TIME_TO_CARRY,TIME_TO_DELIVER_ORDER,COMPARE_ESTIMATED_TO_DELIVERED_TIME,ESTIMATED_TIME_TO_DELIVERY,ORDER_PURCHASE_YEAR,ORDER_PURCHASE_MONTH,ORDER_PURCHASE_DAY,ORDER_PURCHASE_WEEKDAY
2,14,6,20,2018,7,24,Tuesday
4,14,13,27,2017,11,18,Saturday
3,10,32,42,2017,1,23,Monday
4,12,29,41,2018,6,7,Thursday
18,21,-11,10,2017,9,18,Monday
16,18,26,44,2018,1,8,Monday
8,14,7,21,2018,5,2,Wednseday
2,19,13,32,2018,2,3,Saturday
1,2,6,8,2018,7,29,Sunday
6,20,16,36,2018,2,21,Wednseday
3,12,12,24,2017,5,19,Friday
19,34,-7,27,2017,11,24,Friday
4,19,13,32,2017,12,15,Friday
0,4,16,20,2017,8,31,Thursday
1,5,5,10,2018,8,5,Sunday
3,18,4,22,2018,2,19,Monday
2,5,8,13,2018,6,13,Wednseday
2,9,9,18,2018,7,15,Sunday
2,3,9,12,2017,9,13,Wednseday
5,9,11,20,2018,2,15,Thursday
3,17,12,29,2017,2,20,Monday
3,10,16,26,2017,9,15,Friday
1,2,15,17,2017,7,30,Sunday
1,5,16,21,2017,4,6,Thursday
1,9,14,23,2017,5,9,Tuesday
3,11,15,26,2017,12,8,Friday
4,13,13,26,2017,8,26,Saturday
3,20,13,33,2017,12,20,Wednseday
1,13,35,48,2018,6,5,Tuesday
0,6,14,20,2017,5,17,Wednseday
3,4,-1,3,2018,7,30,Monday
1,10,19,29,2018,2,6,Tuesday
3,11,13,24,2017,7,1,Saturday
2,3,16,19,2017,9,27,Wednseday
16,56,-32,24,2017,11,28,Tuesday
1,6,8,14,2018,8,22,Wednseday
1,13,7,20,2018,5,9,Wednseday
2,55,-32,23,2017,11,26,Sunday
0,1,17,18,2017,9,29,Friday
1,8,16,24,2018,8,20,Monday
1,21,1,22,2018,1,30,Tuesday
5,7,27,34,2018,3,31,Saturday
11,28,15,43,2017,3,30,Thursday
1,2,17,19,2018,4,25,Wednseday
2,9,24,33,2017,12,2,Saturday
0,6,22,28,2018,1,9,Tuesday
1,3,17,20,2017,3,28,Tuesday
3,7,20,27,2018,6,8,Friday
2,8,20,28,2017,9,20,Wednseday
1,11,19,30,2017,11,27,Monday
3,4,6,10,2018,5,11,Friday
1,4,29,33,2018,6,24,Sunday
0,14,22,36,2017,3,6,Monday
1,7,4,11,2018,4,26,Thursday
1,8,21,29,2018,7,15,Sunday
12,19,28,47,2018,5,30,Wednseday
2,5,11,16,2017,9,11,Monday
4,5,6,11,2018,4,15,Sunday
2,10,23,33,2018,1,13,Saturday
3,12,16,28,2018,4,4,Wednseday
2,22,11,33,2018,2,28,Wednseday
2,6,17,23,2017,4,22,Saturday
1,8,4,12,2017,9,13,Wednseday
0,2,13,15,2018,1,18,Thursday
16,20,7,27,2017,3,14,Tuesday
2,20,10,30,2017,12,20,Wednseday
1,7,24,31,2017,12,4,Monday
6,10,12,22,2018,3,29,Thursday
4,5,13,18,2018,3,15,Thursday
3,23,-1,22,2018,5,15,Tuesday
3,11,16,27,2018,7,13,Friday
0,18,32,50,2017,4,27,Thursday
5,7,14,21,2017,12,6,Wednseday
1,8,18,26,2017,11,30,Thursday
1,2,7,9,2018,7,22,Sunday
6,15,3,18,2018,5,17,Thursday
3,16,14,30,2017,9,27,Wednseday
2,13,16,29,2018,2,5,Monday
4,13,7,20,2017,11,16,Thursday
5,14,12,26,2018,1,31,Wednseday
2,7,0,7,2018,8,8,Wednseday
2,13,16,29,2017,12,21,Thursday
3,11,26,37,2018,3,18,Sunday
6,12,27,39,2017,1,5,Thursday
14,24,1,25,2017,11,24,Friday
2,10,16,26,2017,12,24,Sunday
4,14,13,27,2018,1,25,Thursday
5,10,16,26,2018,6,16,Saturday
1,7,20,27,2018,1,23,Tuesday
1,81,-49,32,2018,2,1,Thursday
2,9,27,36,2018,6,6,Wednseday
2,6,16,22,2018,1,30,Tuesday
0,7,22,29,2018,1,10,Wednseday
7,12,25,37,2017,2,8,Wednseday
2,4,20,24,2018,6,30,Saturday
5,11,4,15,2018,7,12,Thursday
1,7,8,15,2018,5,15,Tuesday
2,12,15,27,2018,6,16,Saturday
3,4,1,5,2018,7,28,Saturday
6,14,6,20,2017,11,28,Tuesday
1,2,23,25,2018,6,3,Sunday
4,10,7,17,2018,5,7,Monday
14,22,5,27,2018,1,24,Wednseday
0,11,22,33,2018,6,28,Thursday
1,14,12,26,2018,8,1,Wednseday
3,25,8,33,2017,11,24,Friday
2,10,12,22,2018,7,23,Monday
1,2,8,10,2018,4,3,Tuesday
5,14,8,22,2018,3,15,Thursday
3,11,9,20,2018,8,3,Friday
3,6,34,40,2017,1,21,Saturday
2,7,20,27,2017,9,26,Tuesday
1,9,12,21,2017,9,13,Wednseday
0,23,26,49,2018,5,30,Wednseday
0,2,11,13,2017,6,27,Tuesday
9,20,11,31,2017,5,23,Tuesday
1,6,15,21,2017,8,23,Wednseday
16,27,-7,20,2017,5,20,Saturday
0,10,10,20,2017,7,28,Friday
1,2,2,4,2018,8,20,Monday
0,13,12,25,2018,2,9,Friday
1,25,9,34,2018,1,2,Tuesday
1,9,17,26,2017,8,9,Wednseday
4,6,5,11,2018,8,9,Thursday
8,20,16,36,2017,4,19,Wednseday
1,8,19,27,2017,8,17,Thursday
2,9,16,25,2018,7,1,Sunday
5,14,14,28,2017,10,11,Wednseday
1,12,8,20,2018,5,9,Wednseday
1,6,9,15,2018,7,24,Tuesday
1,11,0,11,2017,5,8,Monday
5,11,16,27,2018,3,29,Thursday
3,28,4,32,2018,4,22,Sunday
3,8,15,23,2018,7,22,Sunday
5,10,11,21,2018,7,6,Friday
7,14,17,31,2017,5,29,Monday
2,9,22,31,2018,5,14,Monday
5,11,52,63,2016,10,5,Wednseday
2,11,10,21,2018,3,7,Wednseday
4,8,3,11,2017,11,6,Monday
11,20,8,28,2017,5,19,Friday
3,7,13,20,2017,12,16,Saturday
2,16,15,31,2018,6,23,Saturday
0,14,18,32,2018,3,26,Monday
4,11,11,22,2017,8,10,Thursday
4,7,22,29,2017,12,7,Thursday
1,9,10,19,2017,10,18,Wednseday
2,6,29,35,2018,5,8,Tuesday
0,5,15,20,2017,5,11,Thursday
1,2,12,14,2018,1,9,Tuesday
3,8,19,27,2018,7,3,Tuesday
1,8,9,17,2017,10,17,Tuesday
0,7,17,24,2017,9,8,Friday
0,4,24,28,2017,7,17,Monday
1,7,21,28,2018,8,21,Tuesday
5,10,2,12,2018,3,8,Thursday
3,13,1,14,2017,10,31,Tuesday
1,8,20,28,2017,9,11,Monday
4,14,6,20,2017,10,12,Thursday
2,9,12,21,2018,8,6,Monday
3,5,8,13,2018,6,16,Saturday
3,23,10,33,2018,2,17,Saturday
2,29,-4,25,2018,2,5,Monday
13,20,37,57,2017,1,25,Wednseday
4,17,15,32,2018,6,15,Friday
2,16,21,37,2017,1,14,Saturday
2,10,9,19,2018,8,1,Wednseday
0,19,1,20,2018,3,14,Wednseday
1,6,9,15,2018,1,17,Wednseday
3,6,4,10,2018,7,20,Friday
1,3,16,19,2018,7,4,Wednseday
5,26,1,27,2017,4,13,Thursday
2,3,10,13,2018,7,24,Tuesday
1,12,14,26,2017,7,5,Wednseday
3,7,18,25,2018,5,25,Friday
5,12,13,25,2017,10,12,Thursday
5,13,12,25,2017,12,1,Friday
2,6,4,10,2018,8,21,Tuesday
4,29,-4,25,2017,11,2,Thursday
3,7,17,24,2017,6,23,Friday
7,11,8,19,2018,5,10,Thursday
1,6,10,16,2017,9,13,Wednseday
1,2,14,16,2018,4,11,Wednseday
4,18,8,26,2017,11,3,Friday
1,7,9,16,2018,3,7,Wednseday
4,6,13,19,2018,5,3,Thursday
4,8,15,23,2018,1,1,Monday
16,22,15,37,2017,9,3,Sunday
1,2,7,9,2018,7,11,Wednseday
1,8,17,25,2018,7,30,Monday
2,24,-4,20,2018,2,15,Thursday
1,3,1,4,2018,8,27,Monday
2,14,11,25,2017,2,6,Monday
1,7,22,29,2018,1,16,Tuesday
0,3,7,10,2018,5,18,Friday
2,4,19,23,2018,1,22,Monday
2,9,1,10,2018,8,5,Sunday
1,9,10,19,2017,11,26,Sunday
2,9,14,23,2018,1,3,Wednseday
5,6,7,13,2017,8,31,Thursday
1,2,13,15,2018,6,14,Thursday
1,11,11,22,2017,11,16,Thursday
5,17,15,32,2017,8,26,Saturday
2,4,12,16,2018,6,5,Tuesday
4,10,9,19,2017,3,4,Saturday
3,6,8,14,2017,7,4,Tuesday
8,10,11,21,2018,4,24,Tuesday
1,10,8,18,2017,11,20,Monday
0,17,14,31,2018,5,7,Monday
2,4,21,25,2017,7,31,Monday
8,15,20,35,2018,5,31,Thursday
2,4,18,22,2017,7,24,Monday
4,11,15,26,2017,7,27,Thursday
6,24,4,28,2017,11,28,Tuesday
2,13,24,37,2018,1,23,Tuesday
2,8,1,9,2018,8,19,Sunday
2,4,21,25,2018,5,26,Saturday
1,6,20,26,2017,9,21,Thursday
0,20,15,35,2017,12,20,Wednseday
1,22,9,31,2017,8,28,Monday
1,6,14,20,2017,10,17,Tuesday
4,6,6,12,2018,3,3,Saturday
4,7,23,30,2018,6,23,Saturday
7,28,1,29,2017,9,20,Wednseday
10,22,2,24,2017,3,6,Monday
2,3,5,8,2018,8,7,Tuesday
3,5,18,23,2017,4,15,Saturday
4,10,14,24,2018,4,15,Sunday
1,13,15,28,2017,9,11,Monday
5,14,17,31,2017,2,25,Saturday
3,11,20,31,2017,3,24,Friday
0,2,7,9,2018,4,30,Monday
5,8,11,19,2017,3,8,Wednseday
2,21,3,24,2018,2,17,Saturday
1,20,0,20,2018,5,16,Wednseday
0,75,-47,28,2018,1,19,Friday
1,8,15,23,2018,4,16,Monday
4,21,13,34,2018,5,5,Saturday
1,13,9,22,2017,6,20,Tuesday
2,5,12,17,2018,4,28,Saturday
9,11,6,17,2017,11,18,Saturday
19,27,16,43,2018,5,23,Wednseday
2,27,-1,26,2017,12,16,Saturday
1,8,16,24,2018,1,28,Sunday
4,11,9,20,2018,2,23,Friday
1,3,14,17,2017,12,11,Monday
4,19,13,32,2017,12,15,Friday
1,2,15,17,2017,9,17,Sunday
0,6,8,14,2018,7,25,Wednseday
9,12,19,31,2018,2,12,Monday
2,13,11,24,2017,5,6,Saturday
7,19,3,22,2017,11,30,Thursday
4,11,20,31,2017,2,10,Friday
3,18,13,31,2018,7,20,Friday
1,15,28,43,2018,6,3,Sunday
5,8,47,55,2016,10,5,Wednseday
3,6,21,27,2018,1,26,Friday
1,12,12,24,2018,4,24,Tuesday
4,25,8,33,2017,12,15,Friday
3,6,27,33,2018,8,3,Friday
3,27,5,32,2017,12,1,Friday
10,13,12,25,2018,7,22,Sunday
0,10,6,16,2018,8,8,Wednseday
1,9,20,29,2018,4,8,Sunday
1,28,-6,22,2018,3,12,Monday
2,4,6,10,2018,5,7,Monday
1,26,9,35,2017,8,31,Thursday
3,13,34,47,2017,6,16,Friday
1,12,12,24,2017,5,7,Sunday
1,4,3,7,2018,8,2,Thursday
1,16,15,31,2018,4,9,Monday
0,1,12,13,2017,11,16,Thursday
4,14,25,39,2018,4,13,Friday
1,16,4,20,2018,3,21,Wednseday
2,18,14,32,2017,8,5,Saturday
10,13,14,27,2017,5,6,Saturday
27,30,-6,24,2017,10,24,Tuesday
8,19,15,34,2017,12,28,Thursday
3,5,19,24,2018,1,26,Friday
3,9,9,18,2017,6,10,Saturday
2,7,8,15,2018,1,11,Thursday
5,36,-4,32,2017,10,12,Thursday
4,11,23,34,2017,8,3,Thursday
6,12,16,28,2018,6,13,Wednseday
6,8,8,16,2018,3,6,Tuesday
3,32,-8,24,2018,1,29,Monday
2,8,10,18,2017,10,22,Sunday
3,5,8,13,2017,10,27,Friday
1,8,14,22,2018,7,16,Monday
28,41,8,49,2018,1,11,Thursday
2,11,19,30,2018,6,16,Saturday
8,17,27,44,2018,5,28,Monday
14,16,-2,14,2017,11,13,Monday
5,14,14,28,2017,11,17,Friday
1,7,11,18,2017,8,14,Monday
1,8,25,33,2017,3,1,Wednseday
6,8,13,21,2018,7,18,Wednseday
4,8,17,25,2017,1,22,Sunday
1,5,12,17,2018,7,23,Monday
2,8,34,42,2017,4,3,Monday
1,2,14,16,2018,7,3,Tuesday
2,14,7,21,2018,4,5,Thursday
6,15,8,23,2017,5,16,Tuesday
10,24,2,26,2017,7,14,Friday
2,7,17,24,2018,6,9,Saturday
4,10,43,53,2017,1,22,Sunday
3,9,14,23,2017,5,14,Sunday
1,9,2,11,2017,8,28,Monday
4,23,4,27,2018,3,17,Saturday
1,9,10,19,2018,6,7,Thursday
3,4,6,10,2018,7,27,Friday
1,4,21,25,2018,1,25,Thursday
7,10,4,14,2017,6,6,Tuesday
2,31,-7,24,2018,4,16,Monday
3,7,10,17,2018,7,16,Monday
2,18,12,30,2018,2,4,Sunday
1,4,6,10,2018,8,12,Sunday
1,8,16,24,2018,4,23,Monday
7,15,10,25,2018,5,17,Thursday
6,13,8,21,2017,3,15,Wednseday
1,5,23,28,2018,8,20,Monday
3,12,9,21,2017,11,24,Friday
3,10,16,26,2017,9,8,Friday
1,9,19,28,2018,2,7,Wednseday
2,5,13,18,2018,6,10,Sunday
2,22,13,35,2017,4,18,Tuesday
0,3,19,22,2017,4,12,Wednseday
2,9,21,30,2017,10,29,Sunday
2,19,1,20,2018,2,21,Wednseday
1,35,-17,18,2018,3,1,Thursday
3,6,34,40,2018,4,13,Friday
3,18,20,38,2017,8,11,Friday
3,4,8,12,2018,5,13,Sunday
5,15,14,29,2018,2,1,Thursday
0,8,13,21,2017,5,18,Thursday
1,6,0,6,2018,8,22,Wednseday
1,9,14,23,2017,11,7,Tuesday
4,27,8,35,2017,6,15,Thursday
3,12,13,25,2017,12,1,Friday
1,19,17,36,2018,4,26,Thursday
1,4,20,24,2018,7,22,Sunday
3,4,6,10,2017,5,14,Sunday
3,14,15,29,2017,8,15,Tuesday
1,18,6,24,2018,5,21,Monday
6,13,8,21,2018,2,14,Wednseday
6,11,28,39,2017,1,5,Thursday
0,36,-8,28,2017,11,28,Tuesday
1,2,18,20,2017,7,26,Wednseday
4,6,12,18,2018,8,17,Friday
1,13,14,27,2017,1,26,Thursday
4,18,8,26,2018,3,16,Friday
3,15,17,32,2017,11,26,Sunday
1,6,9,15,2018,8,2,Thursday
3,8,23,31,2017,7,10,Monday
3,14,6,20,2018,7,13,Friday
0,34,9,43,2017,2,22,Wednseday
2,12,11,23,2017,7,2,Sunday
0,5,23,28,2018,4,25,Wednseday
1,6,7,13,2017,8,10,Thursday
1,8,9,17,2017,4,24,Monday
3,6,12,18,2017,12,1,Friday
3,10,11,21,2017,11,29,Wednseday
0,1,16,17,2017,6,2,Friday
2,6,10,16,2017,9,12,Tuesday
2,8,10,18,2017,5,22,Monday
1,5,16,21,2018,5,17,Thursday
3,7,13,20,2017,8,11,Friday
3,13,20,33,2018,2,3,Saturday
1,8,15,23,2017,10,15,Sunday
1,20,-1,19,2018,5,13,Sunday
2,8,7,15,2018,8,1,Wednseday
3,13,13,26,2017,4,22,Saturday
3,19,7,26,2017,12,9,Saturday
3,4,8,12,2017,9,9,Saturday
1,2,21,23,2018,5,21,Monday
13,22,13,35,2017,5,2,Tuesday
2,19,8,27,2017,5,31,Wednseday
0,1,19,20,2017,12,28,Thursday
2,3,11,14,2018,2,27,Tuesday
2,3,6,9,2018,8,25,Saturday
1,11,5,16,2018,7,16,Monday
8,31,-5,26,2018,2,25,Sunday
3,10,15,25,2017,11,11,Saturday
2,6,11,17,2018,6,12,Tuesday
6,14,21,35,2017,1,31,Tuesday
0,1,2,3,2018,8,28,Tuesday
2,7,10,17,2018,8,11,Saturday
4,12,9,21,2017,11,10,Friday
1,13,10,23,2017,3,1,Wednseday
3,18,6,24,2018,3,19,Monday
0,6,20,26,2017,10,11,Wednseday
4,17,6,23,2018,3,10,Saturday
1,5,14,19,2018,3,14,Wednseday
3,13,19,32,2017,5,20,Saturday
3,10,19,29,2017,7,2,Sunday
2,21,17,38,2018,2,26,Monday
2,3,8,11,2018,3,11,Sunday
1,4,19,23,2018,4,23,Monday
0,2,11,13,2018,7,4,Wednseday
1,7,14,21,2018,1,18,Thursday
3,10,13,23,2017,4,30,Sunday
1,4,15,19,2017,7,30,Sunday
2,13,15,28,2018,5,8,Tuesday
2,10,13,23,2018,2,19,Monday
13,18,8,26,2018,8,9,Thursday
0,5,16,21,2017,3,22,Wednseday
2,3,15,18,2018,4,22,Sunday
1,14,10,24,2018,5,21,Monday
1,11,12,23,2018,2,19,Monday
2,10,-2,8,2018,8,12,Sunday
1,27,7,34,2017,4,12,Wednseday
1,4,18,22,2018,6,21,Thursday
4,17,10,27,2017,10,20,Friday
0,7,26,33,2018,6,15,Friday
1,7,1,8,2018,8,23,Thursday
1,8,17,25,2018,4,29,Sunday
1,7,15,22,2017,8,30,Wednseday
2,4,22,26,2017,4,8,Saturday
2,7,9,16,2018,5,9,Wednseday
3,38,1,39,2018,2,23,Friday
2,27,-4,23,2017,11,29,Wednseday
1,6,9,15,2018,5,17,Thursday
1,5,25,30,2018,7,1,Sunday
2,3,7,10,2018,4,2,Monday
7,11,10,21,2017,2,24,Friday
2,13,20,33,2017,10,4,Wednseday
2,13,17,30,2018,6,20,Wednseday
1,9,15,24,2018,1,14,Sunday
2,5,7,12,2017,11,19,Sunday
2,3,10,13,2017,11,21,Tuesday
4,5,9,14,2018,1,26,Friday
3,9,13,22,2017,6,27,Tuesday
4,15,15,30,2018,1,15,Monday
7,11,24,35,2018,3,29,Thursday
1,21,6,27,2018,5,16,Wednseday
5,10,14,24,2018,5,11,Friday
5,6,8,14,2017,8,11,Friday
1,6,8,14,2018,5,10,Thursday
3,16,14,30,2017,10,22,Sunday
4,6,12,18,2018,4,12,Thursday
1,2,14,16,2018,5,20,Sunday
11,16,0,16,2018,8,4,Saturday
3,9,14,23,2018,1,16,Tuesday
9,13,16,29,2018,1,11,Thursday
5,6,7,13,2017,7,26,Wednseday
8,20,13,33,2018,1,17,Wednseday
3,10,19,29,2018,1,16,Tuesday
3,12,14,26,2017,7,14,Friday
4,31,8,39,2017,7,21,Friday
1,3,10,13,2018,7,4,Wednseday
2,18,14,32,2017,10,29,Sunday
2,13,24,37,2017,8,5,Saturday
1,2,8,10,2018,7,23,Monday
2,3,6,9,2018,8,11,Saturday
2,7,17,24,2017,9,25,Monday
1,18,14,32,2018,3,11,Sunday
3,15,7,22,2017,5,1,Monday
7,24,-3,21,2018,2,9,Friday
3,9,11,20,2017,3,28,Tuesday
7,41,-7,34,2018,3,9,Friday
1,4,19,23,2018,6,24,Sunday
1,7,33,40,2018,6,6,Wednseday
11,26,25,51,2018,5,26,Saturday
4,10,15,25,2017,5,13,Saturday
2,36,-7,29,2017,8,14,Monday
1,6,16,22,2018,4,17,Tuesday
5,15,8,23,2018,4,29,Sunday
7,10,2,12,2017,10,20,Friday
1,16,-6,10,2018,3,19,Monday
1,23,6,29,2018,3,28,Wednseday
2,3,2,5,2018,8,4,Saturday
4,22,4,26,2018,7,26,Thursday
0,19,8,27,2018,5,17,Thursday
1,7,12,19,2018,5,16,Wednseday
7,12,14,26,2017,7,19,Wednseday
3,15,22,37,2018,3,18,Sunday
1,18,12,30,2017,10,1,Sunday
3,9,5,14,2017,11,7,Tuesday
6,17,7,24,2017,7,29,Saturday
1,6,14,20,2018,8,2,Thursday
4,18,10,28,2017,12,22,Friday
1,2,15,17,2018,1,7,Sunday
1,17,26,43,2017,2,7,Tuesday
4,7,19,26,2017,4,13,Thursday
1,3,22,25,2017,6,16,Friday
2,13,12,25,2017,12,3,Sunday
16,24,-5,19,2018,7,11,Wednseday
11,12,6,18,2018,7,13,Friday
1,12,3,15,2018,7,29,Sunday
4,16,21,37,2018,4,21,Saturday
2,23,-3,20,2017,11,25,Saturday
0,6,5,11,2017,6,19,Monday
7,16,8,24,2017,4,11,Tuesday
1,8,12,20,2017,11,28,Tuesday
4,4,8,12,2018,3,2,Friday
2,32,-1,31,2017,11,20,Monday
4,5,12,17,2017,11,24,Friday
1,6,17,23,2017,6,13,Tuesday
2,17,7,24,2018,4,22,Sunday
1,13,16,29,2017,1,26,Thursday
0,5,20,25,2018,5,14,Monday
4,26,8,34,2017,9,14,Thursday
2,11,24,35,2018,1,11,Thursday
0,6,21,27,2017,10,26,Thursday
2,11,17,28,2018,4,5,Thursday
3,4,7,11,2017,9,18,Monday
3,12,12,24,2017,7,28,Friday
6,12,14,26,2017,5,19,Friday
1,6,16,22,2017,2,28,Tuesday
3,6,12,18,2017,9,8,Friday
0,7,15,22,2017,8,1,Tuesday
2,4,19,23,2018,6,23,Saturday
1,2,6,8,2018,8,20,Monday
3,24,1,25,2018,6,8,Friday
1,15,14,29,2018,7,11,Wednseday
2,7,13,20,2018,5,8,Tuesday
2,8,20,28,2018,2,12,Monday
3,5,20,25,2017,2,4,Saturday
1,3,14,17,2018,6,18,Monday
1,3,6,9,2018,7,22,Sunday
2,4,12,16,2018,5,19,Saturday
1,2,14,16,2018,7,24,Tuesday
0,1,11,12,2017,11,22,Wednseday
2,5,8,13,2018,8,4,Saturday
2,9,18,27,2017,9,23,Saturday
2,6,21,27,2017,3,1,Wednseday
1,28,4,32,2018,4,26,Thursday
1,2,9,11,2018,6,18,Monday
2,9,15,24,2017,4,10,Monday
5,10,14,24,2017,6,30,Friday
1,5,22,27,2018,6,14,Thursday
6,24,-7,17,2018,3,20,Tuesday
18,20,35,55,2016,10,7,Friday
1,5,7,12,2017,11,22,Wednseday
4,12,10,22,2017,11,12,Sunday
2,7,22,29,2018,1,31,Wednseday
4,7,12,19,2018,5,3,Thursday
6,21,4,25,2018,5,5,Saturday
1,20,5,25,2017,8,24,Thursday
2,10,17,27,2017,8,15,Tuesday
2,16,3,19,2018,3,24,Saturday
0,5,9,14,2018,8,10,Friday
2,8,10,18,2017,9,3,Sunday
1,6,14,20,2018,7,25,Wednseday
5,13,14,27,2018,1,24,Wednseday
2,30,9,39,2017,2,11,Saturday
2,10,17,27,2018,1,6,Saturday
1,8,28,36,2018,7,4,Wednseday
1,8,11,19,2018,8,16,Thursday
3,10,15,25,2017,2,26,Sunday
18,33,-7,26,2017,4,7,Friday
2,9,12,21,2018,3,26,Monday
4,10,12,22,2018,1,14,Sunday
4,12,12,24,2017,7,18,Tuesday
4,25,-3,22,2018,4,5,Thursday
9,30,14,44,2018,5,28,Monday
3,18,22,40,2018,6,15,Friday
3,4,6,10,2017,9,11,Monday
3,41,-15,26,2018,2,18,Sunday
2,3,12,15,2018,5,1,Tuesday
2,4,8,12,2018,6,16,Saturday
2,4,19,23,2018,1,22,Monday
7,12,17,29,2017,11,29,Wednseday
2,8,15,23,2017,7,30,Sunday
3,5,9,14,2018,3,23,Friday
5,11,23,34,2017,2,10,Friday
3,17,14,31,2018,1,6,Saturday
3,14,12,26,2018,1,26,Friday
6,10,14,24,2017,8,29,Tuesday
8,10,8,18,2018,8,5,Sunday
0,3,14,17,2018,2,16,Friday
6,8,11,19,2017,11,15,Wednseday
1,17,-1,16,2018,7,23,Monday
1,8,15,23,2018,1,31,Wednseday
0,8,16,24,2018,4,30,Monday
5,6,7,13,2017,6,23,Friday
1,4,14,18,2018,8,26,Sunday
1,10,11,21,2017,6,12,Monday
7,16,3,19,2017,8,16,Wednseday
7,14,9,23,2018,1,23,Tuesday
14,19,14,33,2017,8,25,Friday
3,16,17,33,2018,4,7,Saturday
10,14,7,21,2017,4,24,Monday
2,8,6,14,2018,8,20,Monday
4,16,11,27,2017,3,11,Saturday
2,18,28,46,2017,5,6,Saturday
6,7,13,20,2017,12,14,Thursday
1,22,12,34,2018,3,7,Wednseday
7,20,1,21,2018,2,23,Friday
5,32,0,32,2018,2,19,Monday
1,23,3,26,2018,1,7,Sunday
2,10,14,24,2017,11,14,Tuesday
3,21,10,31,2017,12,15,Friday
2,10,14,24,2017,6,4,Sunday
3,31,-2,29,2018,2,12,Monday
1,2,13,15,2017,7,12,Wednseday
2,7,21,28,2018,4,25,Wednseday
1,17,0,17,2017,3,27,Monday
11,15,9,24,2017,12,11,Monday
2,17,10,27,2018,2,27,Tuesday
4,11,13,24,2017,12,4,Monday
2,12,8,20,2018,8,8,Wednseday
1,23,1,24,2018,1,22,Monday
2,10,46,56,2017,1,23,Monday
0,1,7,8,2018,7,11,Wednseday
1,14,14,28,2018,2,8,Thursday
3,6,7,13,2017,7,18,Tuesday
1,29,7,36,2017,5,23,Tuesday
5,8,24,32,2018,7,5,Thursday
4,7,15,22,2018,7,16,Monday
3,12,19,31,2017,12,2,Saturday
1,14,3,17,2018,4,2,Monday
3,45,-12,33,2018,5,11,Friday
7,26,1,27,2018,2,9,Friday
4,11,19,30,2018,5,19,Saturday
1,7,15,22,2017,7,25,Tuesday
6,14,13,27,2017,5,17,Wednseday
6,32,-11,21,2018,2,21,Wednseday
2,3,9,12,2018,3,25,Sunday
1,7,15,22,2018,6,13,Wednseday
5,13,10,23,2017,6,14,Wednseday
2,8,12,20,2018,3,6,Tuesday
5,15,17,32,2017,3,23,Thursday
2,4,12,16,2018,4,11,Wednseday
5,40,-12,28,2018,2,5,Monday
5,12,19,31,2017,5,5,Friday
2,15,9,24,2018,5,5,Saturday
2,7,24,31,2018,2,19,Monday
7,17,4,21,2018,3,1,Thursday
4,11,9,20,2017,11,24,Friday
2,8,3,11,2017,5,29,Monday
1,6,16,22,2018,1,16,Tuesday
3,6,0,6,2018,8,24,Friday
3,5,13,18,2017,11,24,Friday
1,2,8,10,2017,5,14,Sunday
2,9,14,23,2017,3,11,Saturday
4,18,-1,17,2017,11,10,Friday
6,11,8,19,2017,3,9,Thursday
2,21,0,21,2017,3,21,Tuesday
8,14,3,17,2017,4,25,Tuesday
3,10,21,31,2017,3,26,Sunday
7,11,12,23,2018,7,16,Monday
1,24,8,32,2018,5,27,Sunday
1,14,21,35,2018,6,19,Tuesday
0,8,13,21,2017,11,29,Wednseday
4,8,17,25,2017,8,17,Thursday
5,36,-7,29,2017,12,14,Thursday
2,11,16,27,2017,8,8,Tuesday
1,7,15,22,2018,7,19,Thursday
3,22,18,40,2018,6,22,Friday
2,11,23,34,2018,5,26,Saturday
6,13,15,28,2017,4,4,Tuesday
7,12,21,33,2018,1,24,Wednseday
1,6,15,21,2018,7,24,Tuesday
1,7,10,17,2017,11,27,Monday
0,5,3,8,2018,8,8,Wednseday
0,17,5,22,2018,3,12,Monday
3,5,26,31,2017,11,18,Saturday
8,11,-4,7,2018,8,2,Thursday
2,8,6,14,2017,9,18,Monday
0,13,9,22,2017,7,18,Tuesday
4,5,14,19,2018,1,4,Thursday
3,8,7,15,2018,7,16,Monday
4,14,18,32,2017,7,20,Thursday
1,18,14,32,2017,4,27,Thursday
4,8,10,18,2018,3,8,Thursday
4,12,15,27,2017,12,7,Thursday
1,5,14,19,2017,10,29,Sunday
1,8,11,19,2018,3,8,Thursday
2,10,17,27,2018,5,2,Wednseday
1,4,11,15,2018,4,26,Thursday
1,11,13,24,2018,3,25,Sunday
8,28,3,31,2018,5,7,Monday
4,10,15,25,2017,7,28,Friday
1,2,13,15,2018,2,26,Monday
1,8,15,23,2017,11,27,Monday
3,19,1,20,2018,5,18,Friday
1,4,14,18,2017,10,9,Monday
2,8,40,48,2018,6,5,Tuesday
7,13,23,36,2017,3,29,Wednseday
6,17,20,37,2017,12,27,Wednseday
12,14,18,32,2017,7,28,Friday
6,7,19,26,2018,5,30,Wednseday
1,6,7,13,2017,7,12,Wednseday
1,2,16,18,2017,10,16,Monday
1,10,16,26,2018,4,20,Friday
1,12,21,33,2018,4,6,Friday
1,8,19,27,2018,4,3,Tuesday
1,4,12,16,2018,5,14,Monday
6,27,-7,20,2017,9,6,Wednseday
5,6,7,13,2017,11,16,Thursday
3,17,7,24,2017,2,27,Monday
0,5,9,14,2018,7,25,Wednseday
0,6,20,26,2018,7,25,Wednseday
1,6,20,26,2017,10,5,Thursday
3,4,10,14,2017,11,24,Friday
5,11,30,41,2018,7,20,Friday
2,4,14,18,2018,2,1,Thursday
16,27,28,55,2018,1,10,Wednseday
5,9,17,26,2017,3,29,Wednseday
5,8,14,22,2018,8,22,Wednseday
1,8,15,23,2017,6,6,Tuesday
2,10,13,23,2018,1,16,Tuesday
1,2,12,14,2017,7,19,Wednseday
5,7,2,9,2018,5,16,Wednseday
1,3,10,13,2017,5,23,Tuesday
1,9,26,35,2018,2,7,Wednseday
6,28,6,34,2018,2,22,Thursday
3,5,17,22,2018,2,11,Sunday
6,7,11,18,2018,2,1,Thursday
11,25,7,32,2017,10,16,Monday
1,5,15,20,2018,7,4,Wednseday
2,41,-10,31,2018,1,30,Tuesday
1,5,6,11,2018,5,17,Thursday
5,6,1,7,2018,8,1,Wednseday
0,7,14,21,2017,3,22,Wednseday
4,8,6,14,2017,11,24,Friday
3,10,15,25,2017,5,6,Saturday
5,13,15,28,2017,10,26,Thursday
1,5,15,20,2017,7,14,Friday
1,13,15,28,2017,6,27,Tuesday
1,2,10,12,2017,8,27,Sunday
2,14,24,38,2017,8,1,Tuesday
0,13,35,48,2018,5,29,Tuesday
4,8,20,28,2018,6,29,Friday
2,10,14,24,2017,7,1,Saturday
3,19,3,22,2017,12,25,Monday
4,11,14,25,2018,7,28,Saturday
1,5,3,8,2018,5,17,Thursday
3,4,19,23,2018,1,28,Sunday
3,9,3,12,2018,8,10,Friday
2,11,13,24,2017,11,26,Sunday
1,12,12,24,2017,6,11,Sunday
23,36,1,37,2018,2,26,Monday
1,28,14,42,2018,3,6,Tuesday
2,6,10,16,2018,4,3,Tuesday
1,3,1,4,2018,8,20,Monday
1,3,8,11,2017,11,6,Monday
1,10,19,29,2017,5,14,Sunday
1,2,8,10,2018,6,18,Monday
1,9,15,24,2017,9,3,Sunday
2,9,22,31,2017,5,29,Monday
7,15,7,22,2017,6,22,Thursday
1,7,17,24,2018,4,6,Friday
2,11,13,24,2017,12,18,Monday
1,8,17,25,2017,9,25,Monday
1,2,18,20,2018,8,21,Tuesday
2,17,12,29,2017,11,6,Monday
2,7,14,21,2017,8,21,Monday
0,13,9,22,2018,3,27,Tuesday
1,25,-5,20,2018,3,1,Thursday
2,6,7,13,2017,8,9,Wednseday
6,14,18,32,2018,2,8,Thursday
2,16,17,33,2018,8,11,Saturday
3,29,-5,24,2018,3,16,Friday
1,12,7,19,2018,7,18,Wednseday
4,5,19,24,2017,5,12,Friday
3,5,5,10,2018,8,3,Friday
1,7,13,20,2017,9,5,Tuesday
3,10,22,32,2017,6,9,Friday
3,12,8,20,2017,7,14,Friday
1,6,21,27,2017,11,2,Thursday
2,5,20,25,2017,12,2,Saturday
2,11,14,25,2017,9,24,Sunday
1,4,8,12,2017,10,19,Thursday
1,7,17,24,2017,3,6,Monday
3,5,11,16,2018,2,13,Tuesday
3,11,10,21,2018,8,10,Friday
1,25,10,35,2017,12,14,Thursday
2,7,15,22,2017,6,27,Tuesday
5,16,10,26,2018,1,24,Wednseday
3,3,12,15,2018,1,16,Tuesday
11,18,-3,15,2017,11,12,Sunday
3,26,-8,18,2018,3,9,Friday
4,24,9,33,2018,1,4,Thursday
1,7,16,23,2017,10,17,Tuesday
15,18,4,22,2017,10,9,Monday
12,16,14,30,2018,8,5,Sunday
1,17,5,22,2018,2,26,Monday
3,4,15,19,2017,12,9,Saturday
1,19,9,28,2017,10,3,Tuesday
1,2,12,14,2017,8,2,Wednseday
2,4,5,9,2018,8,11,Saturday
5,21,10,31,2018,3,24,Saturday
1,13,7,20,2018,2,14,Wednseday
3,31,6,37,2017,11,11,Saturday
3,9,10,19,2018,8,18,Saturday
5,12,16,28,2018,2,22,Thursday
0,13,24,37,2018,1,23,Tuesday
1,23,2,25,2018,2,22,Thursday
3,4,29,33,2018,4,13,Friday
4,19,5,24,2017,7,3,Monday
0,4,8,12,2018,3,8,Thursday
0,2,8,10,2017,9,12,Tuesday
1,13,9,22,2017,11,15,Wednseday
9,10,7,17,2018,1,1,Monday
1,9,14,23,2018,6,25,Monday
5,13,10,23,2017,10,1,Sunday
5,13,12,25,2018,6,28,Thursday
3,10,9,19,2018,5,5,Saturday
1,7,24,31,2017,5,16,Tuesday
1,2,11,13,2018,7,18,Wednseday
5,10,16,26,2018,1,12,Friday
2,12,11,23,2017,11,29,Wednseday
1,7,13,20,2018,2,28,Wednseday
6,11,13,24,2018,5,4,Friday
7,14,9,23,2017,6,5,Monday
3,12,21,33,2017,11,10,Friday
1,4,20,24,2018,4,22,Sunday
13,30,-2,28,2017,12,21,Thursday
1,10,17,27,2017,9,21,Thursday
4,15,6,21,2017,3,9,Thursday
2,10,17,27,2017,10,7,Saturday
1,2,4,6,2018,8,15,Wednseday
3,13,20,33,2017,8,12,Saturday
4,11,9,20,2018,3,24,Saturday
4,12,15,27,2018,1,11,Thursday
14,32,-1,31,2017,2,24,Friday
4,9,9,18,2018,8,11,Saturday
6,10,21,31,2018,7,24,Tuesday
4,6,19,25,2017,8,17,Thursday
1,8,10,18,2017,7,10,Monday
4,7,34,41,2018,5,31,Thursday
3,9,15,24,2017,6,19,Monday
2,5,19,24,2017,10,21,Saturday
5,14,2,16,2018,3,7,Wednseday
8,18,10,28,2018,7,9,Monday
2,9,11,20,2017,5,17,Wednseday
1,14,11,25,2017,6,12,Monday
2,8,10,18,2018,3,4,Sunday
2,31,-10,21,2018,5,15,Tuesday
5,10,17,27,2017,10,18,Wednseday
2,3,43,46,2018,6,2,Saturday
3,6,18,24,2017,11,17,Friday
6,43,-15,28,2017,12,1,Friday
2,7,17,24,2018,5,15,Tuesday
4,10,41,51,2018,1,1,Monday
2,8,17,25,2017,4,9,Sunday
12,20,11,31,2017,2,24,Friday
16,38,13,51,2018,1,15,Monday
1,8,14,22,2017,8,9,Wednseday
3,8,3,11,2017,5,15,Monday
5,33,-4,29,2018,2,1,Thursday
13,21,8,29,2017,9,21,Thursday
6,14,13,27,2018,4,12,Thursday
2,11,14,25,2017,3,6,Monday
4,18,12,30,2018,4,9,Monday
0,13,12,25,2018,7,13,Friday
3,5,0,5,2018,8,24,Friday
5,20,12,32,2017,12,22,Friday
3,14,17,31,2018,2,2,Friday
5,15,25,40,2018,2,21,Wednseday
1,12,9,21,2018,6,28,Thursday
4,11,8,19,2018,7,26,Thursday
3,7,17,24,2018,4,27,Friday
0,28,-6,22,2018,3,15,Thursday
1,8,25,33,2018,6,13,Wednseday
6,8,18,26,2017,1,25,Wednseday
1,11,15,26,2018,6,28,Thursday
1,28,-7,21,2017,3,22,Wednseday
2,23,-7,16,2018,4,2,Monday
1,3,21,24,2018,4,15,Sunday
4,7,9,16,2018,7,16,Monday
1,21,5,26,2017,8,30,Wednseday
8,16,6,22,2017,9,3,Sunday
6,9,5,14,2018,2,9,Friday
1,6,9,15,2018,7,18,Wednseday
1,50,-14,36,2018,2,6,Tuesday
4,7,6,13,2018,8,23,Thursday
3,10,14,24,2017,7,21,Friday
3,4,7,11,2017,10,15,Sunday
9,29,-7,22,2018,3,12,Monday
1,16,7,23,2017,9,17,Sunday
4,10,9,19,2018,3,23,Friday
1,3,13,16,2018,5,14,Monday
2,15,28,43,2018,1,21,Sunday
5,33,-7,26,2017,11,24,Friday
1,7,15,22,2018,5,15,Tuesday
3,8,17,25,2017,2,13,Monday
5,15,11,26,2017,10,1,Sunday
2,24,-6,18,2018,3,5,Monday
1,3,9,12,2018,5,2,Wednseday
1,5,17,22,2017,3,1,Wednseday
2,4,20,24,2017,6,17,Saturday
2,12,13,25,2017,9,2,Saturday
1,3,14,17,2018,4,16,Monday
2,13,8,21,2018,6,26,Tuesday
0,7,19,26,2017,12,29,Friday
3,12,18,30,2017,12,24,Sunday
3,9,8,17,2017,12,3,Sunday
1,3,6,9,2018,7,9,Monday
1,12,13,25,2017,6,1,Thursday
0,4,14,18,2018,1,5,Friday
3,9,14,23,2017,6,3,Saturday
0,2,11,13,2018,4,25,Wednseday
1,8,28,36,2017,4,9,Sunday
20,24,21,45,2018,6,2,Saturday
1,25,10,35,2017,7,6,Thursday
19,25,17,42,2018,6,14,Thursday
1,5,23,28,2017,12,6,Wednseday
2,9,13,22,2018,5,1,Tuesday
1,9,18,27,2018,2,13,Tuesday
2,7,16,23,2018,7,2,Monday
13,23,15,38,2018,1,14,Sunday
4,18,2,20,2017,11,24,Friday
3,10,15,25,2017,8,25,Friday
4,21,19,40,2018,3,16,Friday
3,16,11,27,2018,4,20,Friday
8,35,8,43,2017,4,4,Tuesday
1,2,15,17,2018,1,7,Sunday
2,14,15,29,2017,8,21,Monday
3,13,12,25,2017,9,1,Friday
3,11,14,25,2018,6,10,Sunday
2,7,-2,5,2018,8,1,Wednseday
31,42,33,75,2018,1,3,Wednseday
2,9,17,26,2018,5,23,Wednseday
1,7,17,24,2017,11,7,Tuesday
0,7,24,31,2018,1,29,Monday
6,7,6,13,2017,6,28,Wednseday
5,7,6,13,2017,11,16,Thursday
4,5,13,18,2018,2,2,Friday
2,9,11,20,2018,5,9,Wednseday
2,6,25,31,2018,7,7,Saturday
1,6,15,21,2017,7,18,Tuesday
2,5,6,11,2018,8,25,Saturday
2,9,15,24,2017,8,5,Saturday
3,16,13,29,2017,12,4,Monday
7,18,11,29,2018,2,20,Tuesday
2,7,15,22,2017,5,22,Monday
4,11,2,13,2017,11,3,Friday
2,9,14,23,2018,3,3,Saturday
1,17,21,38,2018,8,12,Sunday
1,15,14,29,2017,4,17,Monday
6,14,19,33,2018,1,3,Wednseday
3,37,-10,27,2018,1,27,Saturday
6,15,12,27,2017,10,5,Thursday
2,6,15,21,2018,7,5,Thursday
4,5,7,12,2018,5,3,Thursday
10,13,18,31,2017,2,11,Saturday
3,10,14,24,2017,3,3,Friday
1,12,20,32,2017,7,27,Thursday
6,10,14,24,2018,7,10,Tuesday
6,6,7,13,2018,3,23,Friday
5,6,13,19,2018,4,27,Friday
2,5,17,22,2018,4,8,Sunday
2,15,11,26,2017,9,24,Sunday
5,13,15,28,2017,9,20,Wednseday
1,6,16,22,2017,9,28,Thursday
1,12,11,23,2017,12,6,Wednseday
7,10,3,13,2017,5,19,Friday
4,7,15,22,2018,4,3,Tuesday
2,7,11,18,2018,5,7,Monday
3,17,36,53,2017,12,23,Saturday
2,8,16,24,2017,8,6,Sunday
2,6,10,16,2017,10,3,Tuesday
11,15,14,29,2017,3,20,Monday
1,25,1,26,2017,9,21,Thursday
2,9,18,27,2017,2,21,Tuesday
10,12,1,13,2017,8,4,Friday
3,9,14,23,2018,5,12,Saturday
1,10,15,25,2017,12,11,Monday
4,11,4,15,2017,11,12,Sunday
14,37,-12,25,2018,2,26,Monday
9,14,14,28,2017,7,17,Monday
1,2,12,14,2018,6,28,Thursday
2,7,7,14,2018,8,15,Wednseday
0,1,20,21,2018,6,25,Monday
1,21,10,31,2017,12,18,Monday
3,8,11,19,2018,2,18,Sunday
3,16,20,36,2017,1,24,Tuesday
6,8,7,15,2018,8,7,Tuesday
1,2,7,9,2018,7,29,Sunday
1,8,21,29,2018,3,26,Monday
1,14,22,36,2017,11,30,Thursday
3,7,21,28,2018,4,27,Friday
5,9,5,14,2018,2,9,Friday
8,11,38,49,2018,6,4,Monday
4,5,6,11,2018,4,1,Sunday
1,15,7,22,2017,6,22,Thursday
0,1,18,19,2017,12,8,Friday
2,6,12,18,2017,9,23,Saturday
6,12,15,27,2017,2,23,Thursday
1,2,14,16,2018,4,11,Wednseday
0,16,10,26,2018,1,31,Wednseday
3,19,0,19,2017,11,26,Sunday
3,15,16,31,2018,1,23,Tuesday
1,4,10,14,2017,11,27,Monday
2,14,13,27,2017,6,14,Wednseday
2,19,5,24,2018,1,28,Sunday
4,6,24,30,2017,9,9,Saturday
4,8,19,27,2017,2,9,Thursday
1,2,7,9,2018,8,12,Sunday
3,7,7,14,2018,8,3,Friday
0,2,5,7,2018,7,31,Tuesday
5,6,8,14,2018,2,23,Friday
1,13,16,29,2017,3,14,Tuesday
2,11,13,24,2018,1,2,Tuesday
2,12,14,26,2017,12,14,Thursday
11,18,9,27,2017,1,26,Thursday
1,2,11,13,2018,3,6,Tuesday
2,10,17,27,2018,5,1,Tuesday
1,12,13,25,2018,4,12,Thursday
1,4,17,21,2017,4,17,Monday
1,4,11,15,2018,4,23,Monday
4,7,6,13,2018,6,15,Friday
1,6,20,26,2018,6,27,Wednseday
1,22,12,34,2017,8,3,Thursday
7,19,9,28,2017,12,15,Friday
2,17,5,22,2018,3,6,Tuesday
1,4,21,25,2018,6,25,Monday
6,13,16,29,2017,3,15,Wednseday
1,6,21,27,2018,8,23,Thursday
0,10,14,24,2017,11,21,Tuesday
3,10,10,20,2017,9,8,Friday
1,3,13,16,2017,10,16,Monday
3,18,33,51,2018,5,26,Saturday
4,15,7,22,2017,11,26,Sunday
4,29,-6,23,2018,3,4,Sunday
2,24,9,33,2017,12,10,Sunday
4,11,1,12,2018,8,16,Thursday
1,16,0,16,2018,3,13,Tuesday
2,24,-5,19,2018,4,8,Sunday
3,7,11,18,2018,5,11,Friday
1,2,10,12,2017,11,22,Wednseday
1,6,4,10,2018,7,31,Tuesday
3,9,5,14,2018,8,8,Wednseday
4,24,3,27,2018,2,6,Tuesday
3,5,20,25,2018,6,16,Saturday
2,16,6,22,2017,7,26,Wednseday
3,16,17,33,2018,3,24,Saturday
7,15,3,18,2018,3,1,Thursday
1,5,17,22,2017,7,27,Thursday
2,38,-4,34,2018,4,17,Tuesday
0,10,14,24,2018,4,24,Tuesday
1,14,17,31,2018,3,19,Monday
0,5,14,19,2018,3,23,Friday
6,19,14,33,2018,3,24,Saturday
1,4,15,19,2017,11,5,Sunday
0,9,26,35,2017,5,16,Tuesday
1,9,32,41,2018,6,7,Thursday
1,10,13,23,2017,11,22,Wednseday
1,7,22,29,2017,10,3,Tuesday
2,8,25,33,2017,10,1,Sunday
0,1,3,4,2018,7,30,Monday
12,33,-11,22,2017,9,13,Wednseday
2,6,14,20,2018,5,5,Saturday
2,7,18,25,2018,8,6,Monday
5,7,7,14,2017,6,14,Wednseday
4,5,8,13,2017,5,18,Thursday
7,25,1,26,2017,12,29,Friday
1,4,9,13,2018,3,20,Tuesday
1,6,14,20,2017,5,10,Wednseday
1,14,8,22,2017,3,16,Thursday
1,21,7,28,2018,3,5,Monday
2,8,16,24,2018,1,7,Sunday
2,9,6,15,2018,5,15,Tuesday
4,12,21,33,2017,4,6,Thursday
1,9,18,27,2018,1,4,Thursday
5,13,15,28,2017,12,7,Thursday
4,7,10,17,2018,7,9,Monday
4,14,12,26,2018,5,24,Thursday
5,11,16,27,2018,7,13,Friday
1,9,22,31,2018,1,30,Tuesday
3,6,6,12,2018,8,17,Friday
1,6,16,22,2017,6,29,Thursday
2,9,16,25,2018,5,5,Saturday
5,13,12,25,2018,1,26,Friday
5,9,9,18,2018,4,1,Sunday
5,16,8,24,2017,7,8,Saturday
1,8,19,27,2017,5,25,Thursday
2,3,9,12,2018,3,31,Saturday
2,13,16,29,2017,11,12,Sunday
3,51,-21,30,2018,3,12,Monday
2,3,6,9,2018,7,23,Monday
2,3,2,5,2018,8,12,Sunday
2,9,23,32,2017,12,4,Monday
4,11,13,24,2018,4,20,Friday
1,9,12,21,2018,7,23,Monday
7,16,8,24,2017,10,31,Tuesday
4,16,10,26,2017,8,5,Saturday
1,6,12,18,2018,4,1,Sunday
3,11,10,21,2017,3,20,Monday
4,14,12,26,2017,3,10,Friday
0,5,6,11,2018,8,3,Friday
2,6,31,37,2017,2,8,Wednseday
5,18,6,24,2017,10,13,Friday
4,5,21,26,2017,12,1,Friday
5,12,3,15,2018,8,16,Thursday
1,15,2,17,2018,3,19,Monday
5,12,8,20,2017,11,9,Thursday
10,15,31,46,2018,6,4,Monday
12,15,-1,14,2017,11,10,Friday
5,22,11,33,2017,11,2,Thursday
1,14,10,24,2017,11,27,Monday
2,10,16,26,2017,2,5,Sunday
7,23,11,34,2018,1,31,Wednseday
3,8,14,22,2018,7,8,Sunday
1,7,14,21,2017,11,9,Thursday
1,14,23,37,2018,4,10,Tuesday
1,20,10,30,2017,6,28,Wednseday
2,7,34,41,2018,5,15,Tuesday
1,2,9,11,2018,6,17,Sunday
6,11,15,26,2018,1,20,Saturday
1,14,16,30,2017,12,5,Tuesday
6,12,8,20,2017,11,15,Wednseday
2,9,7,16,2017,11,22,Wednseday
1,8,6,14,2018,5,8,Tuesday
1,10,22,32,2018,6,25,Monday
0,8,19,27,2018,4,24,Tuesday
1,14,33,47,2018,6,27,Wednseday
1,24,12,36,2017,12,10,Sunday
4,11,12,23,2017,3,18,Saturday
4,31,4,35,2018,4,16,Monday
12,18,16,34,2018,7,28,Saturday
0,11,6,17,2018,8,17,Friday
3,15,11,26,2017,11,26,Sunday
1,8,0,8,2018,8,6,Monday
2,24,12,36,2018,2,4,Sunday
5,6,6,12,2018,4,13,Friday
2,16,11,27,2017,12,6,Wednseday
4,13,3,16,2017,11,25,Saturday
1,4,17,21,2017,6,15,Thursday
21,25,-4,21,2018,7,11,Wednseday
25,26,29,55,2016,10,5,Wednseday
24,33,-8,25,2018,1,14,Sunday
2,7,10,17,2017,8,28,Monday
1,16,15,31,2017,12,12,Tuesday
1,10,10,20,2018,5,8,Tuesday
1,7,21,28,2018,4,26,Thursday
24,43,-21,22,2018,2,18,Sunday
0,15,5,20,2017,12,20,Wednseday
2,10,19,29,2018,8,14,Tuesday
3,8,6,14,2018,8,6,Monday
1,8,16,24,2018,3,20,Tuesday
2,6,12,18,2017,10,7,Saturday
0,10,14,24,2017,9,5,Tuesday
0,9,0,9,2018,8,6,Monday
16,24,3,27,2017,12,2,Saturday
7,39,-11,28,2018,2,26,Monday
4,17,6,23,2017,12,23,Saturday
2,5,14,19,2018,4,15,Sunday
1,2,14,16,2018,5,2,Wednseday
2,17,1,18,2018,5,19,Saturday
5,12,15,27,2017,8,23,Wednseday
1,7,11,18,2017,11,6,Monday
4,14,12,26,2018,3,30,Friday
6,7,-4,3,2018,8,7,Tuesday
4,5,8,13,2017,8,4,Friday
3,40,-10,30,2017,11,29,Wednseday
0,14,14,28,2017,11,8,Wednseday
1,9,11,20,2017,12,27,Wednseday
2,9,8,17,2017,9,10,Sunday
1,6,28,34,2018,5,16,Wednseday
3,11,19,30,2017,12,30,Saturday
2,4,19,23,2017,12,5,Tuesday
12,21,19,40,2018,3,15,Thursday
7,10,17,27,2018,4,7,Saturday
7,15,13,28,2017,8,8,Tuesday
1,4,11,15,2018,8,26,Sunday
2,6,13,19,2017,9,16,Saturday
2,4,13,17,2018,6,25,Monday
1,6,9,15,2018,2,27,Tuesday
5,14,14,28,2017,10,26,Thursday
2,12,22,34,2018,1,20,Saturday
1,3,28,31,2018,8,20,Monday
5,11,12,23,2017,5,21,Sunday
1,4,13,17,2018,6,11,Monday
3,17,7,24,2017,11,25,Saturday
2,17,10,27,2018,4,11,Wednseday
1,7,15,22,2018,3,20,Tuesday
6,9,20,29,2017,8,16,Wednseday
0,5,23,28,2018,5,10,Thursday
1,6,11,17,2017,3,7,Tuesday
3,6,13,19,2018,7,20,Friday
4,14,26,40,2018,5,24,Thursday
1,7,6,13,2018,8,14,Tuesday
1,3,17,20,2017,5,9,Tuesday
4,8,20,28,2018,5,10,Thursday
0,5,20,25,2018,5,3,Thursday
1,21,18,39,2017,12,21,Thursday
6,27,-4,23,2018,5,16,Wednseday
0,5,12,17,2017,7,28,Friday
2,5,12,17,2018,8,11,Saturday
1,11,9,20,2017,8,17,Thursday
1,12,17,29,2017,5,4,Thursday
2,9,11,20,2017,6,17,Saturday
1,2,11,13,2017,10,26,Thursday
0,7,20,27,2018,1,19,Friday
1,6,17,23,2018,5,15,Tuesday
2,22,1,23,2017,11,27,Monday
3,4,10,14,2017,6,2,Friday
3,9,15,24,2018,1,27,Saturday
5,11,13,24,2018,2,9,Friday
4,17,11,28,2018,1,19,Friday
3,6,20,26,2018,5,4,Friday
4,33,-7,26,2018,3,16,Friday
2,6,20,26,2018,4,21,Saturday
1,10,12,22,2018,3,27,Tuesday
2,5,10,15,2017,6,21,Wednseday
4,14,26,40,2018,1,12,Friday
5,12,13,25,2018,2,4,Sunday
0,6,15,21,2017,5,23,Tuesday
10,18,24,42,2017,3,24,Friday
2,24,4,28,2018,5,14,Monday
2,40,-11,29,2018,3,4,Sunday
9,10,-1,9,2018,8,6,Monday
5,12,8,20,2017,11,11,Saturday
1,7,33,40,2018,7,26,Thursday
3,18,5,23,2018,2,11,Sunday
1,9,16,25,2018,7,22,Sunday
4,9,3,12,2018,8,19,Sunday
1,5,5,10,2018,3,19,Monday
2,16,19,35,2017,6,5,Monday
2,10,7,17,2017,9,18,Monday
2,11,22,33,2018,2,3,Saturday
1,5,9,14,2018,2,23,Friday
1,3,5,8,2018,8,21,Tuesday
4,30,-4,26,2018,3,10,Saturday
1,10,14,24,2018,3,11,Sunday
1,2,13,15,2018,4,23,Monday
1,10,13,23,2018,3,21,Wednseday
4,15,44,59,2017,5,22,Monday
7,21,3,24,2017,7,7,Friday
1,12,7,19,2018,7,26,Thursday
6,24,8,32,2018,6,9,Saturday
7,31,-6,25,2017,11,9,Thursday
2,20,7,27,2018,4,18,Wednseday
0,27,-1,26,2018,6,29,Friday
0,11,17,28,2017,11,24,Friday
2,15,15,30,2018,4,11,Wednseday
3,12,16,28,2017,4,21,Friday
1,8,13,21,2018,4,3,Tuesday
3,39,-9,30,2018,4,2,Monday
3,10,21,31,2017,7,28,Friday
6,8,17,25,2017,3,31,Friday
1,13,15,28,2018,4,18,Wednseday
2,5,17,22,2017,3,12,Sunday
4,19,12,31,2017,12,15,Friday
9,25,5,30,2017,12,10,Sunday
2,7,7,14,2018,2,28,Wednseday
5,11,17,28,2017,12,1,Friday
3,4,2,6,2018,7,27,Friday
3,10,17,27,2017,12,19,Tuesday
2,36,-12,24,2017,11,21,Tuesday
1,7,15,22,2017,7,18,Tuesday
1,2,22,24,2017,8,15,Tuesday
2,13,7,20,2018,6,30,Saturday
4,13,15,28,2017,11,24,Friday
5,10,9,19,2018,5,13,Sunday
1,9,19,28,2017,6,27,Tuesday
3,24,3,27,2017,11,25,Saturday
2,9,0,9,2018,7,29,Sunday
5,16,7,23,2017,3,18,Saturday
1,7,14,21,2017,5,15,Monday
3,13,21,34,2018,3,31,Saturday
2,22,17,39,2018,5,27,Sunday
0,7,19,26,2017,7,26,Wednseday
0,4,15,19,2018,8,9,Thursday
1,2,8,10,2018,6,10,Sunday
11,20,10,30,2018,2,10,Saturday
2,12,14,26,2017,9,10,Sunday
3,9,13,22,2018,4,8,Sunday
1,15,5,20,2017,11,21,Tuesday
2,12,14,26,2017,9,13,Wednseday
4,20,2,22,2017,7,13,Thursday
7,28,2,30,2017,12,13,Wednseday
6,8,8,16,2018,4,10,Tuesday
1,3,13,16,2018,4,2,Monday
2,5,9,14,2017,11,28,Tuesday
16,24,14,38,2017,2,5,Sunday
2,6,13,19,2017,3,1,Wednseday
14,19,-7,12,2018,8,1,Wednseday
2,19,3,22,2017,3,29,Wednseday
2,9,5,14,2018,7,25,Wednseday
0,1,6,7,2018,8,27,Monday
7,14,15,29,2017,6,12,Monday
3,4,6,10,2018,7,27,Friday
4,37,10,47,2018,6,2,Saturday
1,13,16,29,2018,1,16,Tuesday
1,4,10,14,2018,6,14,Thursday
1,2,13,15,2017,8,30,Wednseday
2,7,15,22,2017,7,31,Monday
1,10,7,17,2018,7,15,Sunday
1,22,4,26,2018,3,14,Wednseday
17,32,15,47,2018,3,23,Friday
7,8,5,13,2018,5,10,Thursday
1,6,12,18,2018,3,1,Thursday
1,5,11,16,2018,4,11,Wednseday
1,8,33,41,2018,5,31,Thursday
1,11,38,49,2017,1,30,Monday
0,12,17,29,2017,5,25,Thursday
2,10,14,24,2018,4,23,Monday
3,10,15,25,2018,8,11,Saturday
1,15,1,16,2018,3,7,Wednseday
2,20,7,27,2018,2,27,Tuesday
3,16,15,31,2018,5,25,Friday
2,10,11,21,2018,8,8,Wednseday
4,19,9,28,2018,4,26,Thursday
1,14,7,21,2017,11,16,Thursday
6,11,3,14,2017,11,24,Friday
2,15,13,28,2018,2,28,Wednseday
2,7,20,27,2018,8,22,Wednseday
41,53,-29,24,2017,11,24,Friday
2,3,2,5,2018,8,4,Saturday
1,5,20,25,2018,4,19,Thursday
3,13,11,24,2017,8,26,Saturday
1,3,19,22,2017,5,1,Monday
2,8,10,18,2017,10,22,Sunday
1,5,12,17,2017,12,3,Sunday
4,18,15,33,2017,3,3,Friday
1,6,16,22,2017,7,27,Thursday
3,18,5,23,2017,6,18,Sunday
4,8,11,19,2018,5,10,Thursday
2,3,5,8,2018,8,27,Monday
1,2,14,16,2018,6,10,Sunday
3,10,21,31,2017,12,8,Friday
1,6,42,48,2018,1,3,Wednseday
3,22,10,32,2018,3,4,Sunday
3,17,16,33,2017,11,24,Friday
12,20,5,25,2018,5,17,Thursday
1,6,15,21,2017,12,13,Wednseday
1,2,1,3,2018,8,27,Monday
3,12,19,31,2018,4,13,Friday
1,20,1,21,2017,11,22,Wednseday
1,13,10,23,2018,2,20,Tuesday
2,7,16,23,2018,7,18,Wednseday
1,14,6,20,2018,7,11,Wednseday
2,25,14,39,2017,2,4,Saturday
1,6,15,21,2018,2,14,Wednseday
2,10,19,29,2017,9,26,Tuesday
1,2,14,16,2018,1,30,Tuesday
1,2,6,8,2018,5,21,Monday
1,2,13,15,2018,6,14,Thursday
3,8,8,16,2018,5,13,Sunday
1,12,22,34,2018,6,7,Thursday
1,12,15,27,2018,4,26,Thursday
4,7,4,11,2018,2,12,Monday
3,6,20,26,2018,6,22,Friday
2,15,14,29,2018,3,4,Sunday
11,25,6,31,2017,3,3,Friday
3,18,16,34,2018,3,24,Saturday
6,22,6,28,2018,3,20,Tuesday
1,8,14,22,2018,6,25,Monday
2,4,21,25,2018,4,8,Sunday
3,42,-14,28,2017,8,25,Friday
1,15,8,23,2017,11,8,Wednseday
1,11,15,26,2017,11,30,Thursday
0,6,14,20,2018,4,26,Thursday
1,11,8,19,2018,6,7,Thursday
2,11,13,24,2017,11,26,Sunday
1,23,14,37,2017,2,21,Tuesday
1,29,6,35,2017,12,19,Tuesday
3,11,10,21,2018,8,13,Monday
1,2,15,17,2017,12,3,Sunday
7,9,6,15,2018,4,23,Monday
6,12,8,20,2017,8,10,Thursday
2,26,12,38,2017,2,5,Sunday
27,39,-12,27,2017,8,10,Thursday
2,10,32,42,2018,6,4,Monday
2,32,-5,27,2018,2,13,Tuesday
2,13,11,24,2018,1,21,Sunday
4,10,15,25,2017,10,6,Friday
8,12,9,21,2018,1,17,Wednseday
1,9,7,16,2018,1,31,Wednseday
4,17,3,20,2017,10,28,Saturday
4,11,21,32,2017,9,1,Friday
4,8,10,18,2018,5,6,Sunday
1,19,7,26,2018,2,16,Friday
2,3,9,12,2018,3,25,Sunday
8,10,13,23,2017,10,29,Sunday
1,2,18,20,2018,6,28,Thursday
3,11,17,28,2017,7,28,Friday
5,33,2,35,2017,12,13,Wednseday
2,11,24,35,2018,1,15,Monday
1,2,18,20,2017,7,12,Wednseday
1,16,7,23,2018,2,21,Wednseday
1,8,24,32,2017,10,5,Thursday
6,10,12,22,2018,5,1,Tuesday
0,19,13,32,2018,6,14,Thursday
1,12,17,29,2018,4,18,Wednseday
4,11,14,25,2018,4,19,Thursday
10,12,17,29,2018,6,24,Sunday
2,11,17,28,2018,5,7,Monday
1,10,11,21,2017,10,24,Tuesday
0,19,17,36,2018,2,15,Thursday
3,8,11,19,2017,12,1,Friday
2,8,20,28,2017,7,17,Monday
5,20,-11,9,2018,8,4,Saturday
4,18,9,27,2017,12,8,Friday
2,6,15,21,2018,1,17,Wednseday
6,12,8,20,2017,11,24,Friday
2,6,4,10,2018,7,28,Saturday
0,7,20,27,2017,8,30,Wednseday
3,18,19,37,2017,4,2,Sunday
3,8,19,27,2018,2,2,Friday
1,9,6,15,2018,5,15,Tuesday
4,45,-25,20,2018,3,23,Friday
3,16,6,22,2017,8,8,Tuesday
5,12,15,27,2017,4,28,Friday
1,7,24,31,2018,6,10,Sunday
2,6,15,21,2018,6,26,Tuesday
1,5,9,14,2018,6,28,Thursday
7,12,21,33,2018,6,14,Thursday
2,6,15,21,2018,1,16,Tuesday
3,10,14,24,2018,8,18,Saturday
2,11,13,24,2017,11,5,Sunday
16,54,-14,40,2017,12,28,Thursday
1,4,35,39,2017,2,5,Sunday
1,14,15,29,2017,6,5,Monday
4,19,13,32,2018,2,4,Sunday
1,7,8,15,2018,8,13,Monday
5,11,22,33,2017,11,24,Friday
4,8,19,27,2018,6,28,Thursday
0,9,16,25,2017,12,18,Monday
6,19,10,29,2018,5,3,Thursday
8,10,4,14,2018,2,15,Thursday
1,6,20,26,2018,3,22,Thursday
2,16,10,26,2017,8,5,Saturday
2,9,17,26,2018,8,11,Saturday
1,5,27,32,2018,5,17,Thursday
2,10,12,22,2017,5,14,Sunday
1,11,9,20,2018,5,10,Thursday
3,31,-3,28,2018,1,5,Friday
3,18,13,31,2018,2,24,Saturday
2,51,11,62,2018,3,24,Saturday
7,49,-13,36,2017,3,28,Tuesday
4,10,9,19,2017,8,6,Sunday
1,8,34,42,2018,3,26,Monday
1,2,2,4,2018,8,12,Sunday
4,28,12,40,2018,3,9,Friday
1,7,10,17,2017,3,13,Monday
2,9,20,29,2017,9,27,Wednseday
3,21,12,33,2017,12,13,Wednseday
0,4,14,18,2018,2,19,Monday
2,7,12,19,2018,8,1,Wednseday
1,7,17,24,2017,12,19,Tuesday
2,3,20,23,2018,4,10,Tuesday
1,11,12,23,2018,8,6,Monday
1,7,11,18,2017,5,22,Monday
2,11,14,25,2018,6,24,Sunday
3,6,18,24,2018,8,17,Friday
1,70,-45,25,2018,2,22,Thursday
4,15,11,26,2017,12,9,Saturday
2,15,13,28,2018,3,21,Wednseday
7,14,9,23,2018,3,14,Wednseday
2,3,11,14,2017,11,28,Tuesday
0,10,10,20,2018,3,13,Tuesday
1,7,29,36,2017,1,23,Monday
0,11,17,28,2017,12,5,Tuesday
2,8,14,22,2018,7,16,Monday
3,46,-12,34,2018,1,30,Tuesday
3,6,7,13,2018,3,20,Tuesday
3,10,9,19,2018,7,27,Friday
4,8,21,29,2018,4,16,Monday
4,21,7,28,2018,7,19,Thursday
1,3,5,8,2018,7,29,Sunday
3,9,21,30,2018,6,16,Saturday
6,20,7,27,2018,2,10,Saturday
3,23,8,31,2017,10,16,Monday
9,10,19,29,2018,7,22,Sunday
4,11,6,17,2018,8,18,Saturday
1,7,14,21,2017,3,21,Tuesday
2,5,13,18,2017,9,16,Saturday
2,3,13,16,2018,2,6,Tuesday
6,21,-1,20,2018,3,14,Wednseday
0,5,19,24,2018,3,16,Friday
5,10,15,25,2017,9,29,Friday
1,3,13,16,2018,1,16,Tuesday
5,18,0,18,2018,3,3,Saturday
4,24,4,28,2018,1,29,Monday
7,8,5,13,2018,5,8,Tuesday
1,7,20,27,2017,12,6,Wednseday
8,14,8,22,2018,1,17,Wednseday
1,6,12,18,2018,2,8,Thursday
2,14,9,23,2018,2,12,Monday
3,11,14,25,2018,5,25,Friday
1,14,13,27,2017,11,30,Thursday
1,7,29,36,2018,6,20,Wednseday
4,6,8,14,2017,8,25,Friday
1,8,12,20,2017,6,29,Thursday
3,7,7,14,2017,6,9,Friday
6,18,14,32,2018,1,20,Saturday
21,26,-3,23,2017,5,31,Wednseday
2,9,14,23,2017,11,25,Saturday
1,2,11,13,2018,7,18,Wednseday
1,2,1,3,2018,8,28,Tuesday
5,17,9,26,2017,7,15,Saturday
2,9,21,30,2018,1,6,Saturday
3,9,2,11,2018,8,4,Saturday
6,17,4,21,2018,3,27,Tuesday
1,9,12,21,2017,11,22,Wednseday
1,7,13,20,2018,5,15,Tuesday
1,7,19,26,2017,12,27,Wednseday
3,12,13,25,2018,4,27,Friday
1,5,14,19,2017,10,26,Thursday
5,6,12,18,2017,11,30,Thursday
2,21,17,38,2018,1,30,Tuesday
8,13,14,27,2017,11,9,Thursday
3,4,9,13,2018,6,15,Friday
12,13,3,16,2018,7,18,Wednseday
4,8,20,28,2017,11,30,Thursday
3,11,11,22,2018,2,18,Sunday
2,8,9,17,2018,8,12,Sunday
3,10,10,20,2018,1,26,Friday
1,16,12,28,2018,3,21,Wednseday
1,7,15,22,2017,5,23,Tuesday
3,12,12,24,2018,4,30,Monday
1,8,20,28,2017,10,3,Tuesday
1,10,26,36,2018,6,19,Tuesday
2,7,15,22,2017,7,17,Monday
3,32,-11,21,2018,4,6,Friday
1,3,11,14,2018,1,26,Friday
1,5,12,17,2017,11,20,Monday
1,3,10,13,2017,5,24,Wednseday
3,8,21,29,2017,8,27,Sunday
4,13,13,26,2017,4,28,Friday
2,9,15,24,2017,11,18,Saturday
1,2,13,15,2018,7,4,Wednseday
1,6,10,16,2017,9,18,Monday
0,4,15,19,2018,4,19,Thursday
1,4,11,15,2018,6,14,Thursday
2,12,10,22,2017,10,15,Sunday
5,13,9,22,2017,8,30,Wednseday
5,21,18,39,2018,4,5,Thursday
1,9,13,22,2018,3,4,Sunday
7,10,-1,9,2018,7,31,Tuesday
4,10,21,31,2017,7,22,Saturday
5,19,0,19,2018,3,29,Thursday
14,22,6,28,2018,3,29,Thursday
3,13,13,26,2018,1,12,Friday
1,5,9,14,2018,8,23,Thursday
1,2,6,8,2018,5,14,Monday
4,5,7,12,2017,6,18,Sunday
8,14,12,26,2017,3,30,Thursday
6,14,9,23,2018,4,24,Tuesday
4,13,5,18,2018,8,11,Saturday
3,9,15,24,2018,7,24,Tuesday
1,19,-4,15,2018,5,17,Thursday
1,5,19,24,2018,8,12,Sunday
2,8,14,22,2018,1,14,Sunday
7,8,11,19,2018,4,26,Thursday
4,18,-5,13,2017,6,22,Thursday
1,22,7,29,2017,12,14,Thursday
3,4,21,25,2018,6,3,Sunday
2,16,2,18,2018,3,10,Saturday
2,14,8,22,2017,11,16,Thursday
0,6,9,15,2018,7,26,Thursday
2,5,11,16,2018,7,28,Saturday
5,7,13,20,2018,4,18,Wednseday
4,12,14,26,2017,3,24,Friday
4,11,15,26,2017,7,14,Friday
2,3,18,21,2018,6,26,Tuesday
0,9,15,24,2018,5,15,Tuesday
1,8,14,22,2017,8,28,Monday
6,8,21,29,2018,5,1,Tuesday
6,12,15,27,2018,3,16,Friday
1,7,28,35,2017,1,31,Tuesday
1,16,14,30,2017,5,9,Tuesday
2,4,20,24,2017,12,3,Sunday
1,15,4,19,2018,5,6,Sunday
0,7,33,40,2017,4,27,Thursday
4,8,10,18,2018,2,26,Monday
2,7,5,12,2018,7,29,Sunday
3,16,14,30,2018,4,22,Sunday
1,12,14,26,2017,8,17,Thursday
3,17,7,24,2017,4,21,Friday
0,9,19,28,2017,7,19,Wednseday
2,17,6,23,2018,1,30,Tuesday
1,7,1,8,2018,5,15,Tuesday
4,5,13,18,2018,1,11,Thursday
2,6,24,30,2018,1,3,Wednseday
1,8,14,22,2017,8,9,Wednseday
7,13,8,21,2017,4,26,Wednseday
1,7,14,21,2017,3,20,Monday
1,5,21,26,2017,10,26,Thursday
1,3,5,8,2018,5,14,Monday
3,13,20,33,2017,12,9,Saturday
4,32,-5,27,2017,8,18,Friday
0,6,14,20,2018,6,28,Thursday
3,13,22,35,2018,1,12,Friday
1,6,17,23,2018,2,28,Wednseday
2,21,3,24,2017,9,4,Monday
1,3,8,11,2018,5,6,Sunday
1,11,11,22,2017,8,31,Thursday
9,13,7,20,2017,8,15,Tuesday
4,16,2,18,2018,3,10,Saturday
10,29,-5,24,2018,7,17,Tuesday
6,13,10,23,2017,6,14,Wednseday
1,2,18,20,2018,4,12,Thursday
3,8,11,19,2017,12,9,Saturday
0,5,9,14,2018,7,19,Thursday
1,2,7,9,2018,7,25,Wednseday
3,13,5,18,2018,3,2,Friday
0,6,15,21,2018,4,11,Wednseday
1,7,16,23,2017,10,9,Monday
3,8,16,24,2018,7,20,Friday
6,17,14,31,2018,5,4,Friday
1,7,20,27,2017,10,3,Tuesday
1,38,-2,36,2018,1,14,Sunday
2,24,-1,23,2018,2,19,Monday
1,4,21,25,2018,4,8,Sunday
1,5,10,15,2018,1,11,Thursday
3,20,26,46,2018,3,9,Friday
15,20,21,41,2018,5,31,Thursday
3,13,21,34,2018,8,14,Tuesday
5,10,14,24,2017,6,16,Friday
18,37,-6,31,2017,6,12,Monday
2,11,27,38,2017,4,9,Sunday
3,16,14,30,2018,1,20,Saturday
2,20,4,24,2018,1,30,Tuesday
4,7,15,22,2017,11,2,Thursday
2,3,1,4,2018,7,29,Sunday
1,8,5,13,2018,8,21,Tuesday
1,2,10,12,2018,2,14,Wednseday
2,5,11,16,2018,5,13,Sunday
2,6,16,22,2017,7,4,Tuesday
2,11,11,22,2017,7,25,Tuesday
1,12,17,29,2018,4,8,Sunday
5,13,14,27,2017,11,2,Thursday
6,7,8,15,2018,1,24,Wednseday
5,20,19,39,2018,5,12,Saturday
6,14,9,23,2018,8,7,Tuesday
1,3,17,20,2018,8,28,Tuesday
13,32,-12,20,2017,11,16,Thursday
5,12,19,31,2017,10,13,Friday
5,10,13,23,2018,7,15,Sunday
4,12,12,24,2018,5,6,Sunday
4,11,11,22,2017,9,14,Thursday
18,31,-8,23,2017,4,17,Monday
6,14,5,19,2018,2,28,Wednseday
4,7,18,25,2017,9,29,Friday
3,9,7,16,2018,7,24,Tuesday
3,12,19,31,2018,3,24,Saturday
2,18,8,26,2018,3,18,Sunday
3,18,3,21,2018,2,19,Monday
2,9,21,30,2017,9,25,Monday
4,9,20,29,2018,1,1,Monday
1,4,13,17,2017,9,10,Sunday
2,9,17,26,2017,7,15,Saturday
1,7,14,21,2018,5,15,Tuesday
1,7,21,28,2018,6,26,Tuesday
3,27,-6,21,2018,5,15,Tuesday
10,20,45,65,2016,10,5,Wednseday
1,3,8,11,2017,8,14,Monday
7,35,-14,21,2018,2,28,Wednseday
6,41,-20,21,2018,3,2,Friday
1,11,17,28,2018,4,9,Monday
4,16,1,17,2017,3,20,Monday
2,14,22,36,2017,8,30,Wednseday
2,12,11,23,2017,9,13,Wednseday
1,6,15,21,2018,6,13,Wednseday
2,7,12,19,2017,3,11,Saturday
3,10,36,46,2018,8,17,Friday
5,22,4,26,2018,3,29,Thursday
28,49,1,50,2018,3,27,Tuesday
3,16,8,24,2018,4,22,Sunday
1,4,8,12,2018,7,19,Thursday
1,6,18,24,2018,2,25,Sunday
0,6,23,29,2018,1,4,Thursday
1,8,27,35,2017,1,26,Thursday
5,13,16,29,2017,8,23,Wednseday
0,2,10,12,2018,2,14,Wednseday
1,16,0,16,2018,5,20,Sunday
4,12,10,22,2017,9,10,Sunday
3,6,9,15,2018,2,18,Sunday
8,13,15,28,2017,7,18,Tuesday
3,13,36,49,2017,12,15,Friday
0,10,15,25,2018,4,20,Friday
6,14,14,28,2018,5,8,Tuesday
7,12,16,28,2018,6,21,Thursday
2,13,16,29,2018,1,10,Wednseday
1,6,6,12,2018,3,8,Thursday
6,23,6,29,2018,2,11,Sunday
0,2,26,28,2018,2,21,Wednseday
4,8,14,22,2017,4,20,Thursday
6,20,8,28,2018,1,4,Thursday
1,5,10,15,2018,8,20,Monday
4,13,12,25,2018,8,9,Thursday
25,26,29,55,2016,10,5,Wednseday
2,6,13,19,2017,9,16,Saturday
7,9,46,55,2017,1,17,Tuesday
2,3,9,12,2018,3,3,Saturday
1,7,35,42,2018,6,6,Wednseday
8,9,13,22,2018,4,18,Wednseday
2,7,16,23,2017,8,30,Wednseday
2,19,13,32,2018,5,20,Sunday
8,11,48,59,2016,10,7,Friday
4,26,-5,21,2017,10,27,Friday
2,8,35,43,2018,6,3,Sunday
2,9,30,39,2017,10,21,Saturday
3,6,18,24,2017,9,29,Friday
2,13,14,27,2018,1,11,Thursday
1,3,21,24,2018,6,25,Monday
4,13,8,21,2018,5,11,Friday
1,8,5,13,2018,7,4,Wednseday
2,8,15,23,2017,3,1,Wednseday
4,8,19,27,2018,1,4,Thursday
13,24,5,29,2017,11,15,Wednseday
2,5,8,13,2017,7,8,Saturday
3,36,-6,30,2017,9,5,Tuesday
2,5,9,14,2017,11,15,Wednseday
0,1,16,17,2018,4,23,Monday
0,5,17,22,2018,6,28,Thursday
4,39,-14,25,2018,3,31,Saturday
0,5,14,19,2018,7,25,Wednseday
3,11,16,27,2018,6,8,Friday
1,8,18,26,2018,4,19,Thursday
0,26,2,28,2018,2,16,Friday
14,25,-7,18,2017,10,27,Friday
2,22,3,25,2018,4,2,Monday
2,11,13,24,2018,1,30,Tuesday
15,16,5,21,2018,7,4,Wednseday
1,4,6,10,2018,7,30,Monday
2,9,15,24,2017,7,15,Saturday
7,27,-5,22,2018,3,27,Tuesday
1,4,3,7,2018,8,23,Thursday
1,4,9,13,2017,8,31,Thursday
5,6,10,16,2018,7,7,Saturday
2,19,8,27,2017,10,25,Wednseday
6,23,6,29,2018,2,4,Sunday
3,12,14,26,2018,5,11,Friday
3,9,20,29,2017,7,11,Tuesday
4,9,14,23,2018,1,1,Monday
3,7,9,16,2018,7,14,Saturday
1,10,21,31,2017,6,6,Tuesday
6,13,16,29,2018,4,5,Thursday
4,5,8,13,2017,5,26,Friday
1,8,6,14,2018,5,15,Tuesday
3,26,-2,24,2017,12,3,Sunday
8,15,1,16,2017,9,19,Tuesday
1,13,14,27,2018,7,11,Wednseday
6,12,15,27,2018,6,27,Wednseday
2,3,17,20,2017,12,16,Saturday
3,13,11,24,2017,7,28,Friday
3,6,7,13,2018,7,31,Tuesday
1,8,24,32,2018,2,8,Thursday
1,6,8,14,2018,7,31,Tuesday
4,24,13,37,2018,1,13,Saturday
1,6,16,22,2017,6,6,Tuesday
2,15,18,33,2018,1,7,Sunday
1,5,4,9,2018,5,20,Sunday
5,16,16,32,2018,7,21,Saturday
1,15,6,21,2018,4,24,Tuesday
1,6,15,21,2018,5,15,Tuesday
4,6,12,18,2017,8,5,Saturday
5,25,8,33,2017,11,24,Friday
1,3,3,6,2018,8,15,Wednseday
3,8,9,17,2018,8,12,Sunday
11,32,8,40,2018,1,6,Saturday
3,15,6,21,2018,4,4,Wednseday
1,7,11,18,2018,5,14,Monday
1,3,8,11,2018,6,18,Monday
11,11,40,51,2016,10,10,Monday
6,7,12,19,2017,7,20,Thursday
1,2,10,12,2018,3,7,Wednseday
1,37,-3,34,2018,1,4,Thursday
1,2,13,15,2017,8,21,Monday
3,31,-1,30,2017,11,26,Sunday
2,25,-2,23,2018,7,2,Monday
2,4,12,16,2018,8,4,Saturday
3,3,17,20,2018,3,24,Saturday
2,24,0,24,2017,11,12,Sunday
1,8,16,24,2017,7,24,Monday
2,24,2,26,2018,4,15,Sunday
2,5,18,23,2018,1,22,Monday
2,7,15,22,2017,8,2,Wednseday
5,11,10,21,2017,3,10,Friday
8,13,5,18,2017,5,21,Sunday
7,13,14,27,2017,9,6,Wednseday
12,16,3,19,2018,8,1,Wednseday
4,25,2,27,2017,8,18,Friday
4,13,20,33,2017,11,24,Friday
1,7,10,17,2017,9,5,Tuesday
3,9,30,39,2017,3,18,Saturday
1,8,4,12,2018,5,20,Sunday
0,7,7,14,2018,8,16,Thursday
4,6,6,12,2017,7,16,Sunday
1,14,4,18,2018,1,4,Thursday
5,10,10,20,2017,12,7,Thursday
4,5,8,13,2017,6,22,Thursday
1,8,22,30,2017,12,18,Monday
3,12,13,25,2017,6,2,Friday
5,11,19,30,2018,3,24,Saturday
6,12,8,20,2018,4,21,Saturday
6,17,14,31,2017,5,26,Friday
3,10,9,19,2018,7,20,Friday
11,18,30,48,2018,8,11,Saturday
6,7,15,22,2018,3,29,Thursday
1,8,13,21,2018,1,16,Tuesday
1,10,19,29,2018,4,24,Tuesday
7,8,8,16,2018,6,13,Wednseday
0,1,13,14,2017,11,8,Wednseday
1,3,7,10,2018,4,3,Tuesday
1,7,9,16,2018,8,21,Tuesday
16,17,5,22,2017,11,5,Sunday
7,19,21,40,2017,4,20,Thursday
1,3,0,3,2018,8,21,Tuesday
2,26,0,26,2017,4,23,Sunday
1,3,11,14,2018,5,1,Tuesday
2,6,24,30,2017,2,15,Wednseday
1,9,18,27,2017,11,30,Thursday
5,16,15,31,2017,11,11,Saturday
2,6,14,20,2018,8,7,Tuesday
7,10,4,14,2017,11,24,Friday
3,10,11,21,2018,5,4,Friday
1,6,8,14,2018,2,8,Thursday
1,1,22,23,2017,6,18,Sunday
10,15,8,23,2017,3,4,Saturday
5,6,11,17,2017,8,27,Sunday
2,21,11,32,2018,3,5,Monday
13,15,-2,13,2017,10,11,Wednseday
2,8,5,13,2017,7,25,Tuesday
1,2,14,16,2018,1,31,Wednseday
1,26,-4,22,2018,2,25,Sunday
2,8,14,22,2018,7,17,Tuesday
1,9,8,17,2018,8,19,Sunday
0,6,19,25,2017,6,2,Friday
5,6,7,13,2017,10,12,Thursday
4,6,12,18,2018,4,29,Sunday
6,11,8,19,2017,8,31,Thursday
6,9,5,14,2018,3,28,Wednseday
4,14,20,34,2017,6,15,Thursday
5,19,4,23,2018,1,31,Wednseday
5,25,6,31,2017,12,2,Saturday
6,16,10,26,2018,3,7,Wednseday
4,12,29,41,2017,5,26,Friday
1,9,15,24,2017,11,27,Monday
1,16,11,27,2017,11,7,Tuesday
3,7,10,17,2017,11,20,Monday
5,13,13,26,2017,12,13,Wednseday
1,8,20,28,2017,5,23,Tuesday
4,12,14,26,2017,8,11,Friday
4,18,6,24,2017,11,26,Sunday
2,33,0,33,2017,7,16,Sunday
8,11,-4,7,2018,8,2,Thursday
1,6,24,30,2018,5,2,Wednseday
2,3,12,15,2018,2,18,Sunday
2,16,5,21,2017,3,21,Tuesday
2,11,23,34,2017,11,25,Saturday
1,11,14,25,2017,11,19,Sunday
2,6,5,11,2018,8,18,Saturday
1,9,32,41,2018,2,28,Wednseday
4,5,8,13,2017,6,29,Thursday
2,8,17,25,2017,7,16,Sunday
1,11,10,21,2017,9,18,Monday
3,17,8,25,2018,5,18,Friday
3,13,28,41,2018,1,5,Friday
2,10,10,20,2017,8,15,Tuesday
4,12,10,22,2017,9,28,Thursday
1,9,17,26,2018,4,19,Thursday
6,10,5,15,2018,6,26,Tuesday
2,5,18,23,2017,3,5,Sunday
1,11,39,50,2017,8,28,Monday
0,8,22,30,2017,7,10,Monday
2,9,14,23,2018,4,23,Monday
0,8,15,23,2018,6,20,Wednseday
12,17,30,47,2017,2,8,Wednseday
4,18,4,22,2017,7,3,Monday
1,13,18,31,2017,12,5,Tuesday
1,2,17,19,2018,6,24,Sunday
1,7,24,31,2017,3,13,Monday
8,15,19,34,2017,4,19,Wednseday
1,16,16,32,2017,12,14,Thursday
1,9,21,30,2017,12,10,Sunday
0,3,5,8,2018,8,7,Tuesday
2,10,20,30,2018,4,15,Sunday
1,6,14,20,2017,12,21,Thursday
5,14,14,28,2018,2,14,Wednseday
6,19,26,45,2018,1,9,Tuesday
2,9,21,30,2018,7,22,Sunday
3,7,21,28,2018,8,6,Monday
4,13,13,26,2018,7,12,Thursday
3,7,16,23,2018,4,16,Monday
1,17,7,24,2017,10,3,Tuesday
3,16,6,22,2018,7,31,Tuesday
11,19,13,32,2017,7,15,Saturday
11,33,-6,27,2017,4,8,Saturday
1,9,27,36,2018,8,15,Wednseday
2,14,10,24,2018,5,1,Tuesday
2,42,-15,27,2017,8,8,Tuesday
4,11,4,15,2018,1,18,Thursday
7,10,6,16,2018,1,29,Monday
3,9,24,33,2018,4,7,Saturday
10,18,2,20,2017,11,24,Friday
2,6,16,22,2017,7,26,Wednseday
1,7,5,12,2018,3,14,Wednseday
9,27,14,41,2017,12,19,Tuesday
4,11,8,19,2017,10,12,Thursday
2,16,13,29,2017,11,12,Sunday
0,18,15,33,2017,2,23,Thursday
2,16,18,34,2017,6,17,Saturday
1,8,21,29,2018,6,26,Tuesday
1,8,12,20,2017,11,16,Thursday
1,6,28,34,2017,5,23,Tuesday
2,9,16,25,2018,4,5,Thursday
9,14,39,53,2018,1,13,Saturday
1,4,15,19,2017,7,30,Sunday
3,17,20,37,2017,12,23,Saturday
17,20,-6,14,2018,2,27,Tuesday
4,5,12,17,2017,6,16,Friday
18,19,9,28,2018,3,23,Friday
4,13,22,35,2017,1,26,Thursday
3,6,11,17,2018,7,28,Saturday
2,6,17,23,2017,10,11,Wednseday
3,17,22,39,2017,6,11,Sunday
0,7,6,13,2018,8,8,Wednseday
7,8,7,15,2018,2,14,Wednseday
2,7,36,43,2018,6,5,Tuesday
0,3,18,21,2018,8,7,Tuesday
6,10,5,15,2018,6,13,Wednseday
2,22,5,27,2017,4,25,Tuesday
2,5,10,15,2018,2,14,Wednseday
3,13,32,45,2017,10,13,Friday
12,23,-1,22,2017,9,13,Wednseday
2,14,8,22,2018,2,28,Wednseday
11,21,7,28,2018,7,30,Monday
8,13,24,37,2017,2,1,Wednseday
2,14,13,27,2017,3,29,Wednseday
1,4,1,5,2018,8,16,Thursday
3,8,11,19,2017,10,13,Friday
0,12,14,26,2017,11,9,Thursday
3,9,16,25,2018,1,15,Monday
2,5,2,7,2018,8,15,Wednseday
3,10,18,28,2018,5,7,Monday
3,7,20,27,2017,11,24,Friday
3,11,15,26,2017,11,24,Friday
1,13,11,24,2018,2,18,Sunday
2,23,7,30,2018,2,17,Saturday
5,13,14,27,2018,3,9,Friday
7,23,12,35,2018,1,29,Monday
1,2,11,13,2017,8,23,Wednseday
4,17,1,18,2017,9,16,Saturday
2,12,21,33,2017,5,27,Saturday
3,7,15,22,2017,10,3,Tuesday
7,11,24,35,2017,12,6,Wednseday
1,9,19,28,2017,7,18,Tuesday
1,18,7,25,2017,11,27,Monday
1,4,14,18,2017,4,23,Sunday
5,6,8,14,2017,11,17,Friday
5,14,24,38,2017,8,11,Friday
2,11,14,25,2017,5,28,Sunday
0,8,14,22,2018,3,29,Thursday
3,7,9,16,2018,7,17,Tuesday
2,85,-66,19,2018,2,25,Sunday
2,15,16,31,2018,1,9,Tuesday
1,2,15,17,2017,10,1,Sunday
5,21,10,31,2017,12,22,Friday
7,13,14,27,2017,9,22,Friday
0,7,14,21,2018,4,25,Wednseday
3,15,18,33,2018,5,20,Sunday
0,6,17,23,2018,3,27,Tuesday
6,10,14,24,2018,7,7,Saturday
5,6,8,14,2018,2,9,Friday
2,9,11,20,2017,11,7,Tuesday
1,6,14,20,2017,12,14,Thursday
1,6,29,35,2018,7,24,Tuesday
2,11,8,19,2018,5,13,Sunday
4,22,0,22,2017,8,14,Monday
1,10,18,28,2018,1,22,Monday
3,12,7,19,2017,11,18,Saturday
1,7,22,29,2018,8,13,Monday
4,19,13,32,2017,6,4,Sunday
3,12,8,20,2018,2,24,Saturday
5,12,18,30,2017,4,29,Saturday
1,7,14,21,2018,1,18,Thursday
6,17,8,25,2017,11,25,Saturday
3,10,10,20,2017,7,21,Friday
1,12,14,26,2017,7,12,Wednseday
10,16,4,20,2018,7,31,Tuesday
6,22,7,29,2017,11,2,Thursday
4,9,16,25,2017,7,9,Sunday
1,5,8,13,2018,3,28,Wednseday
3,9,19,28,2018,4,24,Tuesday
9,14,14,28,2017,5,9,Tuesday
6,8,6,14,2017,11,24,Friday
14,20,18,38,2017,11,25,Saturday
1,2,7,9,2018,6,11,Monday
0,5,15,20,2018,6,29,Friday
4,6,6,12,2018,3,2,Friday
2,8,21,29,2018,1,9,Tuesday
3,9,16,25,2017,11,5,Sunday
1,11,20,31,2017,7,11,Tuesday
6,10,15,25,2017,5,5,Friday
3,10,15,25,2017,5,26,Friday
6,32,-5,27,2017,8,31,Thursday
4,11,13,24,2017,5,6,Saturday
2,3,10,13,2017,9,6,Wednseday
1,4,7,11,2018,8,12,Sunday
4,10,13,23,2017,8,21,Monday
0,2,21,23,2018,7,4,Wednseday
1,8,21,29,2018,6,28,Thursday
9,13,6,19,2017,11,26,Sunday
1,8,16,24,2018,1,28,Sunday
1,6,22,28,2018,7,3,Tuesday
2,12,0,12,2018,3,15,Thursday
1,3,14,17,2017,12,11,Monday
4,12,49,61,2017,4,7,Friday
14,19,10,29,2018,1,4,Thursday
5,7,11,18,2017,8,17,Thursday
7,9,62,71,2017,2,15,Wednseday
0,7,24,31,2018,6,11,Monday
1,10,6,16,2017,9,19,Tuesday
1,13,17,30,2018,3,7,Wednseday
3,10,15,25,2017,12,2,Saturday
8,10,19,29,2017,3,14,Tuesday
5,12,13,25,2017,8,17,Thursday
2,9,25,34,2018,1,2,Tuesday
3,16,3,19,2017,7,30,Sunday
0,9,34,43,2018,7,4,Wednseday
2,10,13,23,2017,6,18,Sunday
5,12,12,24,2017,9,29,Friday
1,6,8,14,2018,8,1,Wednseday
1,9,29,38,2018,4,2,Monday
5,12,14,26,2017,8,3,Thursday
1,8,19,27,2017,9,28,Thursday
0,7,4,11,2018,8,6,Monday
1,13,7,20,2017,10,10,Tuesday
2,5,13,18,2017,12,2,Saturday
3,10,3,13,2018,6,22,Friday
1,9,26,35,2018,2,6,Tuesday
3,18,10,28,2018,1,5,Friday
1,6,22,28,2018,6,19,Tuesday
1,4,11,15,2018,1,18,Thursday
1,5,22,27,2017,7,13,Thursday
1,6,16,22,2017,4,12,Wednseday
1,35,-9,26,2018,4,18,Wednseday
6,6,13,19,2018,4,14,Saturday
2,20,11,31,2017,5,2,Tuesday
2,4,12,16,2018,4,2,Monday
2,18,4,22,2018,5,21,Monday
7,13,7,20,2017,11,21,Tuesday
1,12,17,29,2018,2,22,Thursday
6,16,7,23,2017,3,21,Tuesday
2,9,20,29,2017,12,18,Monday
3,8,15,23,2017,2,27,Monday
2,10,29,39,2018,1,21,Sunday
3,9,14,23,2017,8,1,Tuesday
1,4,11,15,2017,11,26,Sunday
0,16,12,28,2018,5,2,Wednseday
1,19,22,41,2017,3,29,Wednseday
0,13,7,20,2017,11,9,Thursday
4,12,21,33,2017,9,21,Thursday
3,13,7,20,2017,11,24,Friday
9,12,33,45,2018,6,2,Saturday
2,9,22,31,2017,7,30,Sunday
6,26,-1,25,2018,5,3,Thursday
3,7,17,24,2017,9,8,Friday
1,10,26,36,2017,2,12,Sunday
4,11,15,26,2018,2,3,Saturday
1,7,17,24,2017,10,17,Tuesday
3,9,21,30,2018,4,29,Sunday
3,12,13,25,2017,5,13,Saturday
3,12,10,22,2017,8,28,Monday
3,25,-4,21,2018,3,12,Monday
1,22,2,24,2018,3,20,Tuesday
14,36,-8,28,2017,12,5,Tuesday
1,2,17,19,2017,12,7,Thursday
4,14,12,26,2018,1,19,Friday
4,12,17,29,2018,3,22,Thursday
1,4,14,18,2018,2,1,Thursday
10,14,32,46,2017,1,30,Monday
4,11,8,19,2017,3,24,Friday
1,7,19,26,2018,6,21,Thursday
4,12,22,34,2018,1,27,Saturday
11,20,0,20,2017,11,24,Friday
5,14,15,29,2018,1,10,Wednseday
1,5,1,6,2018,8,9,Thursday
1,7,7,14,2018,8,8,Wednseday
6,8,11,19,2018,7,4,Wednseday
1,26,17,43,2018,7,4,Wednseday
5,11,28,39,2018,6,8,Friday
2,6,14,20,2017,8,15,Tuesday
5,6,6,12,2018,5,16,Wednseday
7,20,9,29,2017,11,23,Thursday
1,14,24,38,2017,1,30,Monday
4,8,12,20,2017,11,10,Friday
1,6,8,14,2017,6,6,Tuesday
3,4,15,19,2017,12,9,Saturday
4,9,14,23,2018,6,25,Monday
2,9,14,23,2018,7,28,Saturday
5,8,13,21,2018,6,28,Thursday
9,16,5,21,2017,4,24,Monday
5,5,8,13,2018,3,23,Friday
3,14,12,26,2018,1,12,Friday
3,15,8,23,2017,10,17,Tuesday
5,24,12,36,2018,3,4,Sunday
1,10,5,15,2018,7,22,Sunday
2,8,15,23,2017,3,13,Monday
5,12,24,36,2018,6,6,Wednseday
0,3,21,24,2018,5,15,Tuesday
7,33,-7,26,2018,5,11,Friday
0,1,8,9,2018,6,11,Monday
1,7,10,17,2018,4,2,Monday
1,9,15,24,2018,2,5,Monday
4,24,-6,18,2018,3,10,Saturday
1,8,14,22,2017,9,26,Tuesday
2,11,12,23,2017,9,4,Monday
2,4,22,26,2017,11,25,Saturday
1,3,18,21,2017,4,5,Wednseday
1,4,20,24,2017,6,5,Monday
1,8,15,23,2018,7,16,Monday
7,15,9,24,2017,12,19,Tuesday
3,5,11,16,2018,1,31,Wednseday
11,21,15,36,2017,12,7,Thursday
6,13,10,23,2018,1,24,Wednseday
3,15,7,22,2017,2,28,Tuesday
0,5,17,22,2018,1,31,Wednseday
7,31,-8,23,2018,5,9,Wednseday
12,20,-1,19,2018,3,30,Friday
3,6,12,18,2017,10,7,Saturday
2,3,2,5,2018,8,4,Saturday
2,9,12,21,2018,1,15,Monday
6,7,8,15,2018,6,19,Tuesday
1,7,14,21,2018,8,21,Tuesday
1,7,13,20,2018,8,8,Wednseday
3,6,9,15,2018,1,23,Tuesday
3,19,16,35,2018,1,12,Friday
1,8,21,29,2018,7,23,Monday
1,2,9,11,2018,8,19,Sunday
5,7,21,28,2018,4,20,Friday
3,4,20,24,2018,2,2,Friday
6,12,9,21,2017,10,26,Thursday
1,20,30,50,2018,6,13,Wednseday
1,3,19,22,2017,3,6,Monday
4,9,24,33,2018,6,21,Thursday
3,16,18,34,2018,4,4,Wednseday
4,7,17,24,2018,8,6,Monday
1,4,20,24,2018,6,18,Monday
1,6,11,17,2018,3,20,Tuesday
0,23,4,27,2018,3,27,Tuesday
3,5,9,14,2018,1,26,Friday
2,10,21,31,2018,6,12,Tuesday
4,13,19,32,2017,11,10,Friday
2,16,14,30,2017,11,5,Sunday
2,6,14,20,2017,7,5,Wednseday
5,16,14,30,2017,8,27,Sunday
1,13,12,25,2018,5,10,Thursday
5,20,0,20,2018,2,16,Friday
2,7,14,21,2018,7,16,Monday
2,8,6,14,2017,11,27,Monday
2,4,11,15,2018,1,22,Monday
2,4,15,19,2018,6,16,Saturday
9,17,8,25,2017,4,3,Monday
0,3,18,21,2018,1,16,Tuesday
4,10,14,24,2017,8,7,Monday
2,7,19,26,2017,12,20,Wednseday
2,8,10,18,2017,3,26,Sunday
6,12,6,18,2017,10,13,Friday
1,8,11,19,2017,8,6,Sunday
2,8,12,20,2017,8,8,Tuesday
5,18,11,29,2017,8,17,Thursday
1,9,21,30,2018,6,19,Tuesday
1,6,10,16,2018,7,18,Wednseday
3,13,21,34,2017,12,1,Friday
3,32,0,32,2018,1,20,Saturday
1,7,9,16,2018,4,10,Tuesday
1,2,7,9,2018,5,8,Tuesday
2,10,21,31,2018,5,13,Sunday
2,4,11,15,2018,5,13,Sunday
3,8,13,21,2018,1,16,Tuesday
6,18,7,25,2017,4,1,Saturday
2,2,16,18,2018,2,1,Thursday
1,7,19,26,2017,3,1,Wednseday
1,5,18,23,2017,5,31,Wednseday
5,18,12,30,2018,1,21,Sunday
10,18,19,37,2017,4,9,Sunday
3,15,9,24,2017,12,11,Monday
6,17,7,24,2017,11,3,Friday
2,20,5,25,2018,3,1,Thursday
12,21,14,35,2017,10,20,Friday
6,12,16,28,2017,7,12,Wednseday
4,17,25,42,2018,6,18,Monday
1,16,12,28,2018,4,24,Tuesday
4,6,4,10,2018,3,13,Tuesday
0,4,17,21,2018,1,15,Monday
1,2,10,12,2017,6,25,Sunday
3,7,9,16,2018,2,18,Sunday
3,4,21,25,2018,6,1,Friday
2,30,0,30,2017,6,28,Wednseday
0,1,8,9,2018,8,28,Tuesday
4,13,22,35,2018,3,30,Friday
6,7,5,12,2018,8,23,Thursday
10,14,17,31,2018,1,8,Monday
2,16,13,29,2017,12,10,Sunday
6,11,15,26,2018,7,13,Friday
6,7,15,22,2017,5,11,Thursday
4,6,19,25,2017,8,17,Thursday
1,12,23,35,2017,5,4,Thursday
5,8,4,12,2017,7,2,Sunday
3,9,19,28,2018,5,8,Tuesday
1,12,18,30,2018,1,15,Monday
2,5,18,23,2018,2,17,Saturday
3,8,17,25,2018,7,27,Friday
1,18,3,21,2017,3,16,Thursday
2,9,10,19,2017,8,30,Wednseday
7,39,-8,31,2018,2,2,Friday
1,13,35,48,2018,2,6,Tuesday
3,14,21,35,2018,6,15,Friday
3,21,4,25,2018,2,23,Friday
1,8,13,21,2018,5,15,Tuesday
1,7,24,31,2018,4,10,Tuesday
1,12,18,30,2018,5,2,Wednseday
2,11,20,31,2018,6,23,Saturday
2,9,18,27,2017,5,27,Saturday
2,10,12,22,2018,4,24,Tuesday
11,17,1,18,2017,9,3,Sunday
1,8,28,36,2018,6,7,Thursday
2,5,20,25,2018,2,4,Sunday
1,7,10,17,2018,3,20,Tuesday
1,6,35,41,2017,2,1,Wednseday
1,9,14,23,2017,8,28,Monday
1,12,1,13,2018,8,9,Thursday
3,11,17,28,2017,3,10,Friday
1,5,13,18,2017,9,28,Thursday
2,3,9,12,2018,7,21,Saturday
50,56,-15,41,2018,6,13,Wednseday
1,9,19,28,2018,2,5,Monday
7,9,3,12,2018,3,15,Thursday
1,18,6,24,2018,4,3,Tuesday
3,19,6,25,2018,6,8,Friday
3,14,18,32,2017,10,6,Friday
1,9,17,26,2017,8,27,Sunday
4,5,7,12,2018,3,2,Friday
2,8,23,31,2018,5,14,Monday
5,6,7,13,2017,9,6,Wednseday
1,7,29,36,2018,7,2,Monday
3,4,15,19,2018,4,29,Sunday
2,11,13,24,2017,3,27,Monday
3,14,11,25,2017,11,25,Saturday
1,9,12,21,2017,10,17,Tuesday
1,3,8,11,2017,10,23,Monday
7,14,8,22,2017,7,31,Monday
2,9,15,24,2017,7,8,Saturday
1,20,9,29,2017,9,27,Wednseday
4,17,9,26,2017,11,3,Friday
1,11,27,38,2017,5,7,Sunday
1,4,12,16,2017,9,19,Tuesday
1,3,24,27,2017,2,14,Tuesday
1,2,2,4,2018,7,30,Monday
1,2,12,14,2018,7,30,Monday
1,8,17,25,2017,10,16,Monday
6,12,13,25,2017,12,30,Saturday
4,5,10,15,2018,2,26,Monday
3,8,20,28,2018,4,16,Monday
0,15,19,34,2018,2,8,Thursday
2,4,8,12,2018,7,22,Sunday
3,10,-2,8,2018,7,30,Monday
1,9,7,16,2017,11,21,Tuesday
15,25,0,25,2018,7,23,Monday
1,7,16,23,2018,1,9,Tuesday
3,16,7,23,2017,11,7,Tuesday
12,20,8,28,2017,1,25,Wednseday
1,4,12,16,2018,5,14,Monday
1,11,15,26,2018,1,4,Thursday
2,9,7,16,2017,9,12,Tuesday
1,5,14,19,2018,7,4,Wednseday
2,6,14,20,2017,7,29,Saturday
3,37,-15,22,2018,2,27,Tuesday
4,6,14,20,2018,2,23,Friday
3,13,12,25,2018,7,13,Friday
3,6,29,35,2018,3,30,Friday
1,5,10,15,2018,7,30,Monday
3,20,15,35,2017,6,13,Tuesday
3,4,7,11,2018,7,8,Sunday
5,11,11,22,2018,4,5,Thursday
4,7,42,49,2016,10,7,Friday
3,14,30,44,2018,2,7,Wednseday
0,6,20,26,2017,5,18,Thursday
1,9,0,9,2018,8,20,Monday
2,5,15,20,2018,2,17,Saturday
3,14,9,23,2017,11,6,Monday
0,2,21,23,2018,3,26,Monday
1,8,18,26,2017,10,8,Sunday
1,16,9,25,2018,4,9,Monday
2,9,9,18,2018,7,2,Monday
7,12,13,25,2018,5,10,Thursday
3,21,9,30,2017,12,18,Monday
10,12,-1,11,2018,4,9,Monday
6,19,7,26,2017,11,24,Friday
5,23,13,36,2017,12,11,Monday
1,30,-13,17,2018,5,8,Tuesday
0,12,2,14,2018,8,17,Friday
2,5,13,18,2017,11,30,Thursday
1,12,15,27,2017,2,23,Thursday
4,13,24,37,2017,6,10,Saturday
4,14,5,19,2018,3,15,Thursday
0,12,18,30,2017,11,1,Wednseday
3,4,14,18,2018,4,22,Sunday
0,11,18,29,2017,8,21,Monday
2,8,13,21,2018,2,21,Wednseday
4,17,8,25,2017,5,5,Friday
0,11,14,25,2017,6,8,Thursday
3,10,13,23,2018,7,1,Sunday
1,12,16,28,2018,2,7,Wednseday
6,17,15,32,2018,4,27,Friday
1,13,9,22,2017,6,27,Tuesday
5,21,6,27,2017,12,13,Wednseday
2,7,15,22,2018,5,7,Monday
1,51,-28,23,2018,3,13,Tuesday
1,3,12,15,2017,10,29,Sunday
1,37,-15,22,2017,3,5,Sunday
1,2,15,17,2018,7,2,Monday
4,7,11,18,2017,9,15,Friday
2,5,11,16,2017,9,18,Monday
2,9,8,17,2018,4,1,Sunday
1,12,17,29,2017,6,7,Wednseday
3,11,15,26,2018,4,27,Friday
2,7,17,24,2017,10,24,Tuesday
2,10,15,25,2018,4,22,Sunday
7,15,12,27,2017,12,20,Wednseday
2,4,7,11,2018,6,24,Sunday
2,10,9,19,2017,8,27,Sunday
18,27,1,28,2018,5,11,Friday
2,3,12,15,2017,6,4,Sunday
4,19,10,29,2017,3,9,Thursday
1,12,22,34,2017,3,15,Wednseday
2,3,7,10,2018,5,7,Monday
3,5,12,17,2017,9,17,Sunday
3,24,-6,18,2018,3,31,Saturday
1,5,9,14,2018,8,22,Wednseday
2,14,20,34,2018,1,17,Wednseday
2,6,13,19,2017,9,2,Saturday
5,25,0,25,2018,2,15,Thursday
3,14,26,40,2018,5,25,Friday
7,8,8,16,2017,12,4,Monday
1,7,18,25,2018,7,26,Thursday
11,15,12,27,2017,11,30,Thursday
4,19,17,36,2017,7,27,Thursday
4,11,9,20,2017,11,10,Friday
0,11,18,29,2018,6,21,Thursday
4,7,11,18,2018,7,21,Saturday
5,29,12,41,2017,2,16,Thursday
10,16,14,30,2017,3,28,Tuesday
3,4,8,12,2018,6,16,Saturday
1,4,19,23,2018,1,22,Monday
6,13,17,30,2017,11,11,Saturday
1,3,15,18,2018,3,26,Monday
4,19,14,33,2018,1,18,Thursday
6,32,-11,21,2018,5,17,Thursday
1,7,17,24,2018,1,23,Tuesday
22,36,-3,33,2018,3,1,Thursday
4,17,8,25,2017,8,19,Saturday
3,5,6,11,2018,5,18,Friday
7,11,16,27,2018,6,7,Thursday
1,10,12,22,2017,8,7,Monday
3,7,20,27,2018,4,17,Tuesday
5,8,7,15,2018,2,11,Sunday
2,4,7,11,2018,5,21,Monday
5,21,6,27,2018,2,14,Wednseday
1,4,25,29,2017,2,13,Monday
6,19,17,36,2017,10,11,Wednseday
2,28,-5,23,2018,3,19,Monday
1,2,12,14,2017,11,8,Wednseday
3,8,8,16,2018,3,5,Monday
3,4,18,22,2017,5,22,Monday
3,7,9,16,2018,7,17,Tuesday
1,5,8,13,2017,8,24,Thursday
2,10,13,23,2017,10,3,Tuesday
1,14,15,29,2018,8,15,Wednseday
7,19,10,29,2017,3,2,Thursday
2,14,26,40,2017,2,15,Wednseday
4,11,18,29,2017,4,9,Sunday
8,26,-10,16,2017,11,22,Wednseday
5,7,11,18,2018,5,10,Thursday
2,9,6,15,2017,9,25,Monday
1,6,8,14,2017,10,10,Tuesday
4,11,14,25,2018,1,5,Friday
4,13,15,28,2017,12,7,Thursday
8,22,1,23,2017,12,13,Wednseday
1,11,15,26,2017,10,15,Sunday
2,8,9,17,2018,8,19,Sunday
6,11,17,28,2018,7,19,Thursday
10,18,11,29,2018,1,2,Tuesday
2,11,6,17,2018,8,6,Monday
3,20,2,22,2017,8,15,Tuesday
0,2,6,8,2018,5,22,Tuesday
1,7,21,28,2017,2,23,Thursday
1,11,13,24,2017,2,5,Sunday
23,28,6,34,2018,5,30,Wednseday
3,11,13,24,2017,6,23,Friday
5,34,1,35,2017,11,30,Thursday
0,5,19,24,2018,6,11,Monday
4,17,9,26,2017,12,3,Sunday
1,5,7,12,2018,8,2,Thursday
23,31,-9,22,2017,7,18,Tuesday
12,19,3,22,2017,11,26,Sunday
4,12,10,22,2017,10,12,Thursday
4,8,14,22,2018,1,16,Tuesday
10,24,7,31,2017,1,27,Friday
1,13,13,26,2017,11,15,Wednseday
7,20,8,28,2017,7,27,Thursday
2,4,16,20,2017,7,29,Saturday
2,12,12,24,2017,11,4,Saturday
1,9,13,22,2017,11,12,Sunday
3,25,0,25,2018,2,16,Friday
8,9,7,16,2018,1,3,Wednseday
1,14,7,21,2017,9,5,Tuesday
5,7,7,14,2017,11,16,Thursday
1,8,17,25,2017,11,9,Thursday
2,7,13,20,2017,12,27,Wednseday
2,26,-5,21,2017,10,11,Wednseday
1,6,25,31,2018,5,29,Tuesday
0,6,8,14,2018,7,17,Tuesday
1,12,8,20,2017,3,30,Thursday
5,9,16,25,2017,3,26,Sunday
1,8,14,22,2017,7,20,Thursday
2,3,7,10,2018,7,23,Monday
0,12,12,24,2017,3,24,Friday
7,24,0,24,2018,2,20,Tuesday
2,14,14,28,2018,4,23,Monday
2,6,12,18,2017,10,22,Sunday
0,8,23,31,2017,12,11,Monday
14,31,10,41,2018,2,3,Saturday
2,4,19,23,2017,8,21,Monday
2,11,19,30,2018,2,5,Monday
3,9,15,24,2018,2,24,Saturday
5,30,-4,26,2018,2,16,Friday
1,11,12,23,2017,7,30,Sunday
4,40,-11,29,2017,12,10,Sunday
7,8,1,9,2018,8,13,Monday
8,28,22,50,2017,2,13,Monday
2,3,11,14,2018,2,12,Monday
2,17,23,40,2018,1,21,Sunday
1,9,7,16,2018,5,14,Monday
2,3,10,13,2018,8,11,Saturday
4,21,13,34,2018,4,6,Friday
3,10,19,29,2017,9,5,Tuesday
4,11,44,55,2018,3,9,Friday
3,11,17,28,2018,8,17,Friday
0,18,7,25,2017,11,24,Friday
3,4,9,13,2018,3,23,Friday
3,6,17,23,2017,8,22,Tuesday
4,12,26,38,2018,8,10,Friday
1,9,21,30,2018,1,16,Tuesday
1,7,35,42,2017,1,23,Monday
3,10,7,17,2018,8,5,Sunday
3,13,16,29,2018,1,10,Wednseday
9,20,19,39,2017,8,26,Saturday
1,19,27,46,2017,11,30,Thursday
2,8,17,25,2018,8,5,Sunday
2,15,4,19,2018,3,25,Sunday
4,7,13,20,2017,9,15,Friday
3,33,0,33,2018,1,20,Saturday
9,25,10,35,2017,12,11,Monday
1,17,5,22,2018,2,28,Wednseday
1,15,20,35,2018,2,5,Monday
2,14,8,22,2017,8,15,Tuesday
3,13,14,27,2018,1,20,Saturday
2,23,6,29,2017,12,19,Tuesday
7,16,4,20,2018,5,10,Thursday
1,8,14,22,2017,3,28,Tuesday
2,16,16,32,2018,5,28,Monday
1,12,24,36,2018,6,13,Wednseday
3,11,14,25,2017,8,26,Saturday
11,11,3,14,2017,11,14,Tuesday
4,9,-6,3,2018,8,6,Monday
2,15,6,21,2017,11,28,Tuesday
9,25,0,25,2018,1,22,Monday
5,7,17,24,2018,6,29,Friday
1,16,10,26,2018,2,28,Wednseday
5,10,13,23,2018,1,8,Monday
1,8,14,22,2018,5,14,Monday
1,6,1,7,2018,8,8,Wednseday
2,8,14,22,2017,3,19,Sunday
3,11,9,20,2017,9,1,Friday
4,15,11,26,2017,9,24,Sunday
3,8,6,14,2017,11,13,Monday
1,6,17,23,2018,1,17,Wednseday
7,9,11,20,2017,12,26,Tuesday
1,11,27,38,2018,4,15,Sunday
1,13,7,20,2017,11,28,Tuesday
1,9,13,22,2017,7,26,Wednseday
3,14,12,26,2017,8,11,Friday
3,9,9,18,2018,8,4,Saturday
4,10,11,21,2017,11,24,Friday
4,22,12,34,2017,11,24,Friday
2,35,-2,33,2018,3,7,Wednseday
1,23,1,24,2017,7,10,Monday
1,7,21,28,2018,7,18,Wednseday
0,6,27,33,2018,5,10,Thursday
1,4,18,22,2018,2,1,Thursday
2,9,21,30,2018,2,6,Tuesday
6,14,6,20,2017,3,30,Thursday
1,10,20,30,2018,2,5,Monday
7,17,6,23,2018,3,12,Monday
3,16,18,34,2018,1,13,Saturday
1,6,14,20,2018,6,28,Thursday
4,68,-48,20,2018,3,2,Friday
1,15,8,23,2018,1,10,Wednseday
1,9,15,24,2018,1,8,Monday
1,16,8,24,2018,2,20,Tuesday
2,33,4,37,2017,2,15,Wednseday
2,3,6,9,2018,5,15,Tuesday
4,18,1,19,2018,3,31,Saturday
2,6,11,17,2018,7,28,Saturday
1,9,16,25,2018,8,16,Thursday
3,4,14,18,2018,6,15,Friday
1,17,5,22,2018,5,16,Wednseday
2,16,-5,11,2018,6,10,Sunday
12,17,7,24,2018,6,24,Sunday
5,11,16,27,2017,2,24,Friday
4,10,11,21,2017,11,24,Friday
0,4,20,24,2017,5,15,Monday
1,9,13,22,2017,11,15,Wednseday
0,7,15,22,2017,5,15,Monday
1,5,9,14,2018,6,28,Thursday
3,10,9,19,2018,5,5,Saturday
3,6,10,16,2018,8,11,Saturday
4,15,17,32,2017,10,2,Monday
3,9,15,24,2017,12,4,Monday
4,10,16,26,2018,7,28,Saturday
1,3,19,22,2017,3,28,Tuesday
1,2,11,13,2017,5,16,Tuesday
8,16,40,56,2018,4,11,Wednseday
2,8,14,22,2018,7,18,Wednseday
4,14,15,29,2018,1,25,Thursday
4,5,7,12,2017,10,20,Friday
1,7,10,17,2018,7,23,Monday
6,13,23,36,2017,11,8,Wednseday
2,7,7,14,2018,4,25,Wednseday
4,49,-16,33,2017,9,21,Thursday
2,7,23,30,2017,5,9,Tuesday
3,14,20,34,2018,1,31,Wednseday
5,32,-9,23,2017,11,12,Sunday
3,7,8,15,2018,6,26,Tuesday
2,42,-9,33,2018,1,14,Sunday
5,12,7,19,2017,10,26,Thursday
4,23,6,29,2017,12,7,Thursday
4,19,9,28,2017,10,26,Thursday
12,17,17,34,2018,4,21,Saturday
6,9,4,13,2018,7,12,Thursday
6,13,21,34,2017,4,29,Saturday
1,9,18,27,2017,11,29,Wednseday
4,14,8,22,2017,8,3,Thursday
3,16,8,24,2017,4,17,Monday
5,9,20,29,2017,9,21,Thursday
3,9,10,19,2017,9,2,Saturday
1,8,10,18,2017,6,26,Monday
7,16,7,23,2017,5,3,Wednseday
2,44,-12,32,2017,12,3,Sunday
4,9,32,41,2017,1,28,Saturday
1,5,14,19,2018,8,1,Wednseday
9,23,1,24,2017,7,1,Saturday
2,5,20,25,2017,5,20,Saturday
5,43,-14,29,2017,11,27,Monday
1,3,13,16,2018,1,8,Monday
7,22,11,33,2017,12,29,Friday
3,12,12,24,2018,8,5,Sunday
4,27,7,34,2018,2,15,Thursday
0,4,20,24,2017,7,7,Friday
6,16,12,28,2018,1,10,Wednseday
2,3,8,11,2017,9,10,Sunday
1,2,11,13,2018,3,20,Tuesday
6,14,20,34,2017,4,26,Wednseday
3,5,11,16,2018,4,8,Sunday
0,1,10,11,2018,5,14,Monday
1,13,35,48,2018,5,29,Tuesday
2,8,18,26,2017,6,11,Sunday
6,10,6,16,2017,11,25,Saturday
1,6,24,30,2017,6,25,Sunday
1,6,14,20,2017,10,10,Tuesday
0,23,-1,22,2018,2,20,Tuesday
1,4,12,16,2018,5,13,Sunday
1,2,7,9,2018,4,23,Monday
2,5,21,26,2018,5,13,Sunday
1,3,21,24,2017,3,20,Monday
4,28,-1,27,2018,2,23,Friday
2,13,24,37,2017,6,6,Tuesday
2,9,15,24,2017,6,27,Tuesday
1,13,19,32,2018,4,22,Sunday
1,16,15,31,2018,6,17,Sunday
1,5,4,9,2018,8,20,Monday
3,12,13,25,2017,12,17,Sunday
2,39,-11,28,2017,12,13,Wednseday
2,7,15,22,2018,1,17,Wednseday
1,23,9,32,2018,4,26,Thursday
2,31,13,44,2018,5,1,Tuesday
14,22,12,34,2018,4,25,Wednseday
2,17,13,30,2018,2,4,Sunday
1,13,25,38,2017,4,4,Tuesday
2,31,-1,30,2018,2,12,Monday
1,10,15,25,2017,12,4,Monday
2,16,16,32,2018,4,21,Saturday
3,6,20,26,2018,4,22,Sunday
2,28,12,40,2018,4,28,Saturday
0,15,8,23,2018,5,21,Monday
1,2,10,12,2017,11,19,Sunday
4,37,-12,25,2018,3,12,Monday
13,19,6,25,2018,4,26,Thursday
5,11,13,24,2017,7,21,Friday
1,7,25,32,2018,6,14,Thursday
1,9,15,24,2018,7,2,Monday
10,13,4,17,2017,3,21,Tuesday
1,4,13,17,2018,3,4,Sunday
3,10,14,24,2018,2,23,Friday
2,8,16,24,2017,2,5,Sunday
2,8,24,32,2018,3,12,Monday
4,5,10,15,2017,8,10,Thursday
1,9,14,23,2017,8,16,Wednseday
14,31,32,63,2016,10,10,Monday
5,11,31,42,2018,8,10,Friday
1,8,13,21,2018,4,19,Thursday
1,8,12,20,2018,7,24,Tuesday
5,8,29,37,2018,6,6,Wednseday
1,4,21,25,2017,8,20,Sunday
1,21,4,25,2017,4,24,Monday
4,12,10,22,2018,1,14,Sunday
1,7,23,30,2017,10,10,Tuesday
1,4,10,14,2018,5,14,Monday
1,6,33,39,2018,4,26,Thursday
1,6,25,31,2018,7,3,Tuesday
0,3,19,22,2017,6,20,Tuesday
4,5,9,14,2018,2,16,Friday
2,10,19,29,2018,4,15,Sunday
4,17,16,33,2017,12,24,Sunday
1,3,7,10,2017,10,16,Monday
6,19,14,33,2018,5,2,Wednseday
1,10,6,16,2018,7,16,Monday
3,11,21,32,2018,1,19,Friday
2,8,15,23,2017,6,14,Wednseday
3,12,22,34,2017,6,30,Friday
2,18,8,26,2018,2,7,Wednseday
4,5,12,17,2017,12,3,Sunday
1,7,10,17,2017,10,23,Monday
3,4,12,16,2018,1,22,Monday
18,19,12,31,2018,6,22,Friday
1,9,26,35,2017,12,5,Tuesday
1,8,8,16,2018,7,25,Wednseday
1,2,13,15,2018,1,23,Tuesday
1,15,12,27,2018,4,19,Thursday
2,13,25,38,2018,7,28,Saturday
5,8,11,19,2018,7,12,Thursday
4,6,15,21,2017,12,22,Friday
4,6,11,17,2018,1,20,Saturday
4,34,-5,29,2017,8,31,Thursday
4,20,6,26,2017,7,28,Friday
3,17,28,45,2018,6,8,Friday
2,9,15,24,2018,1,7,Sunday
0,9,5,14,2018,7,12,Thursday
2,13,6,19,2017,9,10,Sunday
4,10,18,28,2018,4,13,Friday
5,12,14,26,2018,1,13,Saturday
1,8,12,20,2017,12,14,Thursday
1,8,32,40,2018,6,6,Wednseday
2,8,10,18,2017,11,20,Monday
10,17,7,24,2017,8,4,Friday
3,17,2,19,2018,3,3,Saturday
6,20,14,34,2017,7,19,Wednseday
3,5,13,18,2017,12,18,Monday
3,10,8,18,2017,11,27,Monday
1,27,-5,22,2018,3,15,Thursday
4,17,6,23,2017,10,30,Monday
2,22,-5,17,2017,9,19,Tuesday
2,8,16,24,2018,8,19,Sunday
8,28,44,72,2018,5,29,Tuesday
3,19,11,30,2018,1,31,Wednseday
1,17,4,21,2018,5,16,Wednseday
1,2,14,16,2018,4,4,Wednseday
1,8,14,22,2018,4,29,Sunday
0,12,12,24,2018,2,23,Friday
2,14,9,23,2018,1,8,Monday
2,8,20,28,2017,12,18,Monday
3,11,13,24,2017,7,15,Saturday
1,23,18,41,2017,3,15,Wednseday
3,4,6,10,2018,8,5,Sunday
1,6,10,16,2017,9,13,Wednseday
10,12,5,17,2017,8,14,Monday
5,7,7,14,2018,2,9,Friday
2,12,5,17,2017,10,15,Sunday
3,12,8,20,2018,6,29,Friday
3,10,16,26,2017,7,14,Friday
1,16,0,16,2018,5,20,Sunday
8,12,28,40,2018,4,25,Wednseday
3,6,18,24,2018,1,26,Friday
4,8,13,21,2018,5,24,Thursday
1,2,11,13,2017,8,17,Thursday
1,7,23,30,2017,10,25,Wednseday
5,25,0,25,2017,10,29,Sunday
2,10,7,17,2018,8,4,Saturday
3,16,3,19,2018,3,10,Saturday
2,14,5,19,2018,3,31,Saturday
2,9,16,25,2017,8,19,Saturday
0,8,24,32,2018,6,14,Thursday
2,8,17,25,2018,4,5,Thursday
2,11,-3,8,2018,7,23,Monday
2,10,42,52,2018,6,3,Sunday
2,50,-32,18,2018,3,19,Monday
8,13,31,44,2018,6,3,Sunday
0,1,10,11,2017,10,23,Monday
2,8,32,40,2017,12,6,Wednseday
4,5,14,19,2018,4,22,Sunday
2,3,6,9,2018,7,23,Monday
0,11,9,20,2018,7,20,Friday
6,18,3,21,2018,2,16,Friday
5,19,15,34,2018,3,24,Saturday
2,15,23,38,2017,1,24,Tuesday
2,9,14,23,2017,10,1,Sunday
3,6,18,24,2017,9,22,Friday
2,7,21,28,2017,7,24,Monday
2,17,19,36,2017,5,15,Monday
3,8,9,17,2018,5,8,Tuesday
3,15,8,23,2017,6,6,Tuesday
1,9,15,24,2017,11,26,Sunday
0,7,15,22,2017,7,26,Wednseday
1,2,12,14,2018,7,4,Wednseday
3,18,16,34,2017,5,9,Tuesday
1,4,18,22,2017,3,12,Sunday
2,20,10,30,2017,7,26,Wednseday
4,10,15,25,2018,6,29,Friday
4,9,17,26,2017,8,3,Thursday
1,2,14,16,2018,1,8,Monday
3,8,15,23,2018,7,22,Sunday
2,3,4,7,2018,8,21,Tuesday
6,10,1,11,2017,5,13,Saturday
4,14,10,24,2017,7,31,Monday
1,2,7,9,2018,5,13,Sunday
13,24,-4,20,2018,3,30,Friday
1,8,19,27,2018,8,14,Tuesday
13,21,3,24,2017,11,24,Friday
2,9,24,33,2017,6,18,Sunday
3,16,16,32,2018,6,30,Saturday
15,22,9,31,2018,1,15,Monday
1,6,35,41,2018,6,7,Thursday
3,4,4,8,2018,7,30,Monday
2,8,23,31,2018,1,30,Tuesday
2,16,5,21,2017,11,15,Wednseday
7,12,15,27,2018,4,18,Wednseday
0,7,18,25,2018,4,26,Thursday
4,7,14,21,2018,2,22,Thursday
1,2,8,10,2017,10,17,Tuesday
1,8,15,23,2018,2,27,Tuesday
5,21,19,40,2017,12,1,Friday
2,4,12,16,2018,1,14,Sunday
0,7,15,22,2017,5,16,Tuesday
6,12,8,20,2018,7,27,Friday
2,10,25,35,2018,6,11,Monday
1,11,11,22,2018,5,23,Wednseday
17,22,-7,15,2018,8,14,Tuesday
1,5,13,18,2018,3,18,Sunday
1,9,27,36,2017,5,14,Sunday
1,7,11,18,2018,7,26,Thursday
5,19,10,29,2017,12,7,Thursday
1,12,18,30,2017,4,26,Wednseday
1,2,4,6,2018,8,21,Tuesday
1,2,9,11,2018,3,18,Sunday
2,9,22,31,2017,7,30,Sunday
4,6,18,24,2017,9,29,Friday
2,9,20,29,2018,5,6,Sunday
3,5,14,19,2018,1,10,Wednseday
11,16,2,18,2017,10,9,Monday
2,4,11,15,2018,2,25,Sunday
4,6,7,13,2018,4,26,Thursday
4,18,2,20,2018,2,24,Saturday
6,15,13,28,2018,1,23,Tuesday
5,12,14,26,2017,10,8,Sunday
1,15,12,27,2017,11,16,Thursday
3,7,12,19,2018,5,4,Friday
4,18,6,24,2018,5,20,Sunday
2,34,-6,28,2017,12,19,Tuesday
1,8,22,30,2017,11,29,Wednseday
1,4,5,9,2018,7,30,Monday
1,5,28,33,2017,5,24,Wednseday
6,18,7,25,2018,1,20,Saturday
3,10,13,23,2018,2,20,Tuesday
3,13,13,26,2017,12,8,Friday
1,5,13,18,2017,12,18,Monday
2,8,17,25,2018,2,26,Monday
1,12,14,26,2018,3,29,Thursday
1,24,-7,17,2018,3,19,Monday
1,5,14,19,2017,8,13,Sunday
5,12,14,26,2017,3,9,Thursday
6,17,19,36,2017,12,12,Tuesday
1,16,11,27,2018,2,7,Wednseday
9,14,17,31,2017,6,5,Monday
5,33,-1,32,2017,12,7,Thursday
2,5,11,16,2018,2,17,Saturday
2,7,14,21,2018,5,8,Tuesday
2,6,7,13,2017,8,1,Tuesday
3,5,19,24,2017,10,6,Friday
1,7,18,25,2018,2,1,Thursday
1,12,11,23,2017,5,3,Wednseday
3,13,34,47,2017,1,27,Friday
1,6,9,15,2018,8,21,Tuesday
5,12,17,29,2017,11,19,Sunday
1,96,-74,22,2018,3,15,Thursday
5,8,44,52,2016,10,9,Sunday
9,16,9,25,2017,11,11,Saturday
4,17,20,37,2017,12,10,Sunday
4,16,15,31,2017,8,19,Saturday
2,3,10,13,2018,4,11,Wednseday
1,9,5,14,2017,6,29,Thursday
2,6,4,10,2018,8,5,Sunday
3,7,8,15,2018,4,23,Monday
2,9,9,18,2018,8,12,Sunday
1,2,13,15,2018,1,15,Monday
5,11,13,24,2018,8,3,Friday
7,13,12,25,2018,2,15,Thursday
3,8,14,22,2018,1,14,Sunday
1,10,21,31,2017,6,4,Sunday
1,7,-1,6,2018,8,8,Wednseday
0,2,8,10,2017,10,17,Tuesday
7,14,17,31,2018,4,27,Friday
2,5,4,9,2018,8,18,Saturday
4,11,8,19,2018,3,23,Friday
3,13,4,17,2018,4,8,Sunday
2,6,18,24,2017,12,12,Tuesday
1,6,3,9,2018,8,14,Tuesday
3,12,15,27,2017,10,14,Saturday
3,7,25,32,2017,8,18,Friday
3,18,14,32,2018,1,14,Sunday
8,23,13,36,2017,5,7,Sunday
1,23,12,35,2017,8,14,Monday
2,20,26,46,2017,9,24,Sunday
3,26,-6,20,2018,3,7,Wednseday
3,32,-5,27,2017,11,24,Friday
5,31,3,34,2018,2,9,Friday
1,14,8,22,2017,10,9,Monday
5,6,10,16,2018,2,10,Saturday
1,6,27,33,2018,6,24,Sunday
1,3,16,19,2018,4,4,Wednseday
2,3,3,6,2018,8,14,Tuesday
2,8,14,22,2017,11,14,Tuesday
5,16,10,26,2018,3,29,Thursday
10,17,15,32,2018,6,25,Monday
5,18,2,20,2018,8,10,Friday
2,6,6,12,2018,8,1,Wednseday
3,9,15,24,2017,5,21,Sunday
2,11,11,22,2017,7,10,Monday
5,47,-13,34,2017,5,11,Thursday
1,7,20,27,2018,8,21,Tuesday
1,20,2,22,2018,3,22,Thursday
4,18,7,25,2018,4,19,Thursday
2,10,14,24,2017,6,6,Tuesday
5,13,11,24,2017,5,7,Sunday
5,18,15,33,2018,2,11,Sunday
3,4,16,20,2017,12,16,Saturday
5,20,12,32,2017,7,27,Thursday
1,6,14,20,2017,5,23,Tuesday
4,19,2,21,2017,5,4,Thursday
12,37,8,45,2017,4,8,Saturday
2,20,-7,13,2017,5,16,Tuesday
1,8,17,25,2017,10,2,Monday
1,11,20,31,2017,8,22,Tuesday
1,3,20,23,2018,6,26,Tuesday
5,24,11,35,2018,2,9,Friday
1,7,2,9,2018,8,7,Tuesday
2,9,17,26,2018,8,18,Saturday
8,21,10,31,2018,2,6,Tuesday
4,8,5,13,2017,6,22,Thursday
1,10,14,24,2018,4,3,Tuesday
7,8,7,15,2018,2,15,Thursday
3,4,15,19,2017,6,10,Saturday
1,11,27,38,2017,1,23,Monday
9,38,-13,25,2017,12,25,Monday
2,3,9,12,2017,11,19,Sunday
3,8,20,28,2017,7,31,Monday
1,14,15,29,2018,4,3,Tuesday
2,14,16,30,2017,10,28,Saturday
0,10,22,32,2017,10,27,Friday
0,12,14,26,2017,9,14,Thursday
6,18,24,42,2017,7,13,Thursday
1,13,14,27,2017,9,20,Wednseday
1,26,-4,22,2018,3,12,Monday
1,2,15,17,2018,5,21,Monday
3,11,14,25,2018,4,27,Friday
5,7,4,11,2018,8,18,Saturday
1,7,15,22,2017,8,1,Tuesday
1,7,1,8,2017,10,31,Tuesday
3,25,9,34,2017,11,24,Friday
1,18,6,24,2018,5,15,Tuesday
3,7,7,14,2018,3,20,Tuesday
2,12,15,27,2017,9,6,Wednseday
5,7,13,20,2018,6,21,Thursday
5,7,13,20,2018,3,16,Friday
5,18,11,29,2017,6,8,Thursday
16,27,1,28,2018,7,11,Wednseday
4,33,-12,21,2018,3,2,Friday
1,25,-7,18,2018,3,19,Monday
1,16,10,26,2018,4,18,Wednseday
7,16,10,26,2018,4,12,Thursday
0,8,12,20,2017,8,2,Wednseday
3,12,9,21,2017,10,13,Friday
1,5,16,21,2018,2,14,Wednseday
2,9,14,23,2018,7,21,Saturday
3,18,15,33,2017,12,30,Saturday
1,10,19,29,2017,12,18,Monday
2,3,0,3,2018,8,20,Monday
2,15,8,23,2017,11,27,Monday
0,2,19,21,2018,6,12,Tuesday
4,8,17,25,2018,1,4,Thursday
6,13,31,44,2017,8,30,Wednseday
2,15,13,28,2018,1,22,Monday
1,4,20,24,2017,5,21,Sunday
0,11,6,17,2018,6,11,Monday
5,11,14,25,2017,3,3,Friday
2,8,13,21,2017,8,29,Tuesday
2,7,17,24,2018,1,23,Tuesday
3,22,-3,19,2018,3,14,Wednseday
3,5,7,12,2018,5,12,Saturday
3,11,21,32,2018,4,22,Sunday
1,14,18,32,2018,4,6,Friday
2,10,13,23,2017,3,21,Tuesday
1,6,12,18,2018,8,16,Thursday
0,41,-12,29,2018,2,5,Monday
3,13,8,21,2017,11,21,Tuesday
6,12,17,29,2018,8,8,Wednseday
7,8,7,15,2018,5,8,Tuesday
2,12,11,23,2017,3,1,Wednseday
2,4,2,6,2018,8,4,Saturday
1,8,23,31,2018,7,29,Sunday
2,7,7,14,2018,8,1,Wednseday
2,17,17,34,2018,3,21,Wednseday
7,19,9,28,2018,1,4,Thursday
1,11,9,20,2018,4,19,Thursday
1,13,16,29,2017,11,9,Thursday
0,9,4,13,2017,7,18,Tuesday
1,6,16,22,2018,5,3,Thursday
2,8,30,38,2018,6,12,Tuesday
6,12,16,28,2017,8,23,Wednseday
2,10,17,27,2018,3,13,Tuesday
1,14,22,36,2017,10,24,Tuesday
0,14,13,27,2017,12,27,Wednseday
1,8,15,23,2018,5,9,Wednseday
4,19,16,35,2018,5,24,Thursday
2,7,11,18,2017,6,26,Monday
1,16,12,28,2018,5,22,Tuesday
4,7,3,10,2017,10,27,Friday
22,33,3,36,2018,1,4,Thursday
4,48,-5,43,2018,4,19,Thursday
1,2,6,8,2018,7,24,Tuesday
5,18,36,54,2017,4,14,Friday
4,5,18,23,2017,12,24,Sunday
5,10,10,20,2017,8,12,Saturday
4,12,13,25,2018,5,10,Thursday
7,8,3,11,2017,10,30,Monday
2,15,18,33,2018,4,5,Thursday
1,7,14,21,2017,3,2,Thursday
1,4,9,13,2017,6,1,Thursday
4,11,15,26,2017,3,10,Friday
3,10,29,39,2018,3,30,Friday
1,3,7,10,2018,4,3,Tuesday
3,19,14,33,2017,11,24,Friday
4,7,8,15,2018,5,17,Thursday
7,9,41,50,2018,6,4,Monday
2,3,13,16,2018,5,14,Monday
6,11,23,34,2017,2,24,Friday
4,36,-7,29,2018,4,30,Monday
2,5,17,22,2017,9,3,Sunday
1,8,15,23,2018,3,4,Sunday
2,7,22,29,2017,5,24,Wednseday
2,15,14,29,2017,8,16,Wednseday
2,13,15,28,2017,11,8,Wednseday
1,5,15,20,2017,3,22,Wednseday
4,19,4,23,2017,11,19,Sunday
3,7,11,18,2017,10,13,Friday
4,40,-18,22,2017,11,26,Sunday
1,6,25,31,2017,4,4,Tuesday
1,20,14,34,2018,4,24,Tuesday
3,11,12,23,2017,9,9,Saturday
2,16,-2,14,2017,11,7,Tuesday
7,12,23,35,2017,4,20,Thursday
1,3,7,10,2017,9,11,Monday
6,10,11,21,2018,4,3,Tuesday
7,18,9,27,2017,11,23,Thursday
4,7,13,20,2017,2,3,Friday
2,9,28,37,2017,1,28,Saturday
2,8,24,32,2018,6,18,Monday
17,45,-3,42,2018,1,30,Tuesday
2,15,4,19,2018,4,15,Sunday
5,12,15,27,2018,6,28,Thursday
4,48,-17,31,2017,11,25,Saturday
1,8,20,28,2018,2,6,Tuesday
3,15,7,22,2017,8,7,Monday
1,6,23,29,2018,6,27,Wednseday
4,21,17,38,2017,4,7,Friday
3,10,14,24,2018,7,27,Friday
1,4,16,20,2017,8,8,Tuesday
12,18,55,73,2018,1,12,Friday
4,13,18,31,2017,11,18,Saturday
1,12,14,26,2018,2,8,Thursday
3,10,14,24,2018,4,9,Monday
3,4,16,20,2017,7,29,Saturday
6,12,7,19,2018,3,16,Friday
9,44,2,46,2018,2,25,Sunday
0,1,6,7,2018,8,1,Wednseday
0,8,19,27,2017,9,20,Wednseday
1,14,6,20,2018,3,28,Wednseday
1,11,15,26,2017,6,11,Sunday
1,14,5,19,2018,4,26,Thursday
4,5,22,27,2017,12,9,Saturday
0,7,10,17,2018,4,30,Monday
1,5,8,13,2018,8,8,Wednseday
2,8,14,22,2017,8,1,Tuesday
3,6,6,12,2017,9,10,Sunday
0,20,2,22,2018,2,14,Wednseday
8,24,-1,23,2017,10,31,Tuesday
2,19,7,26,2017,12,10,Sunday
1,2,15,17,2017,12,12,Tuesday
0,5,24,29,2017,4,12,Wednseday
1,20,1,21,2018,1,18,Thursday
2,5,11,16,2018,1,17,Wednseday
4,10,14,24,2017,5,19,Friday
3,11,26,37,2018,4,21,Saturday
3,7,4,11,2017,5,29,Monday
12,39,-2,37,2017,5,27,Saturday
4,15,2,17,2017,10,30,Monday
1,8,16,24,2018,3,12,Monday
3,14,14,28,2018,1,19,Friday
3,12,13,25,2018,8,10,Friday
4,11,14,25,2017,11,3,Friday
3,17,7,24,2018,3,20,Tuesday
5,23,3,26,2018,3,28,Wednseday
1,9,11,20,2017,11,7,Tuesday
0,6,28,34,2017,10,5,Thursday
3,12,7,19,2018,3,30,Friday
4,8,11,19,2017,7,2,Sunday
1,8,8,16,2018,1,30,Tuesday
1,7,14,21,2018,2,9,Friday
1,7,28,35,2018,6,7,Thursday
3,16,10,26,2017,3,5,Sunday
3,18,6,24,2017,11,11,Saturday
0,11,16,27,2017,9,29,Friday
2,9,10,19,2017,11,29,Wednseday
4,9,17,26,2017,11,24,Friday
8,12,21,33,2017,11,2,Thursday
4,19,5,24,2018,5,18,Friday
5,12,20,32,2017,12,2,Saturday
2,11,20,31,2017,9,23,Saturday
1,9,45,54,2018,6,3,Sunday
1,8,14,22,2017,5,8,Monday
6,13,3,16,2018,8,1,Wednseday
3,15,9,24,2017,6,19,Monday
2,5,12,17,2018,8,5,Sunday
0,4,9,13,2017,7,11,Tuesday
0,14,23,37,2018,5,28,Monday
2,13,6,19,2017,4,23,Sunday
1,4,25,29,2018,6,18,Monday
5,10,17,27,2018,4,20,Friday
3,5,6,11,2018,5,12,Saturday
6,14,26,40,2018,8,8,Wednseday
0,28,-2,26,2017,11,17,Friday
2,3,12,15,2018,5,6,Sunday
2,8,8,16,2018,8,14,Tuesday
4,11,30,41,2018,4,6,Friday
1,6,16,22,2017,11,15,Wednseday
3,20,5,25,2018,3,17,Saturday
2,7,23,30,2018,2,20,Tuesday
2,48,-24,24,2017,11,11,Saturday
0,21,14,35,2018,4,27,Friday
1,25,-7,18,2018,2,26,Monday
3,9,8,17,2018,2,6,Tuesday
3,6,5,11,2018,8,3,Friday
1,4,9,13,2017,10,12,Thursday
2,8,14,22,2017,10,9,Monday
5,16,3,19,2018,3,28,Wednseday
2,11,11,22,2018,6,12,Tuesday
1,12,21,33,2017,6,15,Thursday
6,14,15,29,2017,7,25,Tuesday
14,21,10,31,2018,4,24,Tuesday
0,8,14,22,2018,6,12,Tuesday
2,15,14,29,2017,5,29,Monday
3,15,10,25,2018,1,8,Monday
1,7,13,20,2017,5,24,Wednseday
1,7,13,20,2017,7,27,Thursday
4,19,12,31,2018,3,30,Friday
1,13,9,22,2018,5,23,Wednseday
1,9,18,27,2018,1,2,Tuesday
4,32,-2,30,2018,2,24,Saturday
4,5,14,19,2018,5,4,Friday
6,14,9,23,2017,9,26,Tuesday
4,6,20,26,2017,12,15,Friday
4,11,6,17,2018,8,11,Saturday
0,11,15,26,2017,12,28,Thursday
5,42,-7,35,2017,12,18,Monday
4,13,22,35,2018,1,4,Thursday
2,3,11,14,2017,6,5,Monday
0,1,9,10,2018,6,18,Monday
0,3,24,27,2017,5,2,Tuesday
0,6,17,23,2017,8,16,Wednseday
2,12,30,42,2018,6,6,Wednseday
6,20,4,24,2017,4,29,Saturday
10,13,36,49,2018,6,1,Friday
1,5,2,7,2018,8,1,Wednseday
0,4,8,12,2018,3,15,Thursday
3,18,3,21,2018,3,23,Friday
2,5,18,23,2018,7,1,Sunday
4,38,-13,25,2018,2,24,Saturday
6,29,7,36,2018,4,11,Wednseday
1,6,9,15,2017,11,27,Monday
1,7,23,30,2018,7,17,Tuesday
1,15,10,25,2018,3,8,Thursday
1,5,14,19,2017,10,4,Wednseday
0,18,9,27,2017,11,16,Thursday
2,26,4,30,2017,11,12,Sunday
3,6,24,30,2018,6,16,Saturday
2,20,6,26,2017,5,3,Wednseday
1,23,10,33,2018,4,25,Wednseday
1,9,13,22,2018,4,4,Wednseday
3,11,13,24,2017,3,24,Friday
1,2,15,17,2018,6,24,Sunday
4,8,11,19,2018,7,6,Friday
3,4,5,9,2018,7,9,Monday
2,14,12,26,2018,2,3,Saturday
3,6,20,26,2018,7,1,Sunday
0,5,22,27,2017,12,21,Thursday
0,5,10,15,2018,8,13,Monday
2,6,26,32,2017,3,25,Saturday
1,11,16,27,2017,3,30,Thursday
11,32,0,32,2018,3,3,Saturday
7,16,4,20,2017,11,23,Thursday
1,11,18,29,2017,10,23,Monday
5,17,19,36,2017,10,4,Wednseday
1,8,12,20,2018,2,22,Thursday
2,20,27,47,2018,5,30,Wednseday
5,8,12,20,2017,3,29,Wednseday
1,5,21,26,2017,2,5,Sunday
2,17,14,31,2017,12,18,Monday
7,14,10,24,2018,2,9,Friday
1,8,29,37,2018,5,28,Monday
4,17,21,38,2018,1,13,Saturday
4,11,6,17,2017,12,3,Sunday
2,31,-2,29,2017,12,4,Monday
2,7,10,17,2017,8,29,Tuesday
1,11,15,26,2018,4,19,Thursday
19,25,-2,23,2018,7,14,Saturday
3,11,9,20,2018,2,23,Friday
3,21,19,40,2017,12,1,Friday
1,4,13,17,2018,8,13,Monday
0,7,25,32,2017,10,27,Friday
1,3,7,10,2018,6,18,Monday
6,10,10,20,2017,11,24,Friday
3,15,15,30,2018,1,9,Tuesday
7,25,-5,20,2017,11,24,Friday
2,23,9,32,2017,5,7,Sunday
1,13,17,30,2018,1,16,Tuesday
0,4,3,7,2018,8,10,Friday
2,7,15,22,2018,8,21,Tuesday
1,8,15,23,2017,8,6,Sunday
2,13,7,20,2018,2,14,Wednseday
6,18,10,28,2017,8,3,Thursday
5,19,19,38,2018,2,3,Saturday
3,14,3,17,2018,3,20,Tuesday
13,23,6,29,2018,7,4,Wednseday
2,8,17,25,2018,8,20,Monday
3,10,2,12,2018,8,5,Sunday
1,12,21,33,2017,12,6,Wednseday
4,9,11,20,2017,9,2,Saturday
5,25,6,31,2017,11,25,Saturday
1,6,2,8,2018,8,14,Tuesday
3,6,32,38,2018,1,26,Friday
10,13,1,14,2018,5,1,Tuesday
4,38,-19,19,2017,9,8,Friday
1,6,15,21,2017,3,16,Thursday
3,12,19,31,2017,9,22,Friday
1,24,0,24,2018,2,26,Monday
6,18,8,26,2017,6,24,Saturday
1,2,6,8,2018,5,14,Monday
0,9,15,24,2017,3,27,Monday
3,19,7,26,2018,1,28,Sunday
17,31,7,38,2017,12,26,Tuesday
1,20,21,41,2018,1,10,Wednseday
5,9,10,19,2018,3,3,Saturday
2,8,4,12,2018,8,19,Sunday
2,17,14,31,2017,5,21,Sunday
5,17,7,24,2017,7,1,Saturday
1,29,-7,22,2017,11,28,Tuesday
3,10,16,26,2017,11,18,Saturday
4,8,10,18,2018,2,26,Monday
1,9,12,21,2018,8,8,Wednseday
3,15,19,34,2018,2,27,Tuesday
1,37,-5,32,2018,3,18,Sunday
3,11,21,32,2018,7,13,Friday
3,11,21,32,2018,6,22,Friday
2,8,13,21,2017,11,8,Wednseday
2,6,1,7,2018,8,7,Tuesday
6,15,17,32,2017,8,3,Thursday
6,16,12,28,2018,1,2,Tuesday
7,14,14,28,2017,11,24,Friday
0,13,12,25,2018,4,13,Friday
2,10,23,33,2017,12,2,Saturday
2,23,5,28,2018,3,6,Tuesday
2,8,15,23,2017,10,9,Monday
1,4,24,28,2018,4,9,Monday
2,8,15,23,2018,7,25,Wednseday
2,31,-2,29,2017,12,4,Monday
5,20,6,26,2017,11,25,Saturday
1,15,1,16,2017,9,11,Monday
4,12,1,13,2017,7,14,Friday
3,20,15,35,2017,10,2,Monday
2,8,26,34,2018,5,1,Tuesday
1,8,14,22,2018,2,13,Tuesday
9,18,5,23,2017,11,28,Tuesday
1,7,17,24,2018,7,2,Monday
13,44,-15,29,2017,12,6,Wednseday
2,22,8,30,2018,3,18,Sunday
4,15,10,25,2017,10,15,Sunday
6,13,11,24,2017,8,11,Friday
3,4,9,13,2017,8,4,Friday
5,15,12,27,2017,6,15,Thursday
1,7,20,27,2018,7,3,Tuesday
3,16,10,26,2018,2,11,Sunday
3,10,14,24,2017,11,17,Friday
3,9,14,23,2018,1,29,Monday
5,6,12,18,2017,10,12,Thursday
4,6,11,17,2018,1,20,Saturday
2,31,3,34,2018,6,30,Saturday
1,9,11,20,2017,8,2,Wednseday
2,4,13,17,2018,2,12,Monday
1,3,16,19,2017,10,22,Sunday
2,12,13,25,2017,5,7,Sunday
1,3,4,7,2018,8,21,Tuesday
2,10,28,38,2017,10,22,Sunday
11,12,11,23,2017,7,23,Sunday
2,14,13,27,2017,5,30,Tuesday
1,4,12,16,2017,10,16,Monday
2,10,19,29,2017,2,21,Tuesday
2,8,64,72,2018,1,20,Saturday
3,5,16,21,2017,4,7,Friday
2,14,8,22,2018,2,21,Wednseday
1,9,17,26,2018,2,7,Wednseday
5,17,3,20,2018,6,8,Friday
1,5,10,15,2018,8,1,Wednseday
1,6,35,41,2017,1,11,Wednseday
5,47,-24,23,2017,11,25,Saturday
2,16,7,23,2018,3,20,Tuesday
10,16,8,24,2017,11,25,Saturday
4,11,16,27,2018,2,24,Saturday
3,9,16,25,2017,5,6,Saturday
5,15,28,43,2018,2,11,Sunday
1,6,1,7,2018,8,7,Tuesday
1,2,9,11,2017,5,22,Monday
5,15,18,33,2018,1,5,Friday
1,25,-5,20,2017,6,29,Thursday
2,8,9,17,2017,10,15,Sunday
1,13,17,30,2017,8,29,Tuesday
5,9,6,15,2018,1,25,Thursday
4,7,24,31,2017,12,15,Friday
6,17,10,27,2018,2,9,Friday
3,14,20,34,2018,3,10,Saturday
7,15,5,20,2017,9,5,Tuesday
3,14,24,38,2017,9,26,Tuesday
1,8,-1,7,2018,8,7,Tuesday
1,16,14,30,2017,6,19,Monday
1,5,14,19,2017,7,30,Sunday
1,7,13,20,2017,3,16,Thursday
0,10,16,26,2018,8,3,Friday
0,8,2,10,2018,7,20,Friday
2,12,28,40,2017,4,1,Saturday
4,10,8,18,2018,3,9,Friday
6,26,0,26,2018,5,10,Thursday
6,20,4,24,2018,2,20,Tuesday
1,7,14,21,2018,1,16,Tuesday
4,25,8,33,2017,12,31,Sunday
2,3,13,16,2018,2,6,Tuesday
2,6,15,21,2018,5,15,Tuesday
5,10,10,20,2018,7,4,Wednseday
3,6,12,18,2018,7,21,Saturday
7,20,7,27,2018,2,13,Tuesday
1,18,13,31,2018,4,23,Monday
3,6,8,14,2018,2,23,Friday
2,7,14,21,2018,4,25,Wednseday
5,23,4,27,2017,11,25,Saturday
1,15,9,24,2018,6,25,Monday
3,18,9,27,2018,1,6,Saturday
1,22,13,35,2018,1,10,Wednseday
6,20,7,27,2018,3,1,Thursday
10,16,8,24,2017,5,2,Tuesday
1,11,11,22,2017,6,19,Monday
2,3,8,11,2018,6,18,Monday
32,37,-8,29,2017,2,20,Monday
2,8,14,22,2018,7,17,Tuesday
7,17,6,23,2017,7,3,Monday
2,13,21,34,2018,1,6,Saturday
2,13,4,17,2018,1,9,Tuesday
5,13,23,36,2017,8,3,Thursday
6,14,5,19,2018,5,9,Wednseday
1,7,23,30,2017,10,25,Wednseday
1,2,6,8,2018,7,25,Wednseday
2,5,7,12,2017,6,18,Sunday
7,30,7,37,2018,1,10,Wednseday
1,7,13,20,2017,8,3,Thursday
3,15,9,24,2017,9,29,Friday
4,18,20,38,2017,4,28,Friday
4,11,10,21,2017,9,14,Thursday
2,8,11,19,2017,9,6,Wednseday
3,9,14,23,2017,12,5,Tuesday
3,4,14,18,2018,1,21,Sunday
3,20,0,20,2017,11,28,Tuesday
4,7,10,17,2017,9,11,Monday
23,29,-4,25,2017,2,20,Monday
1,7,7,14,2017,11,28,Tuesday
2,10,18,28,2017,9,13,Wednseday
1,19,8,27,2018,3,8,Thursday
7,10,12,22,2018,7,10,Tuesday
1,16,10,26,2018,2,7,Wednseday
1,12,20,32,2017,11,16,Thursday
1,5,2,7,2018,8,8,Wednseday
2,10,17,27,2017,11,4,Saturday
3,4,7,11,2018,6,17,Sunday
0,7,21,28,2017,12,19,Tuesday
3,17,11,28,2018,1,19,Friday
6,18,3,21,2018,3,2,Friday
1,5,20,25,2018,5,17,Thursday
5,14,12,26,2018,5,4,Friday
1,20,8,28,2018,3,7,Wednseday
5,12,12,24,2018,1,26,Friday
1,10,36,46,2017,1,15,Sunday
1,4,19,23,2018,1,15,Monday
4,7,15,22,2017,3,9,Thursday
1,45,-6,39,2018,1,28,Sunday
0,7,3,10,2018,8,21,Tuesday
3,10,18,28,2018,1,29,Monday
1,2,9,11,2017,11,6,Monday
4,22,9,31,2017,9,15,Friday
3,4,15,19,2017,12,9,Saturday
1,9,13,22,2018,3,25,Sunday
1,27,7,34,2017,7,6,Thursday
3,10,14,24,2017,11,4,Saturday
1,7,13,20,2017,6,29,Thursday
3,8,14,22,2018,5,1,Tuesday
1,5,6,11,2018,3,11,Sunday
2,5,10,15,2017,7,12,Wednseday
3,10,15,25,2017,5,6,Saturday
3,12,8,20,2017,6,16,Friday
3,5,7,12,2018,8,24,Friday
3,8,10,18,2018,3,25,Sunday
1,21,1,22,2018,5,17,Thursday
6,10,17,27,2017,3,24,Friday
1,4,8,12,2018,3,8,Thursday
5,8,4,12,2018,5,11,Friday
6,12,11,23,2017,6,7,Wednseday
0,7,13,20,2017,9,1,Friday
1,6,30,36,2018,6,5,Tuesday
6,23,9,32,2018,1,25,Thursday
1,2,8,10,2018,3,12,Monday
1,12,14,26,2018,5,24,Thursday
2,10,14,24,2018,2,20,Tuesday
1,8,13,21,2017,10,26,Thursday
8,21,14,35,2018,2,6,Tuesday
5,11,17,28,2018,1,12,Friday
9,11,26,37,2017,9,30,Saturday
6,13,9,22,2017,7,4,Tuesday
3,5,8,13,2018,5,19,Saturday
4,8,23,31,2017,6,5,Monday
2,16,20,36,2017,8,30,Wednseday
6,14,15,29,2018,7,24,Tuesday
3,11,14,25,2017,11,24,Friday
14,22,6,28,2017,9,11,Monday
7,19,15,34,2017,7,19,Wednseday
19,21,5,26,2018,7,19,Thursday
5,16,20,36,2017,4,23,Sunday
4,10,21,31,2018,4,2,Monday
1,5,18,23,2018,6,20,Wednseday
2,4,8,12,2018,3,17,Saturday
3,9,15,24,2018,1,27,Saturday
5,11,7,18,2018,8,16,Thursday
8,17,-3,14,2018,5,8,Tuesday
10,44,10,54,2018,1,21,Sunday
5,21,3,24,2018,1,27,Saturday
6,47,-17,30,2017,11,29,Wednseday
1,9,20,29,2018,3,13,Tuesday
1,13,21,34,2018,6,20,Wednseday
9,26,-1,25,2017,11,27,Monday
6,30,-7,23,2017,11,28,Tuesday
1,16,6,22,2018,3,7,Wednseday
3,13,19,32,2017,10,7,Saturday
5,13,23,36,2018,4,5,Thursday
0,17,11,28,2017,10,20,Friday
6,9,11,20,2018,4,4,Wednseday
1,7,5,12,2018,8,8,Wednseday
4,10,28,38,2017,4,30,Sunday
3,13,14,27,2018,2,6,Tuesday
0,3,21,24,2017,9,12,Tuesday
6,13,9,22,2017,8,3,Thursday
1,9,17,26,2017,12,13,Wednseday
3,13,12,25,2018,1,28,Sunday
1,4,12,16,2017,12,4,Monday
6,7,6,13,2017,6,22,Thursday
1,12,8,20,2017,11,23,Thursday
1,7,14,21,2017,8,30,Wednseday
1,29,-10,19,2018,3,18,Sunday
1,2,11,13,2017,8,22,Tuesday
1,7,19,26,2018,6,7,Thursday
2,36,-2,34,2017,7,4,Tuesday
3,9,12,21,2018,4,24,Tuesday
2,5,20,25,2017,4,1,Saturday
4,19,7,26,2017,12,15,Friday
1,8,17,25,2018,1,14,Sunday
1,12,7,19,2017,8,31,Thursday
4,12,8,20,2017,5,18,Thursday
3,14,15,29,2018,7,10,Tuesday
1,8,35,43,2018,6,24,Sunday
1,6,17,23,2017,8,22,Tuesday
3,27,-3,24,2017,8,12,Saturday
15,19,6,25,2018,8,5,Sunday
3,7,9,16,2018,5,7,Monday
4,7,9,16,2018,1,29,Monday
0,15,3,18,2017,10,13,Friday
1,2,27,29,2018,8,21,Tuesday
1,2,10,12,2017,10,29,Sunday
7,12,12,24,2018,4,6,Friday
2,4,13,17,2017,7,22,Saturday
1,9,12,21,2017,11,21,Tuesday
5,11,22,33,2017,11,30,Thursday
3,9,15,24,2018,4,29,Sunday
1,17,14,31,2018,1,8,Monday
2,9,6,15,2018,8,8,Wednseday
2,9,20,29,2018,1,31,Wednseday
4,7,25,32,2017,10,20,Friday
6,16,13,29,2018,5,22,Tuesday
6,14,9,23,2018,2,13,Tuesday
2,8,6,14,2017,10,30,Monday
1,8,21,29,2017,12,18,Monday
1,7,11,18,2017,10,30,Monday
7,8,12,20,2017,8,3,Thursday
3,11,13,24,2017,9,29,Friday
19,21,11,32,2018,7,19,Thursday
6,11,23,34,2018,5,31,Thursday
3,13,11,24,2017,11,17,Friday
2,11,19,30,2018,1,6,Saturday
4,15,20,35,2018,3,5,Monday
5,11,1,12,2018,8,10,Friday
2,6,14,20,2018,5,22,Tuesday
6,13,14,27,2017,11,25,Saturday
2,5,18,23,2018,1,13,Saturday
4,11,18,29,2018,4,30,Monday
1,9,13,22,2017,10,18,Wednseday
3,12,20,32,2017,7,2,Sunday
0,9,20,29,2018,7,24,Tuesday
2,7,19,26,2017,7,5,Wednseday
2,4,22,26,2018,6,24,Sunday
6,12,13,25,2018,4,14,Saturday
4,12,29,41,2018,6,29,Friday
7,16,12,28,2017,7,6,Thursday
5,30,6,36,2017,2,12,Sunday
1,8,21,29,2017,2,16,Thursday
0,12,14,26,2017,11,10,Friday
1,7,10,17,2017,8,29,Tuesday
5,12,6,18,2017,9,15,Friday
1,7,7,14,2017,11,13,Monday
1,12,18,30,2017,5,17,Wednseday
2,27,9,36,2017,5,3,Wednseday
1,3,23,26,2017,10,15,Sunday
3,13,15,28,2018,4,17,Tuesday
7,11,9,20,2017,9,14,Thursday
1,3,11,14,2017,11,28,Tuesday
5,4,15,19,2017,7,2,Sunday
4,11,10,21,2018,5,11,Friday
4,7,10,17,2018,5,21,Monday
3,13,12,25,2018,4,15,Sunday
4,22,19,41,2017,12,22,Friday
9,22,15,37,2017,8,22,Tuesday
2,8,11,19,2018,3,21,Wednseday
2,18,5,23,2017,12,4,Monday
1,6,14,20,2018,7,4,Wednseday
0,16,13,29,2017,10,18,Wednseday
1,5,20,25,2017,12,10,Sunday
0,1,10,11,2017,7,3,Monday
13,13,15,28,2018,3,7,Wednseday
5,24,-1,23,2017,11,25,Saturday
0,27,3,30,2018,2,21,Wednseday
6,14,22,36,2018,6,19,Tuesday
1,2,25,27,2018,3,20,Tuesday
1,15,8,23,2017,10,3,Tuesday
1,8,14,22,2018,7,22,Sunday
6,18,4,22,2017,5,4,Thursday
3,4,13,17,2018,1,12,Friday
0,2,11,13,2018,5,10,Thursday
1,11,11,22,2017,8,10,Thursday
4,11,21,32,2018,4,14,Saturday
8,23,0,23,2017,6,14,Wednseday
3,4,19,23,2017,5,6,Saturday
2,9,6,15,2018,7,30,Monday
9,13,12,25,2018,4,7,Saturday
3,6,19,25,2018,6,8,Friday
6,24,13,37,2017,11,1,Wednseday
2,7,16,23,2017,10,4,Wednseday
1,7,10,17,2018,7,17,Tuesday
1,2,24,26,2018,5,31,Thursday
13,18,10,28,2018,7,27,Friday
2,5,12,17,2018,8,11,Saturday
3,15,15,30,2017,10,1,Sunday
2,8,30,38,2018,6,25,Monday
0,11,6,17,2018,8,6,Monday
1,14,16,30,2018,2,5,Monday
0,6,11,17,2018,5,15,Tuesday
2,75,-41,34,2018,3,24,Saturday
6,13,11,24,2018,2,2,Friday
4,16,19,35,2018,4,9,Monday
2,7,28,35,2018,7,4,Wednseday
6,27,-6,21,2018,3,23,Friday
8,22,9,31,2018,1,14,Sunday
1,8,8,16,2018,7,30,Monday
5,13,8,21,2017,8,23,Wednseday
3,6,4,10,2018,7,27,Friday
3,15,6,21,2017,11,10,Friday
23,29,4,33,2017,2,1,Wednseday
2,5,20,25,2018,6,10,Sunday
4,11,15,26,2018,2,15,Thursday
1,4,20,24,2018,4,8,Sunday
1,10,25,35,2017,6,13,Tuesday
1,5,8,13,2018,3,21,Wednseday
0,8,9,17,2017,3,14,Tuesday
6,21,11,32,2017,12,14,Thursday
4,15,25,40,2017,10,12,Thursday
7,20,9,29,2017,8,17,Thursday
1,11,17,28,2018,4,12,Thursday
5,40,-15,25,2017,11,24,Friday
2,19,7,26,2017,8,9,Wednseday
1,8,18,26,2018,5,10,Thursday
2,8,28,36,2018,6,5,Tuesday
13,45,-21,24,2018,3,27,Tuesday
2,3,17,20,2018,6,9,Saturday
3,14,32,46,2018,6,1,Friday
1,12,10,22,2017,11,8,Wednseday
3,7,13,20,2017,11,24,Friday
1,9,24,33,2018,1,24,Wednseday
5,14,6,20,2017,9,13,Wednseday
2,4,13,17,2018,2,4,Sunday
6,32,-9,23,2018,5,12,Saturday
6,33,-20,13,2017,11,16,Thursday
2,5,36,41,2018,6,2,Saturday
2,5,14,19,2018,5,16,Wednseday
3,9,8,17,2018,3,20,Tuesday
6,26,-7,19,2018,5,10,Thursday
2,9,20,29,2017,12,20,Wednseday
1,10,11,21,2018,3,13,Tuesday
3,6,18,24,2017,3,10,Friday
6,20,0,20,2017,7,4,Tuesday
3,4,16,20,2017,12,16,Saturday
2,8,9,17,2018,3,6,Tuesday
1,2,12,14,2017,10,18,Wednseday
1,5,13,18,2018,4,29,Sunday
0,1,8,9,2018,6,12,Tuesday
7,8,10,18,2018,2,1,Thursday
4,10,18,28,2018,1,19,Friday
1,9,15,24,2017,9,3,Sunday
4,13,13,26,2018,1,4,Thursday
11,18,21,39,2017,3,31,Friday
2,17,4,21,2017,8,28,Monday
4,15,6,21,2017,9,14,Thursday
3,10,5,15,2018,8,6,Monday
1,7,19,26,2018,1,4,Thursday
1,22,3,25,2018,4,19,Thursday
2,12,14,26,2017,5,17,Wednseday
1,3,19,22,2017,4,2,Sunday
2,9,21,30,2017,5,15,Monday
1,3,8,11,2018,4,1,Sunday
2,15,6,21,2017,6,14,Wednseday
3,13,6,19,2017,9,9,Saturday
1,3,16,19,2018,3,18,Sunday
5,7,19,26,2017,4,12,Wednseday
3,4,10,14,2018,5,14,Monday
2,9,33,42,2018,1,22,Monday
2,7,15,22,2017,8,14,Monday
2,10,8,18,2018,3,18,Sunday
2,11,16,27,2018,1,27,Saturday
2,7,13,20,2017,7,29,Saturday
7,17,19,36,2017,4,20,Thursday
1,15,18,33,2018,2,2,Friday
1,5,26,31,2018,4,15,Sunday
10,15,22,37,2017,4,3,Monday
2,3,9,12,2017,8,20,Sunday
5,41,-14,27,2017,8,10,Thursday
2,4,13,17,2018,4,23,Monday
0,7,5,12,2018,8,17,Friday
4,17,1,18,2018,7,20,Friday
4,5,10,15,2018,3,29,Thursday
5,17,9,26,2017,10,29,Sunday
3,4,3,7,2018,7,27,Friday
3,12,7,19,2017,11,5,Sunday
1,12,34,46,2018,6,4,Monday
2,25,6,31,2017,10,3,Tuesday
2,4,14,18,2018,4,9,Monday
16,28,13,41,2018,2,3,Saturday
0,11,11,22,2017,8,31,Thursday
18,24,10,34,2017,7,21,Friday
6,23,-1,22,2018,4,4,Wednseday
13,17,19,36,2018,7,18,Wednseday
1,7,11,18,2018,8,13,Monday
1,3,10,13,2017,8,4,Friday
1,2,3,5,2018,8,22,Wednseday
1,15,17,32,2018,2,5,Monday
3,10,18,28,2018,4,27,Friday
1,4,7,11,2017,6,19,Monday
3,10,3,13,2018,8,4,Saturday
3,25,-4,21,2017,9,18,Monday
5,9,-1,8,2018,8,5,Sunday
5,14,14,28,2017,11,16,Thursday
4,5,9,14,2018,1,26,Friday
0,7,9,16,2018,8,1,Wednseday
7,10,20,30,2018,6,19,Tuesday
5,13,3,16,2018,1,29,Monday
2,8,17,25,2017,12,4,Monday
3,12,33,45,2018,8,17,Friday
4,25,5,30,2018,5,14,Monday
3,6,15,21,2017,12,15,Friday
0,9,11,20,2018,2,14,Wednseday
3,18,27,45,2017,12,15,Friday
2,20,7,27,2017,2,18,Saturday
2,5,14,19,2018,4,5,Thursday
3,17,14,31,2018,6,19,Tuesday
4,11,29,40,2017,5,25,Thursday
3,6,10,16,2018,1,30,Tuesday
1,6,21,27,2018,5,9,Wednseday
4,5,8,13,2017,8,18,Friday
0,8,20,28,2018,4,17,Tuesday
0,7,12,19,2018,8,17,Friday
3,11,10,21,2017,3,10,Friday
2,15,11,26,2018,1,7,Sunday
0,9,21,30,2018,4,25,Wednseday
1,7,16,23,2018,4,18,Wednseday
2,7,16,23,2018,1,24,Wednseday
2,3,8,11,2018,7,8,Sunday
2,18,18,36,2018,2,1,Thursday
1,11,4,15,2018,5,17,Thursday
0,6,31,37,2018,6,6,Wednseday
1,2,14,16,2018,4,3,Tuesday
1,6,16,22,2017,5,16,Tuesday
4,5,13,18,2017,7,27,Thursday
7,25,10,35,2017,9,11,Monday
1,14,5,19,2017,11,26,Sunday
0,14,6,20,2018,6,28,Thursday
6,10,42,52,2016,10,9,Sunday
1,5,9,14,2018,6,14,Thursday
1,14,41,55,2018,3,6,Tuesday
2,5,13,18,2018,8,25,Saturday
4,6,21,27,2018,6,14,Thursday
0,7,13,20,2018,8,15,Wednseday
4,19,5,24,2018,5,18,Friday
5,31,2,33,2017,8,18,Friday
3,7,12,19,2017,9,1,Friday
1,2,10,12,2018,4,15,Sunday
5,13,8,21,2017,11,24,Friday
2,17,7,24,2018,2,17,Saturday
3,6,12,18,2017,11,24,Friday
34,53,-20,33,2017,5,5,Friday
2,15,12,27,2017,10,3,Tuesday
2,7,16,23,2017,10,2,Monday
2,4,24,28,2018,2,26,Monday
0,11,13,24,2017,8,11,Friday
0,8,20,28,2018,4,17,Tuesday
6,9,4,13,2017,10,17,Tuesday
2,15,16,31,2017,10,29,Sunday
2,22,11,33,2018,2,14,Wednseday
1,6,18,24,2018,6,19,Tuesday
2,8,9,17,2018,5,8,Tuesday
2,5,17,22,2018,7,22,Sunday
1,8,15,23,2018,6,11,Monday
2,11,9,20,2017,11,15,Wednseday
2,7,23,30,2017,9,25,Monday
2,12,17,29,2018,3,25,Sunday
1,5,17,22,2017,7,12,Wednseday
6,28,-6,22,2018,3,20,Tuesday
7,12,14,26,2018,6,20,Wednseday
7,22,0,22,2017,7,12,Wednseday
28,31,2,33,2018,1,20,Saturday
5,13,16,29,2017,7,26,Wednseday
5,16,21,37,2017,8,2,Wednseday
4,16,16,32,2017,10,7,Saturday
5,8,18,26,2018,7,19,Thursday
6,8,5,13,2018,8,9,Thursday
6,18,12,30,2018,2,10,Saturday
6,17,19,36,2017,10,3,Tuesday
5,31,6,37,2017,12,9,Saturday
0,9,8,17,2017,9,18,Monday
1,2,13,15,2018,6,27,Wednseday
3,10,15,25,2017,8,25,Friday
1,13,13,26,2017,12,27,Wednseday
4,6,14,20,2017,12,29,Friday
0,14,13,27,2018,4,19,Thursday
3,16,6,22,2018,1,14,Sunday
3,9,10,19,2017,9,30,Saturday
5,11,9,20,2017,11,24,Friday
1,7,18,25,2018,5,3,Thursday
6,19,1,20,2017,8,10,Thursday
1,15,7,22,2017,8,31,Thursday
1,22,-2,20,2017,6,22,Thursday
3,10,30,40,2018,6,15,Friday
5,12,9,21,2018,4,20,Friday
2,23,1,24,2018,1,9,Tuesday
4,25,1,26,2018,5,3,Thursday
0,6,7,13,2018,8,7,Tuesday
1,12,8,20,2018,2,15,Thursday
1,8,18,26,2017,9,24,Sunday
1,2,13,15,2018,1,22,Monday
4,11,13,24,2018,3,2,Friday
2,15,8,23,2017,11,5,Sunday
10,18,16,34,2018,3,9,Friday
4,10,11,21,2018,2,26,Monday
14,19,14,33,2018,6,1,Friday
1,8,12,20,2017,7,20,Thursday
3,23,-1,22,2018,4,1,Sunday
3,12,16,28,2018,5,4,Friday
1,7,7,14,2018,8,16,Thursday
1,7,14,21,2018,4,16,Monday
1,6,5,11,2017,6,26,Monday
0,1,22,23,2018,1,3,Wednseday
3,15,8,23,2018,2,18,Sunday
1,6,14,20,2017,7,26,Wednseday
6,31,7,38,2018,2,3,Saturday
4,19,1,20,2018,3,17,Saturday
2,4,21,25,2017,2,20,Monday
2,3,13,16,2017,11,21,Tuesday
6,7,9,16,2018,4,18,Wednseday
1,2,8,10,2017,10,17,Tuesday
0,15,5,20,2018,3,21,Wednseday
1,3,21,24,2018,5,27,Sunday
2,63,-38,25,2018,2,25,Sunday
2,5,17,22,2018,4,8,Sunday
2,7,17,24,2017,3,14,Tuesday
5,12,6,18,2017,9,15,Friday
4,19,3,22,2018,2,22,Thursday
1,7,23,30,2018,6,20,Wednseday
16,20,14,34,2017,11,29,Wednseday
1,7,15,22,2017,7,17,Monday
8,12,3,15,2018,8,15,Wednseday
1,11,18,29,2017,12,26,Tuesday
3,23,2,25,2017,6,10,Saturday
3,6,7,13,2017,9,5,Tuesday
3,17,16,33,2018,3,9,Friday
1,30,-8,22,2018,3,4,Sunday
1,15,35,50,2018,5,27,Sunday
4,17,22,39,2018,4,29,Sunday
1,10,14,24,2017,6,4,Sunday
1,5,15,20,2018,5,2,Wednseday
1,38,-1,37,2018,5,1,Tuesday
6,7,13,20,2018,6,14,Thursday
2,8,13,21,2017,6,5,Monday
5,10,13,23,2018,4,7,Saturday
1,4,14,18,2018,6,7,Thursday
6,27,-7,20,2017,7,25,Tuesday
0,10,23,33,2018,6,1,Friday
7,22,1,23,2017,12,6,Wednseday
4,7,9,16,2018,5,21,Monday
4,7,19,26,2017,6,15,Thursday
1,20,6,26,2018,5,16,Wednseday
6,18,14,32,2017,4,27,Thursday
0,7,14,21,2018,5,8,Tuesday
1,14,14,28,2018,8,6,Monday
1,23,2,25,2017,12,17,Sunday
5,8,14,22,2018,1,31,Wednseday
3,15,18,33,2017,12,1,Friday
1,11,16,27,2017,10,27,Friday
10,28,-8,20,2017,11,11,Saturday
1,2,8,10,2018,6,25,Monday
3,6,22,28,2017,9,22,Friday
0,4,11,15,2018,7,26,Thursday
2,16,8,24,2017,8,7,Monday
0,5,15,20,2018,7,4,Wednseday
2,6,21,27,2018,8,7,Tuesday
4,10,22,32,2017,5,12,Friday
2,3,9,12,2017,10,29,Sunday
4,5,10,15,2017,11,12,Sunday
2,3,11,14,2017,11,27,Monday
3,21,20,41,2017,12,13,Wednseday
3,26,20,46,2018,5,26,Saturday
3,20,14,34,2017,12,23,Saturday
13,33,1,34,2018,3,1,Thursday
6,13,9,22,2017,7,27,Thursday
5,17,9,26,2018,8,5,Sunday
1,11,14,25,2017,10,30,Monday
0,5,11,16,2017,11,25,Saturday
1,4,9,13,2018,3,1,Thursday
4,6,9,15,2018,4,26,Thursday
1,4,29,33,2017,2,2,Thursday
6,10,44,54,2016,10,9,Sunday
9,12,8,20,2017,7,15,Saturday
7,16,11,27,2017,4,11,Tuesday
7,14,10,24,2017,7,31,Monday
2,16,7,23,2017,9,13,Wednseday
4,22,12,34,2018,1,4,Thursday
3,8,20,28,2017,3,20,Monday
2,5,20,25,2017,12,10,Sunday
5,18,27,45,2018,1,5,Friday
2,19,7,26,2017,8,23,Wednseday
4,14,7,21,2018,7,2,Monday
1,34,-5,29,2018,4,3,Tuesday
2,12,18,30,2018,5,23,Wednseday
3,13,13,26,2017,11,24,Friday
22,27,1,28,2018,3,1,Thursday
1,23,10,33,2017,11,30,Thursday
2,9,13,22,2018,3,25,Sunday
2,4,14,18,2017,10,22,Sunday
4,18,8,26,2018,2,23,Friday
3,10,11,21,2017,11,27,Monday
1,14,10,24,2017,10,2,Monday
2,5,21,26,2017,7,8,Saturday
3,32,-9,23,2018,2,6,Tuesday
4,7,19,26,2018,5,10,Thursday
2,18,12,30,2017,12,5,Tuesday
3,10,16,26,2017,3,25,Saturday
3,10,16,26,2017,9,22,Friday
5,11,14,25,2018,1,13,Saturday
2,10,13,23,2018,4,23,Monday
1,6,3,9,2018,8,8,Wednseday
3,7,3,10,2018,3,19,Monday
0,2,14,16,2018,2,6,Tuesday
2,9,11,20,2018,2,20,Tuesday
1,7,15,22,2017,8,2,Wednseday
7,24,7,31,2018,5,5,Saturday
2,24,13,37,2017,3,20,Monday
1,10,20,30,2018,6,11,Monday
1,30,-8,22,2018,3,28,Wednseday
4,30,-7,23,2017,11,27,Monday
2,17,5,22,2018,1,30,Tuesday
1,8,24,32,2017,12,21,Thursday
4,7,9,16,2018,7,2,Monday
3,9,14,23,2018,4,29,Sunday
7,13,8,21,2017,5,10,Wednseday
1,8,6,14,2018,8,13,Monday
3,6,7,13,2018,6,22,Friday
1,13,11,24,2018,1,23,Tuesday
5,12,15,27,2018,3,24,Saturday
2,34,-4,30,2018,3,4,Sunday
9,19,5,24,2017,7,15,Saturday
0,14,5,19,2018,5,9,Wednseday
1,7,8,15,2018,7,5,Thursday
2,22,-5,17,2018,3,19,Monday
1,16,9,25,2018,3,25,Sunday
5,8,13,21,2018,7,5,Thursday
1,8,18,26,2017,11,23,Thursday
2,7,10,17,2018,5,22,Tuesday
4,34,-7,27,2018,5,12,Saturday
1,7,23,30,2017,5,31,Wednseday
1,7,21,28,2018,4,5,Thursday
3,24,10,34,2017,4,29,Saturday
6,17,7,24,2017,10,10,Tuesday
2,27,-5,22,2018,3,14,Wednseday
5,12,11,23,2017,12,23,Saturday
1,5,17,22,2017,4,5,Wednseday
5,33,-2,31,2018,2,10,Saturday
9,15,11,26,2017,12,27,Wednseday
4,11,6,17,2018,8,17,Friday
9,11,4,15,2018,2,11,Sunday
2,11,-2,9,2018,8,5,Sunday
4,6,11,17,2018,4,6,Friday
2,22,14,36,2018,2,6,Tuesday
2,9,9,18,2017,4,23,Sunday
1,8,12,20,2018,4,26,Thursday
3,16,16,32,2017,6,9,Friday
4,10,20,30,2018,4,30,Monday
13,17,1,18,2017,10,7,Saturday
1,5,5,10,2018,8,6,Monday
1,29,-9,20,2018,5,16,Wednseday
1,6,4,10,2018,4,3,Tuesday
15,19,25,44,2017,3,15,Wednseday
10,17,16,33,2018,2,17,Saturday
3,23,5,28,2018,3,13,Tuesday
2,19,17,36,2017,5,28,Sunday
3,6,2,8,2018,7,24,Tuesday
2,7,10,17,2018,6,30,Saturday
18,25,15,40,2018,3,23,Friday
2,16,25,41,2017,12,26,Tuesday
6,10,7,17,2017,10,24,Tuesday
3,7,25,32,2017,8,4,Friday
2,3,16,19,2017,7,15,Saturday
1,9,15,24,2018,6,11,Monday
1,7,13,20,2018,7,10,Tuesday
0,4,13,17,2018,5,15,Tuesday
2,6,17,23,2017,7,4,Tuesday
6,7,11,18,2018,7,20,Friday
4,11,15,26,2018,4,29,Sunday
2,14,14,28,2018,4,16,Monday
1,8,6,14,2018,8,16,Thursday
2,9,9,18,2017,8,7,Monday
3,4,14,18,2018,1,6,Saturday
2,20,4,24,2018,3,27,Tuesday
0,3,9,12,2018,5,4,Friday
6,21,2,23,2018,3,28,Wednseday
1,8,19,27,2017,5,30,Tuesday
4,6,10,16,2018,2,17,Saturday
2,9,12,21,2018,7,4,Wednseday
7,16,3,19,2018,2,28,Wednseday
2,15,11,26,2018,7,25,Wednseday
4,11,16,27,2017,6,1,Thursday
1,4,7,11,2017,8,28,Monday
1,10,21,31,2017,6,6,Tuesday
4,10,6,16,2018,7,16,Monday
7,12,32,44,2018,6,6,Wednseday
2,5,11,16,2018,7,21,Saturday
0,12,15,27,2017,9,20,Wednseday
0,4,9,13,2018,8,23,Thursday
5,9,12,21,2017,11,15,Wednseday
2,7,11,18,2018,7,28,Saturday
2,6,18,24,2018,4,22,Sunday
3,18,9,27,2017,12,8,Friday
1,12,14,26,2018,7,15,Sunday
6,17,17,34,2017,12,6,Wednseday
4,6,9,15,2017,11,12,Sunday
1,2,11,13,2018,4,25,Wednseday
1,2,22,24,2017,5,15,Monday
9,10,6,16,2018,2,13,Tuesday
1,4,17,21,2017,12,7,Thursday
4,5,23,28,2018,5,31,Thursday
2,4,13,17,2017,12,3,Sunday
2,15,13,28,2017,6,12,Monday
3,20,16,36,2017,5,16,Tuesday
1,10,8,18,2018,3,1,Thursday
1,11,18,29,2017,5,28,Sunday
2,16,10,26,2018,2,14,Wednseday
1,3,11,14,2017,9,13,Wednseday
5,12,13,25,2018,1,27,Saturday
5,34,-5,29,2018,1,3,Wednseday
7,17,14,31,2018,4,27,Friday
7,8,10,18,2018,2,2,Friday
2,14,5,19,2017,11,26,Sunday
10,18,14,32,2018,5,25,Friday
3,9,16,25,2018,3,4,Sunday
3,5,20,25,2017,12,1,Friday
0,5,30,35,2018,5,10,Thursday
4,13,14,27,2018,2,20,Tuesday
0,4,6,10,2018,8,13,Monday
1,9,13,22,2017,7,5,Wednseday
3,33,4,37,2018,4,7,Saturday
3,19,22,41,2017,2,11,Saturday
3,25,9,34,2017,12,1,Friday
18,22,17,39,2018,7,8,Sunday
1,9,17,26,2018,6,24,Sunday
9,12,4,16,2018,2,7,Wednseday
2,12,11,23,2017,8,13,Sunday
4,11,7,18,2018,7,27,Friday
5,22,5,27,2018,2,14,Wednseday
1,8,13,21,2017,2,23,Thursday
2,6,20,26,2017,11,25,Saturday
1,8,14,22,2017,3,13,Monday
3,7,5,12,2018,8,3,Friday
3,11,13,24,2017,6,23,Friday
7,12,11,23,2017,12,6,Wednseday
1,12,14,26,2017,6,1,Thursday
5,13,9,22,2017,6,22,Thursday
4,22,-1,21,2018,1,19,Friday
1,3,20,23,2018,3,26,Monday
0,8,15,23,2018,5,15,Tuesday
1,8,17,25,2017,3,23,Thursday
4,6,12,18,2017,12,2,Saturday
9,21,16,37,2017,4,26,Wednseday
5,12,19,31,2018,2,2,Friday
5,14,12,26,2017,7,7,Friday
1,3,14,17,2017,3,20,Monday
1,31,-8,23,2018,3,6,Tuesday
2,9,11,20,2018,5,9,Wednseday
1,9,21,30,2017,7,31,Monday
5,9,16,25,2018,4,28,Saturday
7,13,13,26,2017,8,10,Thursday
1,8,50,58,2017,5,15,Monday
5,8,18,26,2017,9,6,Wednseday
3,17,8,25,2018,2,26,Monday
1,7,3,10,2018,8,21,Tuesday
2,24,12,36,2018,2,5,Monday
5,8,4,12,2018,8,12,Sunday
1,9,10,19,2018,6,10,Sunday
1,6,9,15,2018,7,17,Tuesday
2,8,10,18,2017,7,17,Monday
5,10,10,20,2018,3,24,Saturday
1,12,8,20,2017,10,19,Thursday
10,16,11,27,2018,2,17,Saturday
5,18,14,32,2017,11,24,Friday
3,22,21,43,2017,2,13,Monday
7,10,7,17,2017,10,17,Tuesday
2,29,2,31,2017,12,16,Saturday
2,8,23,31,2018,1,29,Monday
3,12,20,32,2018,1,15,Monday
0,10,14,24,2017,6,30,Friday
4,13,28,41,2017,4,29,Saturday
2,25,11,36,2017,10,17,Tuesday
1,7,19,26,2018,6,21,Thursday
0,16,19,35,2017,6,6,Tuesday
31,49,-24,25,2018,4,20,Friday
0,10,23,33,2017,3,3,Friday
5,20,8,28,2017,11,24,Friday
2,4,7,11,2018,5,19,Saturday
0,13,10,23,2017,8,22,Tuesday
1,5,28,33,2018,5,16,Wednseday
2,8,20,28,2018,1,22,Monday
1,13,11,24,2017,9,3,Sunday
4,5,5,10,2018,8,18,Saturday
4,12,22,34,2017,4,28,Friday
7,9,8,17,2017,3,13,Monday
2,16,10,26,2017,9,13,Wednseday
4,19,13,32,2018,4,5,Thursday
3,9,9,18,2017,12,10,Sunday
1,9,17,26,2017,5,14,Sunday
5,28,-7,21,2018,2,22,Thursday
1,16,0,16,2017,12,4,Monday
4,21,31,52,2018,5,11,Friday
2,8,15,23,2017,8,7,Monday
4,12,14,26,2017,7,20,Thursday
2,8,17,25,2017,5,8,Monday
1,14,13,27,2017,6,29,Thursday
8,9,11,20,2017,12,27,Wednseday
0,9,26,35,2018,6,19,Tuesday
4,11,7,18,2017,12,31,Sunday
1,2,15,17,2018,4,9,Monday
4,7,6,13,2018,8,16,Thursday
1,7,13,20,2018,5,9,Wednseday
3,19,8,27,2017,7,28,Friday
2,47,-27,20,2018,3,14,Wednseday
26,26,0,26,2017,6,2,Friday
4,10,15,25,2018,1,6,Saturday
1,8,14,22,2017,6,19,Monday
1,6,9,15,2018,8,21,Tuesday
2,7,13,20,2017,8,9,Wednseday
9,9,6,15,2017,11,26,Sunday
5,19,22,41,2018,1,27,Saturday
1,17,18,35,2017,5,2,Tuesday
2,9,23,32,2017,10,2,Monday
2,19,4,23,2018,1,28,Sunday
1,13,23,36,2017,3,22,Wednseday
1,12,27,39,2018,2,8,Thursday
24,50,-9,41,2018,1,26,Friday
7,25,3,28,2018,3,19,Monday
3,5,5,10,2018,5,11,Friday
1,5,11,16,2018,5,9,Wednseday
4,8,18,26,2017,3,30,Thursday
1,6,23,29,2018,6,17,Sunday
1,6,13,19,2017,8,31,Thursday
1,6,17,23,2018,4,17,Tuesday
2,21,6,27,2017,9,20,Wednseday
2,4,19,23,2017,9,25,Monday
4,16,2,18,2018,5,19,Saturday
2,6,7,13,2018,3,7,Wednseday
6,15,7,22,2017,3,29,Wednseday
6,23,7,30,2017,10,14,Saturday
1,3,4,7,2018,8,27,Monday
2,9,13,22,2018,7,31,Tuesday
3,17,28,45,2018,5,27,Sunday
1,4,9,13,2017,10,12,Thursday
3,11,16,27,2017,6,3,Saturday
1,16,17,33,2018,1,14,Sunday
2,5,19,24,2018,7,1,Sunday
3,7,18,25,2017,3,31,Friday
0,10,20,30,2017,12,12,Tuesday
3,5,19,24,2018,4,29,Sunday
5,11,13,24,2018,2,10,Saturday
6,10,14,24,2017,8,8,Tuesday
5,11,17,28,2018,1,12,Friday
6,7,6,13,2017,9,6,Wednseday
1,2,8,10,2018,6,25,Monday
0,3,10,13,2018,3,23,Friday
4,5,13,18,2018,2,1,Thursday
0,3,21,24,2018,6,11,Monday
1,11,26,37,2018,6,17,Sunday
1,57,-22,35,2018,1,10,Wednseday
1,7,12,19,2018,4,6,Friday
2,7,22,29,2017,3,28,Tuesday
1,4,26,30,2017,5,21,Sunday
5,9,4,13,2017,5,31,Wednseday
1,2,7,9,2018,8,7,Tuesday
3,7,25,32,2017,3,24,Friday
4,10,22,32,2018,4,28,Saturday
2,3,7,10,2018,5,12,Saturday
1,8,12,20,2017,11,9,Thursday
2,10,12,22,2017,6,11,Sunday
4,16,28,44,2018,2,4,Sunday
1,13,20,33,2017,7,12,Wednseday
8,14,8,22,2017,10,31,Tuesday
1,36,-7,29,2017,12,6,Wednseday
8,11,18,29,2018,6,26,Tuesday
1,15,14,29,2018,3,12,Monday
2,8,14,22,2017,8,29,Tuesday
3,5,8,13,2017,8,11,Friday
0,1,17,18,2018,5,24,Thursday
4,6,7,13,2017,5,12,Friday
1,31,-20,11,2017,7,10,Monday
1,17,8,25,2018,2,22,Thursday
3,18,7,25,2017,12,1,Friday
4,20,1,21,2017,11,24,Friday
1,4,18,22,2017,11,19,Sunday
4,8,9,17,2018,1,9,Tuesday
1,8,14,22,2018,7,3,Tuesday
1,10,13,23,2018,3,5,Monday
5,12,22,34,2017,10,4,Wednseday
1,8,17,25,2018,4,15,Sunday
2,8,13,21,2017,6,6,Tuesday
4,9,14,23,2017,4,1,Saturday
1,16,6,22,2018,3,26,Monday
1,6,15,21,2017,5,17,Wednseday
3,4,22,26,2018,6,3,Sunday
7,27,-8,19,2018,1,10,Wednseday
2,13,10,23,2018,1,24,Wednseday
2,12,6,18,2018,7,14,Saturday
1,6,21,27,2018,6,6,Wednseday
4,9,16,25,2017,12,8,Friday
4,39,-13,26,2017,12,14,Thursday
1,12,17,29,2017,1,26,Thursday
3,3,23,26,2017,12,2,Saturday
1,6,48,54,2018,8,22,Wednseday
3,14,6,20,2018,7,18,Wednseday
8,9,7,16,2018,3,19,Monday
5,9,14,23,2018,7,7,Saturday
1,7,17,24,2018,4,10,Tuesday
4,10,14,24,2018,7,23,Monday
7,28,-6,22,2018,3,21,Wednseday
1,5,6,11,2018,6,17,Sunday
1,13,30,43,2018,2,27,Tuesday
3,9,4,13,2018,5,19,Saturday
1,4,3,7,2018,8,9,Thursday
1,14,13,27,2018,6,7,Thursday
2,16,7,23,2018,2,14,Wednseday
4,12,9,21,2017,11,24,Friday
1,4,19,23,2018,6,24,Sunday
2,9,12,21,2017,11,1,Wednseday
2,21,1,22,2018,2,20,Tuesday
3,18,7,25,2018,3,10,Saturday
39,49,-12,37,2017,12,18,Monday
1,5,19,24,2018,5,13,Sunday
3,10,14,24,2017,9,22,Friday
1,2,14,16,2018,1,30,Tuesday
1,13,27,40,2018,2,9,Friday
1,5,32,37,2018,1,8,Monday
0,4,22,26,2018,6,21,Thursday
17,17,8,25,2018,2,23,Friday
1,20,12,32,2017,12,7,Thursday
6,27,-2,25,2017,11,25,Saturday
3,13,12,25,2018,4,15,Sunday
3,5,18,23,2018,7,28,Saturday
3,19,5,24,2017,11,17,Friday
0,15,20,35,2018,2,5,Monday
3,27,6,33,2018,2,18,Sunday
1,6,17,23,2017,3,21,Tuesday
2,11,21,32,2018,6,9,Saturday
3,11,13,24,2017,10,20,Friday
2,7,15,22,2018,5,7,Monday
3,5,25,30,2017,12,31,Sunday
4,18,14,32,2018,1,14,Sunday
1,8,7,15,2018,5,3,Thursday
17,21,17,38,2018,8,6,Monday
2,28,1,29,2017,12,11,Monday
6,15,16,31,2018,2,2,Friday
34,191,-175,16,2018,1,3,Wednseday
1,7,16,23,2018,5,15,Tuesday
5,10,15,25,2018,7,14,Saturday
11,13,13,26,2018,4,1,Sunday
3,7,19,26,2017,12,15,Friday
2,15,12,27,2017,10,3,Tuesday
3,10,16,26,2018,4,29,Sunday
2,8,17,25,2018,5,14,Monday
0,2,19,21,2017,5,24,Wednseday
2,4,19,23,2017,2,27,Monday
8,9,7,16,2018,4,10,Tuesday
1,21,3,24,2018,5,15,Tuesday
4,11,16,27,2017,7,21,Friday
3,10,12,22,2017,7,3,Monday
2,20,6,26,2017,11,15,Wednseday
3,5,8,13,2018,3,23,Friday
2,16,19,35,2017,8,29,Tuesday
0,33,0,33,2018,2,9,Friday
3,8,20,28,2018,4,16,Monday
1,13,12,25,2017,6,8,Thursday
10,19,20,39,2017,10,28,Saturday
4,19,0,19,2018,3,25,Sunday
1,7,10,17,2017,3,7,Tuesday
4,15,21,36,2018,5,3,Thursday
1,5,21,26,2018,8,1,Wednseday
2,6,25,31,2017,5,27,Saturday
5,15,30,45,2017,2,26,Sunday
1,9,20,29,2017,8,27,Sunday
0,19,17,36,2017,5,24,Wednseday
3,42,-15,27,2018,1,23,Tuesday
6,17,2,19,2018,4,7,Saturday
1,2,6,8,2018,8,20,Monday
18,31,-10,21,2018,3,2,Friday
6,19,21,40,2017,5,4,Thursday
8,16,14,30,2017,8,7,Monday
5,21,34,55,2018,6,1,Friday
1,36,0,36,2017,4,10,Monday
10,21,8,29,2017,11,27,Monday
1,8,11,19,2018,1,11,Thursday
7,8,13,21,2017,9,20,Wednseday
1,5,3,8,2018,8,16,Thursday
3,18,6,24,2018,2,23,Friday
2,5,22,27,2018,6,16,Saturday
4,7,3,10,2017,9,11,Monday
3,9,27,36,2018,3,13,Tuesday
0,11,34,45,2018,7,20,Friday
13,27,-4,23,2017,11,29,Wednseday
12,32,-13,19,2018,2,18,Sunday
1,8,17,25,2018,6,21,Thursday
1,21,14,35,2017,8,21,Monday
6,13,15,28,2018,1,11,Thursday
11,18,1,19,2017,9,1,Friday
2,5,19,24,2017,3,25,Saturday
4,16,5,21,2017,3,20,Monday
1,6,15,21,2018,8,9,Thursday
2,8,13,21,2018,4,25,Wednseday
9,18,37,55,2016,10,6,Thursday
1,6,14,20,2018,4,17,Tuesday
2,3,8,11,2018,4,1,Sunday
1,7,17,24,2018,4,17,Tuesday
4,17,11,28,2018,2,20,Tuesday
3,5,7,12,2018,3,9,Friday
1,7,21,28,2018,4,25,Wednseday
22,27,24,51,2018,3,27,Tuesday
4,14,7,21,2018,7,19,Thursday
1,12,26,38,2018,1,7,Sunday
2,5,5,10,2018,8,18,Saturday
3,22,10,32,2018,2,23,Friday
2,9,30,39,2018,4,23,Monday
1,10,11,21,2017,11,15,Wednseday
3,9,18,27,2018,4,21,Saturday
7,17,14,31,2018,5,22,Tuesday
4,16,27,43,2017,12,3,Sunday
2,11,26,37,2017,8,26,Saturday
1,18,-1,17,2018,3,6,Tuesday
1,8,17,25,2017,12,10,Sunday
0,1,18,19,2018,4,25,Wednseday
1,6,37,43,2018,6,5,Tuesday
3,4,21,25,2018,6,30,Saturday
5,18,20,38,2017,12,1,Friday
1,6,7,13,2018,8,2,Thursday
2,3,0,3,2018,8,13,Monday
1,8,15,23,2017,5,21,Sunday
5,12,21,33,2018,6,21,Thursday
6,28,-5,23,2017,6,13,Tuesday
5,14,6,20,2017,6,16,Friday
3,7,11,18,2018,8,10,Friday
4,6,8,14,2018,4,26,Thursday
3,14,28,42,2018,8,13,Monday
0,6,14,20,2018,2,21,Wednseday
5,11,11,22,2017,6,18,Sunday
1,6,16,22,2017,4,11,Tuesday
2,9,1,10,2018,8,20,Monday
2,3,17,20,2018,8,25,Saturday
6,43,-17,26,2017,11,23,Thursday
2,8,16,24,2017,11,14,Tuesday
5,26,14,40,2018,3,8,Thursday
9,19,5,24,2017,9,3,Sunday
1,20,7,27,2018,5,2,Wednseday
1,12,16,28,2018,5,2,Wednseday
2,3,20,23,2018,6,18,Monday
9,45,-15,30,2018,1,6,Saturday
6,11,19,30,2017,5,2,Tuesday
1,13,15,28,2017,10,24,Tuesday
3,8,3,11,2018,8,5,Sunday
1,8,15,23,2018,7,16,Monday
3,16,15,31,2018,1,30,Tuesday
2,11,-2,9,2018,7,16,Monday
1,6,19,25,2017,6,18,Sunday
5,28,-1,27,2018,4,18,Wednseday
6,12,14,26,2018,6,22,Friday
4,11,3,14,2018,2,12,Monday
5,7,8,15,2018,5,2,Wednseday
6,16,20,36,2017,3,7,Tuesday
2,8,20,28,2018,1,2,Tuesday
3,14,3,17,2017,8,28,Monday
2,8,15,23,2017,10,2,Monday
2,6,11,17,2018,6,12,Tuesday
2,13,7,20,2017,5,10,Wednseday
1,4,11,15,2018,8,20,Monday
1,7,19,26,2018,4,4,Wednseday
4,5,21,26,2017,3,2,Thursday
1,8,6,14,2018,8,6,Monday
4,7,6,13,2018,3,29,Thursday
7,11,11,22,2018,1,18,Thursday
4,4,6,10,2018,3,5,Monday
2,5,8,13,2017,10,11,Wednseday
1,13,-8,5,2018,8,2,Thursday
2,6,7,13,2018,2,28,Wednseday
3,12,12,24,2018,5,6,Sunday
3,11,13,24,2018,2,20,Tuesday
3,27,1,28,2017,11,24,Friday
2,5,20,25,2018,1,6,Saturday
2,10,18,28,2017,10,24,Tuesday
2,10,23,33,2018,5,26,Saturday
0,6,8,14,2018,2,9,Friday
2,9,16,25,2018,8,19,Sunday
3,23,11,34,2018,1,30,Tuesday
2,4,16,20,2017,12,16,Saturday
5,6,0,6,2018,8,22,Wednseday
6,15,14,29,2017,12,7,Thursday
8,17,8,25,2017,12,10,Sunday
1,7,16,23,2017,5,29,Monday
7,22,14,36,2017,12,5,Tuesday
2,7,28,35,2018,5,30,Wednseday
2,8,16,24,2017,8,13,Sunday
4,17,8,25,2018,5,5,Saturday
1,2,10,12,2018,5,16,Wednseday
1,8,17,25,2017,11,20,Monday
8,25,7,32,2018,2,15,Thursday
4,27,15,42,2018,1,25,Thursday
1,2,17,19,2018,1,31,Wednseday
3,22,8,30,2018,6,11,Monday
0,3,19,22,2018,1,16,Tuesday
3,10,27,37,2018,4,14,Saturday
9,20,6,26,2017,9,6,Wednseday
2,14,2,16,2018,1,15,Monday
2,6,17,23,2017,11,18,Saturday
7,11,1,12,2018,8,2,Thursday
3,37,-12,25,2018,2,26,Monday
2,9,26,35,2018,4,24,Tuesday
3,8,11,19,2017,11,17,Friday
2,12,19,31,2018,4,22,Sunday
2,16,1,17,2018,5,19,Saturday
2,8,18,26,2017,11,1,Wednseday
4,16,3,19,2018,5,20,Sunday
1,12,7,19,2018,3,8,Thursday
1,20,2,22,2018,5,17,Thursday
1,9,13,22,2018,2,28,Wednseday
1,3,8,11,2017,5,22,Monday
1,13,16,29,2017,2,8,Wednseday
2,12,25,37,2017,4,8,Saturday
3,12,9,21,2017,11,20,Monday
3,4,8,12,2018,3,16,Friday
2,10,12,22,2017,11,6,Monday
6,7,6,13,2017,10,28,Saturday
2,9,24,33,2017,9,20,Wednseday
2,2,15,17,2018,2,4,Sunday
3,15,15,30,2017,10,1,Sunday
7,10,16,26,2017,12,27,Wednseday
0,3,9,12,2017,9,15,Friday
1,6,17,23,2017,5,24,Wednseday
2,9,9,18,2018,3,31,Saturday
3,11,6,17,2018,1,20,Saturday
2,9,13,22,2017,9,17,Sunday
2,5,13,18,2018,4,5,Thursday
1,10,15,25,2017,3,6,Monday
3,16,14,30,2018,3,3,Saturday
10,45,4,49,2018,1,30,Tuesday
2,8,32,40,2017,8,27,Sunday
3,7,24,31,2018,6,15,Friday
1,7,12,19,2018,7,18,Wednseday
1,3,13,16,2018,2,6,Tuesday
1,13,10,23,2017,6,6,Tuesday
1,2,15,17,2018,1,28,Sunday
2,58,-33,25,2018,3,3,Saturday
4,9,2,11,2018,8,4,Saturday
2,8,16,24,2017,4,2,Sunday
2,3,14,17,2018,4,17,Tuesday
1,14,17,31,2017,8,14,Monday
1,3,9,12,2017,10,29,Sunday
3,11,10,21,2017,3,3,Friday
3,8,43,51,2017,5,15,Monday
3,11,8,19,2017,9,15,Friday
5,48,-14,34,2018,3,17,Saturday
2,6,21,27,2017,8,29,Tuesday
2,16,18,34,2018,2,20,Tuesday
1,18,3,21,2017,3,21,Tuesday
1,15,20,35,2017,5,3,Wednseday
0,13,17,30,2018,6,27,Wednseday
3,5,19,24,2018,1,21,Sunday
2,21,16,37,2018,1,10,Wednseday
2,9,18,27,2018,1,10,Wednseday
5,10,14,24,2018,5,5,Saturday
3,9,18,27,2018,3,20,Tuesday
1,14,16,30,2017,4,3,Monday
1,8,9,17,2018,3,27,Tuesday
1,6,24,30,2018,7,18,Wednseday
4,9,-5,4,2018,8,6,Monday
1,19,5,24,2017,5,8,Monday
3,13,39,52,2018,6,2,Saturday
16,42,4,46,2018,4,2,Monday
2,12,12,24,2018,2,18,Sunday
1,3,7,10,2018,3,12,Monday
3,4,6,10,2017,5,14,Sunday
1,23,19,42,2017,12,5,Tuesday
1,7,20,27,2018,7,17,Tuesday
1,9,12,21,2018,8,7,Tuesday
1,7,9,16,2017,9,11,Monday
2,9,28,37,2018,6,11,Monday
1,4,21,25,2017,12,25,Monday
1,9,10,19,2018,8,8,Wednseday
1,5,19,24,2018,5,13,Sunday
1,7,10,17,2017,9,19,Tuesday
1,7,18,25,2018,1,8,Monday
2,7,7,14,2018,5,16,Wednseday
2,5,22,27,2018,8,18,Saturday
22,27,9,36,2018,6,6,Wednseday
5,9,11,20,2017,12,30,Saturday
2,7,15,22,2017,7,4,Tuesday
1,2,7,9,2018,6,12,Tuesday
1,7,21,28,2017,3,20,Monday
1,24,6,30,2017,5,1,Monday
3,6,24,30,2017,6,6,Tuesday
1,8,38,46,2018,6,10,Sunday
0,1,12,13,2017,7,19,Wednseday
2,14,17,31,2017,11,28,Tuesday
8,9,4,13,2017,10,11,Wednseday
1,5,9,14,2018,8,15,Wednseday
1,6,22,28,2018,4,26,Thursday
0,1,20,21,2018,6,20,Wednseday
1,4,17,21,2018,7,16,Monday
1,6,21,27,2017,11,8,Wednseday
2,16,13,29,2017,9,4,Monday
3,18,6,24,2017,9,3,Sunday
1,13,11,24,2018,1,16,Tuesday
0,23,5,28,2018,4,5,Thursday
14,19,5,24,2017,10,6,Friday
1,14,15,29,2018,1,8,Monday
1,7,4,11,2017,10,9,Monday
1,8,6,14,2017,6,15,Thursday
1,2,14,16,2018,4,9,Monday
1,5,9,14,2017,11,16,Thursday
3,28,3,31,2018,4,7,Saturday
4,13,7,20,2017,9,1,Friday
7,23,0,23,2017,12,5,Tuesday
0,2,17,19,2017,3,15,Wednseday
1,12,8,20,2018,3,22,Thursday
3,6,7,13,2018,8,11,Saturday
4,12,12,24,2017,7,14,Friday
15,18,18,36,2018,6,18,Monday
1,18,10,28,2018,3,26,Monday
6,16,3,19,2018,3,21,Wednseday
3,9,12,21,2018,1,17,Wednseday
3,22,-6,16,2018,3,12,Monday
3,24,6,30,2018,4,16,Monday
5,21,9,30,2017,7,5,Wednseday
5,15,8,23,2018,3,18,Sunday
2,22,14,36,2017,4,16,Sunday
3,25,13,38,2017,4,29,Saturday
2,3,13,16,2018,6,9,Saturday
3,35,-1,34,2017,12,1,Friday
4,14,8,22,2017,11,16,Thursday
4,8,3,11,2017,9,4,Monday
4,5,9,14,2017,8,25,Friday
3,6,17,23,2018,1,23,Tuesday
0,9,10,19,2018,7,18,Wednseday
17,25,-7,18,2018,7,16,Monday
5,12,14,26,2017,11,9,Thursday
1,38,-13,25,2018,3,12,Monday
5,14,22,36,2018,2,5,Monday
5,20,7,27,2017,9,14,Thursday
5,19,10,29,2018,1,31,Wednseday
1,22,8,30,2018,4,8,Sunday
1,16,14,30,2018,2,19,Monday
5,16,8,24,2017,11,25,Saturday
2,23,1,24,2018,1,28,Sunday
1,22,2,24,2018,1,30,Tuesday
3,10,15,25,2018,4,16,Monday
2,8,9,17,2017,3,7,Tuesday
1,8,13,21,2017,5,8,Monday
8,31,25,56,2017,3,13,Monday
1,9,22,31,2017,10,8,Sunday
11,23,8,31,2018,2,26,Monday
7,13,25,38,2017,1,24,Tuesday
1,15,14,29,2017,12,4,Monday
4,13,8,21,2018,3,8,Thursday
12,19,10,29,2018,7,12,Thursday
9,14,15,29,2018,1,16,Tuesday
1,11,15,26,2017,4,7,Friday
8,17,-6,11,2017,10,15,Sunday
2,8,15,23,2018,1,28,Sunday
10,22,7,29,2017,5,22,Monday
2,7,21,28,2017,7,3,Monday
0,6,13,19,2018,5,11,Friday
3,10,11,21,2018,6,8,Friday
1,4,10,14,2018,7,23,Monday
1,8,4,12,2017,6,18,Sunday
1,27,23,50,2018,1,4,Thursday
6,7,9,16,2018,1,31,Wednseday
7,10,20,30,2018,6,26,Tuesday
7,13,13,26,2018,1,6,Saturday
9,11,10,21,2018,4,2,Monday
2,14,1,15,2018,5,23,Wednseday
8,27,7,34,2017,12,28,Thursday
4,10,25,35,2017,8,18,Friday
5,18,23,41,2017,1,7,Saturday
0,2,12,14,2017,11,24,Friday
3,6,26,32,2018,5,5,Saturday
9,17,21,38,2017,5,2,Tuesday
3,9,9,18,2017,10,16,Monday
1,4,19,23,2017,11,26,Sunday
4,12,15,27,2017,4,6,Thursday
2,20,8,28,2017,12,19,Tuesday
1,12,10,22,2017,5,11,Thursday
2,6,-3,3,2018,8,7,Tuesday
2,8,20,28,2017,5,1,Monday
4,19,2,21,2018,2,19,Monday
3,26,9,35,2017,8,11,Friday
6,22,4,26,2018,3,21,Wednseday
2,23,31,54,2018,5,26,Saturday
4,18,8,26,2017,11,3,Friday
3,7,11,18,2017,5,12,Friday
0,13,29,42,2018,6,14,Thursday
5,11,11,22,2018,7,19,Thursday
2,16,17,33,2017,5,24,Wednseday
3,14,18,32,2018,4,16,Monday
1,3,6,9,2018,5,14,Monday
1,9,13,22,2018,2,20,Tuesday
2,10,28,38,2018,8,19,Sunday
0,4,18,22,2017,10,2,Monday
1,7,9,16,2018,1,30,Tuesday
1,19,0,19,2017,4,26,Wednseday
3,12,20,32,2017,11,4,Saturday
2,15,8,23,2017,8,13,Sunday
2,10,14,24,2018,1,14,Sunday
3,8,15,23,2018,4,17,Tuesday
9,17,18,35,2017,5,15,Monday
2,5,12,17,2017,10,15,Sunday
2,9,9,18,2017,4,23,Sunday
1,12,14,26,2017,9,21,Thursday
2,8,14,22,2017,8,28,Monday
1,18,10,28,2017,6,22,Thursday
6,13,8,21,2017,4,5,Wednseday
2,9,18,27,2017,5,2,Tuesday
8,15,25,40,2017,5,7,Sunday
1,8,21,29,2017,1,16,Monday
4,7,13,20,2017,9,1,Friday
1,4,15,19,2018,7,1,Sunday
0,8,34,42,2018,6,7,Thursday
2,3,14,17,2018,1,9,Tuesday
1,14,9,23,2018,5,15,Tuesday
2,4,6,10,2018,8,19,Sunday
3,5,11,16,2018,1,14,Sunday
1,6,19,25,2018,4,19,Thursday
4,5,21,26,2017,7,28,Friday
1,7,18,25,2017,7,6,Thursday
1,10,22,32,2018,2,5,Monday
2,14,10,24,2017,10,30,Monday
4,9,10,19,2017,8,31,Thursday
1,11,11,22,2018,1,18,Thursday
1,13,10,23,2018,8,14,Tuesday
0,12,16,28,2017,5,5,Friday
2,7,20,27,2017,11,14,Tuesday
2,10,22,32,2017,3,27,Monday
2,10,14,24,2017,11,20,Monday
4,9,9,18,2018,3,19,Monday
1,8,14,22,2018,5,15,Tuesday
1,18,3,21,2018,7,23,Monday
4,19,14,33,2017,12,29,Friday
6,8,15,23,2018,5,29,Tuesday
2,19,13,32,2018,1,7,Sunday
1,3,7,10,2018,4,2,Monday
2,5,13,18,2018,7,21,Saturday
3,67,-40,27,2018,3,17,Saturday
1,12,20,32,2017,12,4,Monday
1,4,22,26,2017,8,3,Thursday
3,7,6,13,2017,7,11,Tuesday
0,7,23,30,2017,2,7,Tuesday
2,4,21,25,2018,4,1,Sunday
6,22,6,28,2017,12,6,Wednseday
6,18,11,29,2018,7,5,Thursday
1,8,18,26,2018,7,19,Thursday
2,14,16,30,2017,7,17,Monday
1,2,3,5,2018,8,12,Sunday
3,13,18,31,2017,11,11,Saturday
1,8,22,30,2018,7,24,Tuesday
5,36,-7,29,2017,11,29,Wednseday
1,6,14,20,2018,2,27,Tuesday
2,5,14,19,2018,1,11,Thursday
6,11,13,24,2018,4,27,Friday
4,22,6,28,2018,2,2,Friday
1,6,18,24,2018,1,2,Tuesday
0,5,8,13,2017,9,6,Wednseday
1,10,26,36,2017,5,21,Sunday
3,8,19,27,2018,2,6,Tuesday
6,10,24,34,2018,3,23,Friday
2,11,16,27,2017,11,7,Tuesday
6,13,19,32,2017,6,1,Thursday
1,2,14,16,2018,3,7,Wednseday
1,7,13,20,2017,7,18,Tuesday
3,22,28,50,2017,1,30,Monday
2,3,13,16,2017,8,21,Monday
3,8,16,24,2018,1,7,Sunday
5,16,9,25,2017,11,25,Saturday
2,4,15,19,2017,3,25,Saturday
4,6,19,25,2018,4,21,Saturday
4,27,2,29,2017,1,26,Thursday
3,4,15,19,2018,4,14,Saturday
2,3,8,11,2017,11,20,Monday
1,7,13,20,2017,7,19,Wednseday
3,4,10,14,2018,2,19,Monday
5,44,-5,39,2017,11,26,Sunday
7,13,12,25,2017,7,13,Thursday
1,5,16,21,2017,10,19,Thursday
1,6,16,22,2017,4,12,Wednseday
1,9,23,32,2017,12,17,Sunday
2,7,16,23,2018,1,8,Monday
2,4,12,16,2018,2,6,Tuesday
2,8,14,22,2017,9,12,Tuesday
3,6,20,26,2017,12,24,Sunday
2,17,17,34,2017,7,4,Tuesday
1,29,-7,22,2018,2,18,Sunday
4,15,16,31,2017,10,22,Sunday
2,10,19,29,2017,12,4,Monday
1,3,20,23,2017,2,6,Monday
3,4,8,12,2017,11,19,Sunday
10,30,10,40,2017,12,17,Sunday
3,6,20,26,2017,7,14,Friday
1,6,29,35,2018,6,19,Tuesday
4,7,46,53,2016,10,6,Thursday
3,14,29,43,2018,6,26,Tuesday
1,7,18,25,2018,1,11,Thursday
2,9,20,29,2018,5,7,Monday
5,13,17,30,2017,5,13,Saturday
1,18,11,29,2017,2,16,Thursday
1,5,18,23,2017,3,26,Sunday
4,30,0,30,2018,1,16,Tuesday
3,10,14,24,2017,4,1,Saturday
6,13,21,34,2017,9,28,Thursday
4,17,6,23,2017,7,9,Sunday
2,15,10,25,2018,2,25,Sunday
1,10,21,31,2017,5,1,Monday
3,4,6,10,2018,6,18,Monday
3,14,17,31,2018,1,2,Tuesday
2,6,35,41,2017,2,1,Wednseday
2,5,12,17,2018,4,21,Saturday
2,8,7,15,2018,8,22,Wednseday
0,10,18,28,2017,5,5,Friday
0,6,20,26,2018,4,19,Thursday
4,13,13,26,2017,11,10,Friday
6,19,7,26,2017,7,14,Friday
5,10,14,24,2017,7,21,Friday
7,16,7,23,2018,1,3,Wednseday
3,10,10,20,2017,10,21,Saturday
2,9,20,29,2018,7,22,Sunday
1,12,8,20,2018,2,15,Thursday
3,16,8,24,2018,4,1,Sunday
3,11,13,24,2017,11,24,Friday
3,28,-4,24,2018,3,9,Friday
2,8,18,26,2017,10,12,Thursday
3,23,6,29,2018,3,25,Sunday
1,6,18,24,2018,4,1,Sunday
3,25,-5,20,2018,5,15,Tuesday
2,8,14,22,2017,6,11,Sunday
1,7,11,18,2018,8,9,Thursday
5,11,10,21,2018,1,18,Thursday
1,16,16,32,2017,12,11,Monday
1,22,-1,21,2017,3,20,Monday
4,7,8,15,2018,2,26,Monday
5,7,5,12,2018,4,11,Wednseday
2,13,11,24,2017,8,26,Saturday
0,14,21,35,2018,3,23,Friday
4,8,25,33,2018,5,10,Thursday
4,10,8,18,2017,7,24,Monday
1,8,19,27,2018,4,26,Thursday
2,8,16,24,2018,4,22,Sunday
2,7,19,26,2017,4,6,Thursday
1,5,11,16,2018,7,22,Sunday
4,18,7,25,2017,11,10,Friday
2,4,19,23,2017,4,22,Saturday
3,16,16,32,2017,9,24,Sunday
4,11,21,32,2018,1,5,Friday
19,25,9,34,2018,7,7,Saturday
28,38,2,40,2018,1,24,Wednseday
0,9,13,22,2017,8,15,Tuesday
6,17,9,26,2018,1,14,Sunday
6,20,9,29,2018,3,21,Wednseday
2,12,13,25,2018,2,4,Sunday
2,9,22,31,2017,9,10,Sunday
1,7,22,29,2017,5,9,Tuesday
2,15,14,29,2017,11,15,Wednseday
1,4,2,6,2018,8,23,Thursday
1,7,13,20,2017,7,27,Thursday
0,4,16,20,2018,7,26,Thursday
1,4,6,10,2018,8,13,Monday
1,12,5,17,2018,4,2,Monday
3,8,5,13,2017,8,23,Wednseday
4,21,32,53,2016,10,7,Friday
2,22,-5,17,2018,3,6,Tuesday
3,131,-104,27,2018,1,12,Friday
2,5,13,18,2018,5,12,Saturday
3,11,15,26,2017,4,7,Friday
1,6,17,23,2017,6,13,Tuesday
3,7,12,19,2018,5,11,Friday
0,12,7,19,2018,3,15,Thursday
1,3,6,9,2018,8,5,Sunday
4,27,-5,22,2017,6,22,Thursday
3,36,2,38,2017,12,8,Friday
1,7,10,17,2018,7,31,Tuesday
3,10,13,23,2018,2,27,Tuesday
3,5,12,17,2018,1,19,Friday
7,11,23,34,2018,6,26,Tuesday
2,5,4,9,2018,8,1,Wednseday
2,6,16,22,2018,4,12,Thursday
1,6,15,21,2017,5,4,Thursday
1,6,7,13,2017,9,7,Thursday
3,11,20,31,2018,6,22,Friday
2,9,20,29,2018,6,20,Wednseday
3,7,1,8,2018,8,6,Monday
2,8,15,23,2017,7,23,Sunday
1,2,10,12,2017,10,22,Sunday
2,8,17,25,2018,6,25,Monday
2,10,11,21,2018,8,7,Tuesday
1,5,12,17,2018,3,19,Monday
10,18,12,30,2017,5,29,Monday
5,10,10,20,2017,10,20,Friday
3,9,15,24,2017,3,27,Monday
5,26,2,28,2017,9,21,Thursday
0,9,19,28,2017,12,13,Wednseday
3,13,4,17,2018,5,20,Sunday
0,9,14,23,2017,3,14,Tuesday
6,20,49,69,2018,5,29,Tuesday
2,10,17,27,2017,11,11,Saturday
2,6,8,14,2017,11,23,Thursday
0,18,4,22,2018,2,1,Thursday
4,22,14,36,2018,1,25,Thursday
3,14,2,16,2017,12,5,Tuesday
1,3,0,3,2018,8,6,Monday
4,9,18,27,2018,3,15,Thursday
6,13,14,27,2017,11,11,Saturday
2,10,13,23,2017,12,3,Sunday
2,9,15,24,2017,12,31,Sunday
5,6,7,13,2017,8,10,Thursday
4,10,16,26,2017,11,25,Saturday
1,17,14,31,2017,3,20,Monday
0,6,16,22,2017,4,20,Thursday
1,2,14,16,2018,4,10,Tuesday
1,4,5,9,2018,7,22,Sunday
2,9,14,23,2018,5,6,Sunday
2,3,5,8,2018,8,12,Sunday
9,34,-12,22,2018,3,7,Wednseday
2,14,21,35,2017,5,16,Tuesday
2,13,9,22,2017,8,1,Tuesday
3,14,24,38,2018,4,7,Saturday
1,3,7,10,2018,3,12,Monday
12,13,5,18,2018,7,12,Thursday
2,6,20,26,2017,5,27,Saturday
4,17,18,35,2017,7,7,Friday
1,10,20,30,2018,3,12,Monday
1,37,-2,35,2017,12,12,Tuesday
4,12,22,34,2017,4,15,Saturday
3,7,10,17,2017,9,22,Friday
5,6,8,14,2017,11,24,Friday
1,9,42,51,2018,6,4,Monday
2,3,7,10,2017,5,14,Sunday
2,13,8,21,2018,1,9,Tuesday
2,8,12,20,2017,11,15,Wednseday
3,8,23,31,2017,10,1,Sunday
1,17,7,24,2018,7,15,Sunday
4,11,15,26,2017,11,4,Saturday
4,13,8,21,2017,11,24,Friday
2,20,14,34,2018,3,13,Tuesday
4,7,14,21,2017,10,19,Thursday
1,6,22,28,2018,1,29,Monday
2,8,10,18,2018,6,10,Sunday
1,3,10,13,2017,10,10,Tuesday
4,7,19,26,2018,3,30,Friday
0,14,21,35,2018,5,8,Tuesday
1,14,13,27,2017,4,19,Wednseday
2,19,17,36,2017,6,11,Sunday
1,9,11,20,2018,5,24,Thursday
3,10,4,14,2018,8,10,Friday
5,20,10,30,2017,10,11,Wednseday
0,6,15,21,2017,6,13,Tuesday
7,9,15,24,2018,6,5,Tuesday
1,6,4,10,2018,8,21,Tuesday
4,12,14,26,2017,5,7,Sunday
2,5,5,10,2018,7,21,Saturday
2,8,21,29,2017,4,3,Monday
4,19,8,27,2017,4,20,Thursday
3,16,10,26,2018,1,14,Sunday
1,22,1,23,2017,3,13,Monday
4,15,20,35,2017,6,15,Thursday
9,16,6,22,2017,3,5,Sunday
2,3,5,8,2018,8,19,Sunday
1,2,13,15,2018,6,27,Wednseday
0,5,15,20,2017,6,29,Thursday
1,15,17,32,2018,2,18,Sunday
1,4,14,18,2018,3,19,Monday
7,16,6,22,2018,7,11,Wednseday
2,7,22,29,2018,1,22,Monday
3,40,-1,39,2018,2,16,Friday
3,6,14,20,2017,12,30,Saturday
4,36,-11,25,2017,9,7,Thursday
3,10,11,21,2018,8,7,Tuesday
2,13,9,22,2017,11,5,Sunday
5,44,-15,29,2018,3,4,Sunday
2,15,6,21,2018,7,17,Tuesday
3,17,15,32,2018,3,17,Saturday
2,5,0,5,2018,8,8,Wednseday
6,56,-22,34,2017,12,30,Saturday
2,13,23,36,2018,8,8,Wednseday
1,10,22,32,2017,12,7,Thursday
0,1,3,4,2018,8,27,Monday
4,5,7,12,2018,6,23,Saturday
9,13,4,17,2017,4,25,Tuesday
4,11,29,40,2017,10,13,Friday
2,6,19,25,2018,4,21,Saturday
5,8,17,25,2018,4,19,Thursday
13,18,50,68,2017,9,23,Saturday
1,9,15,24,2018,4,23,Monday
1,3,16,19,2017,10,8,Sunday
11,27,-4,23,2018,2,17,Saturday
1,6,15,21,2017,3,30,Thursday
2,5,17,22,2017,11,19,Sunday
3,7,14,21,2017,8,18,Friday
1,2,14,16,2018,1,31,Wednseday
2,15,8,23,2017,4,30,Sunday
2,7,17,24,2018,7,3,Tuesday
4,5,12,17,2018,2,17,Saturday
34,54,12,66,2018,1,6,Saturday
1,8,15,23,2017,11,8,Wednseday
2,13,19,32,2018,4,19,Thursday
4,15,18,33,2017,9,21,Thursday
3,14,18,32,2018,1,5,Friday
2,8,9,17,2018,7,3,Tuesday
2,6,17,23,2018,7,18,Wednseday
6,39,-4,35,2018,1,19,Friday
38,44,7,51,2016,10,4,Tuesday
2,8,9,17,2018,5,8,Tuesday
3,26,4,30,2017,10,15,Sunday
1,6,15,21,2018,8,1,Wednseday
4,5,11,16,2017,9,9,Saturday
5,10,29,39,2018,4,8,Sunday
3,4,15,19,2018,4,14,Saturday
0,7,16,23,2017,2,6,Monday
1,11,10,21,2017,9,13,Wednseday
1,2,11,13,2017,7,18,Tuesday
1,14,14,28,2018,8,13,Monday
1,12,9,21,2018,7,16,Monday
4,5,10,15,2017,8,17,Thursday
2,8,17,25,2018,4,16,Monday
5,11,17,28,2017,10,26,Thursday
2,6,24,30,2017,9,23,Saturday
3,14,11,25,2017,8,25,Friday
1,8,33,41,2017,1,11,Wednseday
7,17,10,27,2017,12,12,Tuesday
2,8,15,23,2017,2,27,Monday
2,3,16,19,2017,10,8,Sunday
1,12,14,26,2018,2,8,Thursday
1,9,13,22,2017,7,26,Wednseday
3,15,9,24,2018,2,13,Tuesday
3,27,-3,24,2018,5,11,Friday
1,25,-13,12,2018,7,12,Thursday
4,11,13,24,2017,5,19,Friday
2,7,13,20,2017,7,11,Tuesday
1,7,14,21,2017,5,29,Monday
1,2,14,16,2017,6,4,Sunday
2,11,11,22,2017,5,15,Monday
2,8,14,22,2018,4,18,Wednseday
3,13,4,17,2018,5,15,Tuesday
2,34,-3,31,2017,11,25,Saturday
1,3,12,15,2018,1,22,Monday
4,19,1,20,2018,5,17,Thursday
1,17,0,17,2018,5,21,Monday
5,15,4,19,2018,3,3,Saturday
4,22,10,32,2017,12,22,Friday
2,9,14,23,2017,7,2,Sunday
4,11,17,28,2018,1,22,Monday
7,44,-22,22,2018,1,30,Tuesday
4,8,21,29,2017,7,30,Sunday
7,20,0,20,2018,3,2,Friday
1,8,26,34,2017,8,3,Thursday
1,11,12,23,2017,8,6,Sunday
2,6,6,12,2018,3,7,Wednseday
2,8,29,37,2017,5,23,Tuesday
4,11,8,19,2017,9,8,Friday
5,11,24,35,2018,6,22,Friday
7,13,13,26,2018,5,25,Friday
2,14,16,30,2017,7,26,Wednseday
2,19,15,34,2017,7,15,Saturday
1,8,3,11,2018,8,12,Sunday
6,7,5,12,2018,3,14,Wednseday
0,2,20,22,2018,6,20,Wednseday
6,26,13,39,2017,12,29,Friday
21,37,-1,36,2018,2,7,Wednseday
5,41,-13,28,2017,11,24,Friday
2,21,4,25,2017,11,25,Saturday
4,5,0,5,2018,8,3,Friday
1,12,8,20,2018,2,21,Wednseday
7,29,-14,15,2017,11,21,Tuesday
1,6,21,27,2018,6,28,Thursday
14,42,-6,36,2018,4,16,Monday
1,9,14,23,2017,5,22,Monday
0,6,18,24,2017,5,19,Friday
4,7,5,12,2018,8,4,Saturday
0,13,15,28,2018,1,8,Monday
2,14,3,17,2017,4,25,Tuesday
2,17,27,44,2017,12,10,Sunday
5,12,10,22,2017,11,1,Wednseday
3,10,9,19,2018,8,11,Saturday
0,13,21,34,2018,6,7,Thursday
6,14,10,24,2018,2,17,Saturday
5,16,4,20,2017,11,16,Thursday
2,5,11,16,2018,8,11,Saturday
1,8,13,21,2017,8,28,Monday
5,12,27,39,2017,10,27,Friday
20,46,-17,29,2018,6,13,Wednseday
0,7,16,23,2018,5,14,Monday
3,19,7,26,2018,1,26,Friday
2,10,12,22,2017,7,10,Monday
4,11,7,18,2018,8,10,Friday
0,2,18,20,2018,5,10,Thursday
1,10,19,29,2017,4,23,Sunday
6,7,14,21,2018,6,12,Tuesday
0,5,17,22,2017,10,18,Wednseday
1,5,28,33,2018,5,31,Thursday
4,9,14,23,2017,4,9,Sunday
2,13,22,35,2017,5,31,Wednseday
3,15,12,27,2018,5,1,Tuesday
1,15,12,27,2018,3,21,Wednseday
3,13,26,39,2018,6,2,Saturday
2,9,16,25,2018,6,3,Sunday
3,20,26,46,2018,2,2,Friday
3,10,9,19,2017,3,4,Saturday
1,21,12,33,2018,1,3,Wednseday
6,17,8,25,2017,11,10,Friday
5,23,0,23,2018,2,21,Wednseday
1,34,-11,23,2017,9,13,Wednseday
4,9,10,19,2017,3,25,Saturday
1,6,8,14,2018,7,19,Thursday
1,15,10,25,2018,2,22,Thursday
4,19,1,20,2018,2,23,Friday
1,4,14,18,2018,6,10,Sunday
2,10,12,22,2017,7,24,Monday
2,25,-1,24,2018,1,8,Monday
7,13,7,20,2017,11,24,Friday
1,7,19,26,2017,7,12,Wednseday
1,2,6,8,2018,5,9,Wednseday
8,17,8,25,2018,1,28,Sunday
3,4,10,14,2017,6,5,Monday
2,9,22,31,2017,7,24,Monday
18,26,-5,21,2018,1,12,Friday
2,11,27,38,2018,4,16,Monday
2,13,16,29,2017,2,8,Wednseday
1,7,17,24,2018,5,14,Monday
1,2,7,9,2018,6,12,Tuesday
6,7,6,13,2018,3,29,Thursday
17,31,24,55,2017,2,4,Saturday
2,3,14,17,2018,1,20,Saturday
27,36,-9,27,2017,2,14,Tuesday
2,5,22,27,2017,3,1,Wednseday
1,2,23,25,2018,2,4,Sunday
5,8,8,16,2017,11,25,Saturday
1,4,2,6,2018,8,16,Thursday
0,10,14,24,2018,4,9,Monday
2,11,20,31,2017,9,16,Saturday
5,12,7,19,2018,3,15,Thursday
2,8,16,24,2017,4,11,Tuesday
5,15,7,22,2017,7,12,Wednseday
1,4,23,27,2018,1,23,Tuesday
5,7,13,20,2017,7,21,Friday
4,14,13,27,2017,6,23,Friday
7,15,20,35,2017,8,28,Monday
0,1,13,14,2018,8,16,Thursday
1,8,11,19,2018,7,18,Wednseday
2,4,13,17,2017,12,4,Monday
3,10,21,31,2017,11,3,Friday
2,8,20,28,2018,7,4,Wednseday
3,6,7,13,2018,6,8,Friday
4,16,10,26,2017,11,30,Thursday
0,5,21,26,2018,4,11,Wednseday
4,6,21,27,2017,2,25,Saturday
2,4,13,17,2017,9,10,Sunday
6,23,-3,20,2018,3,23,Friday
4,5,7,12,2018,5,18,Friday
7,8,5,13,2017,5,31,Wednseday
3,10,7,17,2018,5,8,Tuesday
2,12,16,28,2017,9,27,Wednseday
4,32,6,38,2017,11,26,Sunday
3,6,19,25,2017,11,24,Friday
1,7,8,15,2018,5,7,Monday
9,14,4,18,2018,7,9,Monday
1,26,2,28,2018,2,1,Thursday
1,15,13,28,2017,12,26,Tuesday
1,8,14,22,2017,8,2,Wednseday
1,21,8,29,2018,6,14,Thursday
0,11,18,29,2017,10,5,Thursday
3,51,-29,22,2018,2,21,Wednseday
6,20,3,23,2017,9,6,Wednseday
4,9,13,22,2018,7,19,Thursday
13,24,7,31,2018,7,3,Tuesday
3,4,3,7,2018,8,17,Friday
6,8,17,25,2018,4,19,Thursday
5,19,23,42,2018,5,30,Wednseday
3,7,17,24,2018,6,22,Friday
3,10,24,34,2018,5,5,Saturday
5,31,0,31,2018,1,14,Sunday
2,17,19,36,2017,10,24,Tuesday
1,7,21,28,2018,7,3,Tuesday
1,15,4,19,2018,6,10,Sunday
4,14,7,21,2017,12,22,Friday
21,23,-6,17,2018,7,31,Tuesday
5,18,14,32,2017,6,16,Friday
4,11,20,31,2018,2,23,Friday
1,13,10,23,2017,11,29,Wednseday
1,5,16,21,2018,6,27,Wednseday
1,8,13,21,2018,4,25,Wednseday
3,17,2,19,2018,6,16,Saturday
0,7,23,30,2018,1,9,Tuesday
1,6,15,21,2018,6,26,Tuesday
3,19,13,32,2017,12,4,Monday
4,14,7,21,2018,3,23,Friday
11,25,1,26,2018,7,13,Friday
3,7,13,20,2018,3,16,Friday
1,5,18,23,2017,5,21,Sunday
3,11,10,21,2017,11,24,Friday
1,3,1,4,2018,8,5,Sunday
4,11,7,18,2018,8,12,Sunday
4,18,14,32,2017,10,21,Saturday
2,9,20,29,2017,9,27,Wednseday
3,13,13,26,2018,1,10,Wednseday
3,11,20,31,2018,7,14,Saturday
1,12,16,28,2018,3,8,Thursday
9,12,41,53,2016,10,6,Thursday
1,18,16,34,2017,7,13,Thursday
5,9,14,23,2018,1,3,Wednseday
4,23,8,31,2017,12,16,Saturday
1,31,4,35,2018,2,6,Tuesday
2,10,26,36,2017,8,20,Sunday
4,34,6,40,2018,1,25,Thursday
1,6,11,17,2018,7,24,Tuesday
2,18,12,30,2017,6,24,Saturday
5,11,15,26,2018,1,6,Saturday
3,10,14,24,2018,8,18,Saturday
2,5,10,15,2017,5,7,Sunday
5,12,15,27,2017,2,8,Wednseday
3,18,3,21,2017,11,24,Friday
0,10,12,22,2018,4,25,Wednseday
1,8,18,26,2018,4,12,Thursday
4,10,19,29,2017,1,22,Sunday
1,4,7,11,2018,8,13,Monday
3,18,3,21,2018,2,19,Monday
8,12,6,18,2017,10,22,Sunday
1,2,13,15,2018,6,27,Wednseday
1,13,15,28,2017,4,4,Tuesday
2,5,9,14,2017,7,5,Wednseday
2,8,25,33,2017,7,30,Sunday
3,10,13,23,2018,4,4,Wednseday
4,33,-12,21,2018,2,23,Friday
7,36,6,42,2018,3,28,Wednseday
6,37,-3,34,2017,12,9,Saturday
6,11,15,26,2017,4,28,Friday
1,3,18,21,2018,1,17,Wednseday
1,8,15,23,2017,12,6,Wednseday
1,5,8,13,2017,6,22,Thursday
0,13,15,28,2017,12,14,Thursday
2,3,14,17,2018,1,13,Saturday
1,9,15,24,2017,11,5,Sunday
2,14,8,22,2017,10,17,Tuesday
1,8,9,17,2018,7,30,Monday
2,11,12,23,2017,9,24,Sunday
5,8,14,22,2017,4,12,Wednseday
2,9,12,21,2017,3,22,Wednseday
3,19,9,28,2017,8,4,Friday
5,6,7,13,2017,10,11,Wednseday
3,4,9,13,2018,5,5,Saturday
1,2,10,12,2018,6,13,Wednseday
4,19,14,33,2018,1,19,Friday
1,9,13,22,2018,7,2,Monday
0,8,26,34,2017,12,6,Wednseday
6,9,5,14,2018,8,14,Tuesday
0,3,17,20,2017,7,4,Tuesday
24,33,22,55,2017,12,22,Friday
2,3,10,13,2018,5,5,Saturday
4,13,8,21,2017,3,9,Thursday
3,10,20,30,2017,9,26,Tuesday
25,32,17,49,2018,2,2,Friday
4,6,13,19,2017,12,7,Thursday
3,6,19,25,2017,8,25,Friday
10,28,9,37,2017,4,8,Saturday
2,16,8,24,2017,4,11,Tuesday
2,9,15,24,2018,4,15,Sunday
4,23,14,37,2018,4,16,Monday
2,10,20,30,2017,6,11,Sunday
1,2,3,5,2018,8,5,Sunday
2,15,16,31,2018,2,4,Sunday
3,20,0,20,2018,3,16,Friday
1,6,7,13,2018,7,31,Tuesday
1,22,20,42,2017,9,26,Tuesday
3,11,35,46,2017,10,14,Saturday
3,10,23,33,2018,4,29,Sunday
5,15,14,29,2017,12,13,Wednseday
1,11,22,33,2018,5,3,Thursday
5,16,28,44,2017,8,5,Saturday
4,5,14,19,2017,12,2,Saturday
9,12,20,32,2018,8,18,Saturday
1,6,14,20,2017,12,13,Wednseday
3,7,21,28,2018,1,12,Friday
1,2,1,3,2018,8,20,Monday
1,7,10,17,2017,9,11,Monday
6,15,11,26,2017,4,12,Wednseday
3,9,16,25,2017,10,14,Saturday
2,3,6,9,2018,4,30,Monday
4,13,15,28,2017,12,22,Friday
1,2,23,25,2018,2,4,Sunday
0,4,15,19,2018,7,19,Thursday
1,8,22,30,2018,1,3,Wednseday
2,6,25,31,2018,5,5,Saturday
0,2,14,16,2018,4,11,Wednseday
1,2,8,10,2017,9,11,Monday
2,9,14,23,2018,8,7,Tuesday
3,12,23,35,2017,8,4,Friday
6,7,5,12,2018,4,4,Wednseday
3,9,9,18,2018,7,7,Saturday
1,8,39,47,2017,1,11,Wednseday
1,4,27,31,2017,5,1,Monday
2,9,16,25,2017,5,22,Monday
7,8,5,13,2018,3,28,Wednseday
0,8,8,16,2018,7,18,Wednseday
1,8,20,28,2018,4,19,Thursday
0,2,19,21,2018,1,30,Tuesday
2,11,6,17,2017,4,24,Monday
3,6,10,16,2018,3,18,Sunday
2,11,11,22,2017,9,25,Monday
1,7,17,24,2018,7,17,Tuesday
4,21,10,31,2018,1,5,Friday
8,19,4,23,2017,10,18,Wednseday
0,4,6,10,2018,8,11,Saturday
4,10,13,23,2018,2,19,Monday
1,12,17,29,2018,1,3,Wednseday
5,16,16,32,2017,8,10,Thursday
3,6,11,17,2018,7,14,Saturday
1,10,11,21,2018,8,6,Monday
0,4,23,27,2017,2,16,Thursday
3,6,13,19,2018,1,26,Friday
1,7,19,26,2018,8,22,Wednseday
1,5,13,18,2018,7,19,Thursday
2,7,15,22,2017,8,9,Wednseday
4,11,24,35,2017,12,1,Friday
2,3,6,9,2018,7,23,Monday
3,6,16,22,2017,12,24,Sunday
2,7,-1,6,2018,8,7,Tuesday
4,18,7,25,2017,11,3,Friday
5,11,10,21,2018,7,13,Friday
2,5,10,15,2017,7,20,Thursday
1,3,13,16,2018,4,22,Sunday
1,10,3,13,2017,8,15,Tuesday
2,12,7,19,2017,10,4,Wednseday
4,14,10,24,2017,11,24,Friday
1,7,14,21,2018,1,18,Thursday
5,9,11,20,2017,7,13,Thursday
3,13,7,20,2017,7,22,Saturday
3,26,8,34,2017,3,17,Friday
2,8,21,29,2017,2,22,Wednseday
4,9,7,16,2018,8,12,Sunday
2,15,21,36,2017,8,15,Tuesday
8,18,18,36,2017,7,3,Monday
1,7,16,23,2018,4,4,Wednseday
2,15,22,37,2017,5,7,Sunday
4,14,12,26,2018,1,26,Friday
1,9,26,35,2018,5,9,Wednseday
2,17,22,39,2018,1,8,Monday
12,26,13,39,2017,12,1,Friday
4,45,-13,32,2017,11,26,Sunday
3,25,1,26,2018,3,11,Sunday
1,2,13,15,2017,9,20,Wednseday
1,7,15,22,2018,4,17,Tuesday
1,16,7,23,2018,4,16,Monday
4,6,18,24,2018,5,19,Saturday
4,5,14,19,2018,5,10,Thursday
1,3,12,15,2018,8,7,Tuesday
2,5,20,25,2017,9,30,Saturday
5,10,21,31,2017,6,9,Friday
1,15,6,21,2018,1,16,Tuesday
1,12,13,25,2018,7,12,Thursday
1,28,-1,27,2017,12,12,Tuesday
1,5,8,13,2018,8,8,Wednseday
2,10,17,27,2017,2,14,Tuesday
2,20,2,22,2018,5,16,Wednseday
2,5,20,25,2018,3,11,Sunday
1,4,22,26,2018,7,1,Sunday
7,14,9,23,2017,10,31,Tuesday
1,6,16,22,2017,7,19,Wednseday
1,9,14,23,2017,7,2,Sunday
4,16,17,33,2017,12,14,Thursday
1,4,9,13,2017,7,13,Thursday
2,23,-1,22,2018,3,19,Monday
6,7,6,13,2018,3,21,Wednseday
1,7,19,26,2018,8,9,Thursday
1,8,27,35,2018,5,14,Monday
1,4,1,5,2018,8,16,Thursday
3,7,13,20,2018,6,8,Friday
7,8,12,20,2017,12,28,Thursday
0,20,2,22,2018,3,7,Wednseday
1,13,7,20,2018,8,7,Tuesday
1,5,24,29,2018,3,18,Sunday
1,5,14,19,2017,12,7,Thursday
1,15,23,38,2017,10,16,Monday
14,20,7,27,2017,11,24,Friday
1,9,13,22,2018,7,22,Sunday
0,7,20,27,2017,8,30,Wednseday
1,2,5,7,2018,8,21,Tuesday
5,12,12,24,2018,5,11,Friday
4,34,-2,32,2017,12,4,Monday
4,16,30,46,2017,2,19,Sunday
7,17,10,27,2017,9,29,Friday
3,10,14,24,2017,11,24,Friday
2,3,11,14,2017,11,7,Tuesday
4,16,16,32,2017,11,6,Monday
8,18,14,32,2017,4,27,Thursday
1,7,28,35,2017,4,25,Tuesday
3,7,6,13,2018,5,11,Friday
4,23,15,38,2017,4,30,Sunday
4,5,10,15,2017,6,8,Thursday
8,13,24,37,2017,2,21,Tuesday
3,15,10,25,2018,7,9,Monday
3,4,14,18,2018,5,25,Friday
8,13,17,30,2018,6,13,Wednseday
11,14,14,28,2018,7,19,Thursday
1,7,21,28,2018,7,5,Thursday
1,6,9,15,2018,7,17,Tuesday
1,9,13,22,2017,5,17,Wednseday
0,6,11,17,2018,4,17,Tuesday
3,6,15,21,2018,1,12,Friday
1,14,15,29,2018,2,14,Wednseday
1,15,19,34,2017,12,27,Wednseday
47,58,-41,17,2018,3,11,Sunday
2,8,35,43,2018,1,9,Tuesday
5,13,17,30,2018,1,24,Wednseday
3,8,18,26,2017,10,15,Sunday
4,12,13,25,2018,1,25,Thursday
2,17,14,31,2018,2,5,Monday
1,23,2,25,2018,3,19,Monday
2,7,18,25,2017,11,2,Thursday
20,22,-8,14,2018,2,22,Thursday
3,14,12,26,2017,6,24,Saturday
1,5,20,25,2017,11,9,Thursday
0,3,10,13,2018,8,21,Tuesday
2,12,21,33,2018,2,4,Sunday
1,7,30,37,2018,5,29,Tuesday
2,15,22,37,2017,5,16,Tuesday
10,18,2,20,2017,10,27,Friday
3,6,21,27,2018,8,24,Friday
1,14,0,14,2018,5,16,Wednseday
7,8,9,17,2018,6,26,Tuesday
6,15,22,37,2017,2,1,Wednseday
4,7,12,19,2018,5,11,Friday
2,3,0,3,2018,8,6,Monday
3,6,15,21,2018,7,20,Friday
4,39,-18,21,2018,3,12,Monday
2,9,22,31,2018,6,19,Tuesday
1,8,10,18,2018,4,9,Monday
1,15,28,43,2018,6,21,Thursday
4,10,10,20,2017,12,29,Friday
5,19,14,33,2018,6,10,Sunday
5,19,7,26,2018,2,22,Thursday
2,10,23,33,2017,12,9,Saturday
4,8,10,18,2017,10,9,Monday
4,10,3,13,2018,8,17,Friday
3,12,8,20,2017,10,27,Friday
1,7,4,11,2017,9,18,Monday
2,18,2,20,2017,11,25,Saturday
9,28,3,31,2017,4,4,Tuesday
1,27,0,27,2018,2,14,Wednseday
2,8,14,22,2017,11,26,Sunday
5,6,12,18,2018,1,5,Friday
11,16,9,25,2017,12,10,Sunday
3,11,15,26,2017,6,23,Friday
1,26,-2,24,2018,1,30,Tuesday
1,7,19,26,2018,4,11,Wednseday
2,7,28,35,2017,2,1,Wednseday
12,19,3,22,2017,6,28,Wednseday
11,17,6,23,2018,3,12,Monday
0,2,13,15,2018,1,15,Monday
2,3,14,17,2018,4,8,Sunday
17,34,1,35,2018,3,9,Friday
4,12,20,32,2017,7,9,Sunday
2,7,13,20,2018,8,1,Wednseday
1,10,21,31,2018,3,12,Monday
8,13,42,55,2016,10,7,Friday
3,8,15,23,2017,4,3,Monday
4,12,8,20,2017,7,6,Thursday
3,4,1,5,2018,8,10,Friday
1,11,24,35,2018,2,8,Thursday
4,6,16,22,2017,2,26,Sunday
2,6,4,10,2018,7,17,Tuesday
1,6,13,19,2018,7,18,Wednseday
3,6,8,14,2018,4,27,Friday
6,8,16,24,2017,11,28,Tuesday
4,13,12,25,2017,7,13,Thursday
0,8,27,35,2018,4,27,Friday
20,20,13,33,2017,11,24,Friday
2,13,9,22,2018,5,1,Tuesday
2,6,7,13,2017,8,19,Saturday
3,20,12,32,2017,5,12,Friday
1,8,28,36,2018,8,6,Monday
1,7,15,22,2017,9,28,Thursday
2,11,5,16,2018,7,22,Sunday
2,6,19,25,2017,9,24,Sunday
4,27,7,34,2017,12,16,Saturday
2,12,12,24,2017,11,6,Monday
9,49,-27,22,2018,3,15,Thursday
4,11,17,28,2018,6,1,Friday
0,46,-21,25,2018,3,2,Friday
2,11,7,18,2017,9,3,Sunday
1,4,13,17,2018,8,26,Sunday
2,27,4,31,2017,5,9,Tuesday
4,5,7,12,2018,5,3,Thursday
2,8,9,17,2017,9,11,Monday
1,12,9,21,2017,9,20,Wednseday
2,9,14,23,2018,5,6,Sunday
2,3,9,12,2017,7,2,Sunday
3,15,26,41,2018,5,25,Friday
2,3,14,17,2018,6,3,Sunday
1,3,11,14,2017,11,7,Tuesday
2,3,12,15,2017,8,8,Tuesday
1,2,6,8,2018,7,25,Wednseday
1,2,10,12,2018,4,4,Wednseday
2,2,12,14,2018,4,11,Wednseday
0,9,12,21,2018,4,24,Tuesday
0,5,15,20,2018,4,19,Thursday
2,6,19,25,2017,11,25,Saturday
1,5,13,18,2017,12,1,Friday
2,14,12,26,2017,6,28,Wednseday
3,16,11,27,2017,6,3,Saturday
1,2,11,13,2018,3,27,Tuesday
2,6,21,27,2017,8,15,Tuesday
3,8,16,24,2017,9,23,Saturday
6,9,12,21,2018,8,1,Wednseday
25,35,-16,19,2017,9,15,Friday
5,17,13,30,2018,2,10,Saturday
3,24,-2,22,2017,11,26,Sunday
18,28,15,43,2018,7,30,Monday
5,11,14,25,2017,2,24,Friday
1,7,11,18,2018,2,26,Monday
3,7,12,19,2017,9,1,Friday
5,28,-1,27,2018,3,22,Thursday
1,10,13,23,2017,11,28,Tuesday
1,2,11,13,2017,5,24,Wednseday
1,9,17,26,2018,1,28,Sunday
6,14,6,20,2017,11,24,Friday
2,3,13,16,2017,8,21,Monday
2,15,27,42,2018,4,24,Tuesday
1,4,9,13,2018,4,26,Thursday
4,10,27,37,2017,4,9,Sunday
3,22,3,25,2017,4,30,Sunday
3,8,14,22,2017,4,2,Sunday
3,12,7,19,2018,3,17,Saturday
1,9,15,24,2018,1,16,Tuesday
12,18,15,33,2017,8,18,Friday
0,3,12,15,2018,5,14,Monday
1,4,10,14,2018,8,9,Thursday
6,13,16,29,2017,7,18,Tuesday
4,19,13,32,2018,2,5,Monday
1,4,10,14,2018,5,7,Monday
3,16,6,22,2017,8,7,Monday
2,15,7,22,2018,2,28,Wednseday
0,41,-17,24,2018,2,16,Friday
3,6,9,15,2017,11,27,Monday
1,2,6,8,2018,7,11,Wednseday
5,26,8,34,2017,12,29,Friday
0,3,8,11,2018,7,20,Friday
1,14,21,35,2018,2,5,Monday
2,3,8,11,2018,3,26,Monday
1,7,11,18,2018,7,19,Thursday
1,23,8,31,2018,3,26,Monday
25,35,-11,24,2018,3,26,Monday
8,16,15,31,2017,11,26,Sunday
3,7,18,25,2018,3,16,Friday
2,14,13,27,2018,2,21,Wednseday
2,9,15,24,2017,3,6,Monday
4,10,25,35,2018,4,13,Friday
2,3,17,20,2017,12,16,Saturday
1,11,6,17,2017,8,28,Monday
1,5,2,7,2018,8,23,Thursday
4,39,-8,31,2017,12,2,Saturday
11,19,8,27,2017,2,4,Saturday
0,9,13,22,2017,5,16,Tuesday
1,10,21,31,2018,1,19,Friday
10,12,16,28,2018,1,19,Friday
2,8,17,25,2018,6,17,Sunday
2,22,16,38,2018,5,13,Sunday
4,5,14,19,2018,2,2,Friday
2,11,5,16,2018,8,5,Sunday
0,7,13,20,2017,7,18,Tuesday
1,6,7,13,2018,3,28,Wednseday
1,2,17,19,2017,10,5,Thursday
9,24,6,30,2017,11,14,Tuesday
4,7,9,16,2017,8,21,Monday
1,18,0,18,2017,10,30,Monday
1,6,15,21,2017,11,23,Thursday
0,26,7,33,2017,12,28,Thursday
3,13,8,21,2017,11,24,Friday
2,12,7,19,2018,6,16,Saturday
4,6,19,25,2018,1,20,Saturday
4,15,18,33,2017,8,18,Friday
5,58,-37,21,2018,3,5,Monday
2,9,9,18,2017,5,15,Monday
2,16,6,22,2018,2,27,Tuesday
4,34,-2,32,2017,11,24,Friday
18,19,9,28,2018,3,9,Friday
2,7,4,11,2018,4,16,Monday
1,7,15,22,2018,7,26,Thursday
1,24,0,24,2018,1,23,Tuesday
4,7,14,21,2017,12,29,Friday
1,5,14,19,2017,10,19,Thursday
1,8,28,36,2018,5,3,Thursday
3,12,13,25,2017,5,6,Saturday
4,11,22,33,2018,6,8,Friday
3,11,16,27,2018,4,27,Friday
2,13,12,25,2017,12,10,Sunday
3,9,7,16,2018,1,31,Wednseday
3,7,12,19,2018,8,10,Friday
2,8,21,29,2018,1,28,Sunday
7,10,12,22,2018,4,17,Tuesday
18,35,-3,32,2017,4,7,Friday
4,7,8,15,2018,8,2,Thursday
4,12,17,29,2017,9,14,Thursday
1,7,6,13,2017,8,17,Thursday
3,6,13,19,2018,7,6,Friday
4,7,12,19,2018,5,17,Thursday
1,2,8,10,2018,5,14,Monday
3,18,13,31,2017,5,6,Saturday
3,23,-6,17,2018,3,26,Monday
1,8,10,18,2017,7,17,Monday
1,6,25,31,2018,5,29,Tuesday
2,8,26,34,2018,4,11,Wednseday
2,15,8,23,2018,1,31,Wednseday
6,24,6,30,2018,1,17,Wednseday
3,6,7,13,2017,11,3,Friday
1,23,-2,21,2018,5,17,Thursday
4,44,-15,29,2018,2,19,Monday
1,12,29,41,2017,3,23,Thursday
3,12,15,27,2018,1,26,Friday
1,13,8,21,2018,3,21,Wednseday
7,40,-19,21,2018,3,1,Thursday
2,7,4,11,2017,10,9,Monday
3,8,10,18,2018,5,11,Friday
2,16,8,24,2018,3,17,Saturday
3,15,22,37,2018,2,12,Monday
7,18,24,42,2017,6,22,Thursday
1,2,7,9,2018,5,15,Tuesday
1,4,11,15,2018,4,29,Sunday
1,9,20,29,2018,4,23,Monday
2,6,6,12,2018,8,11,Saturday
1,6,11,17,2018,7,24,Tuesday
3,4,11,15,2017,11,26,Sunday
2,23,8,31,2017,7,2,Sunday
1,11,14,25,2017,7,23,Sunday
3,15,9,24,2018,3,13,Tuesday
14,16,49,65,2017,5,17,Wednseday
2,10,17,27,2018,6,30,Saturday
1,8,8,16,2018,1,29,Monday
1,1,13,14,2018,2,19,Monday
7,34,-5,29,2018,1,25,Thursday
0,3,6,9,2018,8,14,Tuesday
5,7,19,26,2017,11,30,Thursday
0,14,13,27,2017,9,29,Friday
2,4,15,19,2018,7,1,Sunday
1,28,-1,27,2018,2,22,Thursday
6,7,8,15,2017,9,6,Wednseday
8,10,5,15,2018,3,27,Tuesday
1,5,21,26,2017,1,25,Wednseday
5,22,11,33,2018,1,19,Friday
1,8,13,21,2017,10,10,Tuesday
3,24,0,24,2017,7,3,Monday
7,13,27,40,2017,12,29,Friday
4,28,8,36,2018,1,11,Thursday
10,24,-6,18,2017,9,15,Friday
1,4,21,25,2017,10,2,Monday
2,5,7,12,2018,4,11,Wednseday
2,11,9,20,2018,2,24,Saturday
2,4,19,23,2017,8,14,Monday
2,9,14,23,2017,5,15,Monday
2,8,16,24,2017,12,4,Monday
5,15,1,16,2018,5,2,Wednseday
1,8,21,29,2017,6,7,Wednseday
5,25,0,25,2017,11,24,Friday
5,43,-13,30,2018,1,17,Wednseday
13,36,20,56,2018,5,29,Tuesday
4,14,6,20,2017,3,3,Friday
23,31,13,44,2018,7,21,Saturday
6,17,-4,13,2018,5,16,Wednseday
0,10,16,26,2017,10,27,Friday
2,6,16,22,2017,9,26,Tuesday
0,11,14,25,2018,7,12,Thursday
2,7,11,18,2018,4,23,Monday
2,11,11,22,2017,9,10,Sunday
2,12,7,19,2018,3,7,Wednseday
1,44,-20,24,2017,11,27,Monday
2,5,17,22,2018,6,20,Wednseday
1,12,15,27,2017,3,30,Thursday
2,5,8,13,2017,9,13,Wednseday
3,10,17,27,2018,4,14,Saturday
2,4,22,26,2018,7,8,Sunday
1,8,21,29,2017,6,8,Thursday
2,5,11,16,2018,5,28,Monday
8,37,-14,23,2018,1,17,Wednseday
1,9,10,19,2017,8,27,Sunday
2,10,-2,8,2018,7,16,Monday
4,15,12,27,2018,6,14,Thursday
0,5,7,12,2018,8,3,Friday
1,3,0,3,2018,8,14,Tuesday
10,21,10,31,2017,12,5,Tuesday
2,8,13,21,2018,5,9,Wednseday
0,14,23,37,2018,4,11,Wednseday
2,4,11,15,2018,7,23,Monday
4,16,11,27,2017,6,3,Saturday
2,12,13,25,2017,4,22,Saturday
2,11,13,24,2017,8,5,Saturday
6,29,5,34,2017,11,16,Thursday
4,12,12,24,2018,8,4,Saturday
1,11,14,25,2017,6,1,Thursday
5,6,14,20,2017,12,29,Friday
6,21,9,30,2017,9,5,Tuesday
3,39,-16,23,2018,3,3,Saturday
2,29,-1,28,2018,5,14,Monday
1,19,14,33,2018,5,16,Wednseday
0,3,15,18,2017,10,6,Friday
3,5,15,20,2018,4,20,Friday
4,18,0,18,2018,3,2,Friday
2,12,7,19,2018,3,21,Wednseday
12,53,-28,25,2017,11,25,Saturday
1,6,27,33,2017,6,1,Thursday
1,4,10,14,2018,4,26,Thursday
3,18,3,21,2018,3,19,Monday
4,12,8,20,2017,11,24,Friday
2,16,9,25,2018,1,8,Monday
6,20,15,35,2017,5,3,Wednseday
3,12,19,31,2017,2,17,Friday
14,15,-2,13,2018,8,1,Wednseday
2,13,15,28,2018,4,11,Wednseday
4,13,19,32,2017,6,23,Friday
4,13,12,25,2018,3,2,Friday
2,6,18,24,2018,1,7,Sunday
3,9,14,23,2017,8,26,Saturday
1,9,13,22,2017,3,29,Wednseday
4,12,6,18,2018,3,10,Saturday
1,8,12,20,2018,7,12,Thursday
2,3,7,10,2017,9,18,Monday
3,10,6,16,2018,8,5,Sunday
1,16,5,21,2017,4,26,Wednseday
2,8,10,18,2017,7,10,Monday
1,8,13,21,2018,5,7,Monday
2,12,17,29,2018,3,29,Thursday
4,17,27,44,2017,10,14,Saturday
1,12,20,32,2017,7,6,Thursday
3,7,7,14,2017,5,16,Tuesday
3,28,4,32,2017,10,6,Friday
3,15,33,48,2017,5,9,Tuesday
1,4,14,18,2017,3,12,Sunday
1,2,9,11,2018,4,8,Sunday
5,46,-14,32,2018,6,15,Friday
5,17,20,37,2018,5,27,Sunday
3,7,7,14,2017,5,23,Tuesday
1,6,22,28,2018,4,19,Thursday
9,13,5,18,2017,11,30,Thursday
10,17,8,25,2018,4,20,Friday
2,9,8,17,2017,9,26,Tuesday
1,5,15,20,2018,6,29,Friday
4,28,5,33,2018,1,28,Sunday
3,7,13,20,2018,2,24,Saturday
3,27,7,34,2018,2,27,Tuesday
1,6,17,23,2018,1,3,Wednseday
3,37,-3,34,2018,3,13,Tuesday
2,16,14,30,2018,1,15,Monday
5,28,-3,25,2018,3,1,Thursday
1,6,21,27,2017,5,31,Wednseday
4,10,9,19,2018,5,4,Friday
1,5,23,28,2018,7,4,Wednseday
2,6,27,33,2017,2,11,Saturday
3,7,32,39,2018,8,3,Friday
3,11,14,25,2018,7,27,Friday
1,2,7,9,2018,6,11,Monday
5,7,11,18,2018,6,7,Thursday
0,15,6,21,2018,3,20,Tuesday
1,38,-8,30,2018,3,11,Sunday
6,19,18,37,2018,2,10,Saturday
2,14,4,18,2018,2,19,Monday
9,14,13,27,2017,8,22,Tuesday
5,7,12,19,2017,11,16,Thursday
1,9,11,20,2018,6,14,Thursday
4,9,7,16,2018,7,16,Monday
1,15,1,16,2018,5,22,Tuesday
5,13,11,24,2017,11,24,Friday
1,8,15,23,2017,8,21,Monday
1,3,20,23,2018,4,10,Tuesday
2,12,21,33,2018,3,21,Wednseday
6,12,15,27,2018,5,2,Wednseday
7,12,10,22,2017,5,17,Wednseday
3,4,11,15,2017,7,17,Monday
1,4,4,8,2018,5,10,Thursday
2,11,12,23,2017,9,17,Sunday
1,30,-5,25,2018,3,15,Thursday
2,7,5,12,2018,3,14,Wednseday
4,10,9,19,2017,3,11,Saturday
1,4,3,7,2018,8,16,Thursday
2,9,12,21,2018,1,17,Wednseday
1,9,28,37,2018,6,11,Monday
1,13,7,20,2017,11,29,Wednseday
1,8,17,25,2018,1,15,Monday
1,4,15,19,2017,12,17,Sunday
1,14,9,23,2018,2,27,Tuesday
13,15,2,17,2017,11,25,Saturday
4,26,7,33,2018,3,16,Friday
14,28,1,29,2017,6,8,Thursday
12,19,13,32,2018,3,22,Thursday
6,7,20,27,2018,5,30,Wednseday
4,8,14,22,2018,3,19,Monday
1,2,7,9,2018,6,12,Tuesday
3,7,13,20,2017,3,21,Tuesday
1,5,30,35,2017,1,26,Thursday
5,50,-28,22,2018,2,26,Monday
1,9,15,24,2018,4,15,Sunday
6,15,5,20,2018,8,3,Friday
5,12,26,38,2017,12,15,Friday
1,7,15,22,2017,7,17,Monday
1,10,17,27,2017,10,17,Tuesday
1,2,31,33,2018,4,25,Wednseday
14,26,-8,18,2018,3,1,Thursday
1,2,11,13,2018,6,20,Wednseday
2,6,9,15,2018,5,15,Tuesday
2,7,11,18,2018,8,6,Monday
2,10,-1,9,2018,6,12,Tuesday
5,11,10,21,2018,2,16,Friday
4,8,16,24,2018,8,12,Sunday
1,2,9,11,2017,5,22,Monday
5,21,5,26,2017,9,22,Friday
1,20,-1,19,2018,3,14,Wednseday
1,16,-3,13,2018,2,28,Wednseday
1,11,10,21,2017,11,13,Monday
3,9,15,24,2017,9,3,Sunday
5,6,9,15,2018,4,5,Thursday
5,13,21,34,2017,11,30,Thursday
7,13,17,30,2017,8,15,Tuesday
1,5,21,26,2017,12,14,Thursday
7,15,6,21,2018,1,11,Thursday
2,54,-38,16,2018,7,25,Wednseday
4,19,9,28,2018,2,19,Monday
4,10,15,25,2018,3,9,Friday
3,17,6,23,2017,6,13,Tuesday
6,11,28,39,2017,1,5,Thursday
2,6,7,13,2017,8,2,Wednseday
1,8,8,16,2018,3,7,Wednseday
2,3,8,11,2018,5,21,Monday
5,10,9,19,2018,8,17,Friday
2,16,9,25,2017,5,29,Monday
5,11,14,25,2018,1,12,Friday
1,5,18,23,2018,6,27,Wednseday
1,7,19,26,2017,7,5,Wednseday
2,15,13,28,2017,8,9,Wednseday
2,4,9,13,2017,7,22,Saturday
1,8,21,29,2018,1,7,Sunday
6,10,4,14,2018,2,8,Thursday
2,23,13,36,2017,10,1,Sunday
1,6,16,22,2018,6,27,Wednseday
1,4,15,19,2018,1,11,Thursday
1,12,9,21,2018,5,9,Wednseday
2,5,13,18,2018,4,1,Sunday
2,23,-1,22,2017,11,27,Monday
4,12,29,41,2017,1,26,Thursday
1,12,17,29,2018,3,25,Sunday
2,11,7,18,2018,3,1,Thursday
4,7,46,53,2016,10,7,Friday
2,9,8,17,2018,8,18,Saturday
2,8,13,21,2018,8,22,Wednseday
10,17,8,25,2017,9,8,Friday
4,9,14,23,2017,5,14,Sunday
7,10,-2,8,2018,8,14,Tuesday
1,7,17,24,2017,8,21,Monday
1,15,14,29,2018,3,20,Tuesday
3,69,-49,20,2018,2,14,Wednseday
3,13,4,17,2017,3,7,Tuesday
2,10,18,28,2017,10,3,Tuesday
14,19,14,33,2017,10,25,Wednseday
2,21,8,29,2018,5,16,Wednseday
3,15,35,50,2018,8,14,Tuesday
6,10,17,27,2018,6,19,Tuesday
5,14,14,28,2017,12,1,Friday
1,14,28,42,2018,6,5,Tuesday
7,19,3,22,2017,4,20,Thursday
0,1,2,3,2018,8,14,Tuesday
3,7,15,22,2018,2,27,Tuesday
5,10,9,19,2018,4,27,Friday
1,4,10,14,2017,11,16,Thursday
2,7,9,16,2018,7,3,Tuesday
2,7,10,17,2018,6,11,Monday
12,24,9,33,2018,3,25,Sunday
1,12,8,20,2018,7,12,Thursday
3,9,21,30,2018,7,14,Saturday
14,15,8,23,2018,4,11,Wednseday
1,6,19,25,2017,12,14,Thursday
1,22,-1,21,2018,1,15,Monday
2,10,12,22,2017,7,17,Monday
4,5,11,16,2017,9,24,Sunday
5,11,25,36,2018,6,28,Thursday
4,17,12,29,2017,12,4,Monday
5,16,9,25,2017,10,29,Sunday
1,9,15,24,2017,7,17,Monday
8,28,3,31,2017,4,24,Monday
1,15,14,29,2017,12,21,Thursday
1,16,15,31,2018,2,5,Monday
1,4,15,19,2017,9,7,Thursday
0,6,15,21,2017,5,26,Friday
22,24,-9,15,2018,1,16,Tuesday
4,16,19,35,2018,2,27,Tuesday
3,25,16,41,2018,3,3,Saturday
5,8,5,13,2017,8,3,Thursday
1,15,3,18,2017,10,30,Monday
1,11,16,27,2018,2,7,Wednseday
1,11,17,28,2017,6,8,Thursday
7,8,7,15,2018,7,5,Thursday
1,8,15,23,2018,4,25,Wednseday
3,9,12,21,2018,1,15,Monday
1,7,20,27,2017,9,28,Thursday
1,9,11,20,2018,2,23,Friday
3,6,19,25,2018,1,20,Saturday
2,12,13,25,2018,7,15,Sunday
3,8,16,24,2018,7,1,Sunday
8,17,10,27,2017,10,17,Tuesday
1,11,7,18,2018,5,7,Monday
1,4,14,18,2018,6,7,Thursday
5,15,12,27,2018,3,29,Thursday
5,11,15,26,2018,7,21,Saturday
3,30,11,41,2018,1,20,Saturday
1,2,6,8,2018,7,23,Monday
3,10,12,22,2017,8,14,Monday
3,9,26,35,2017,8,4,Friday
1,13,16,29,2018,3,8,Thursday
1,3,16,19,2017,5,21,Sunday
1,3,13,16,2017,7,25,Tuesday
7,14,13,27,2017,12,21,Thursday
1,5,35,40,2017,1,25,Wednseday
0,19,13,32,2017,5,26,Friday
5,12,20,32,2018,4,5,Thursday
3,10,11,21,2017,8,25,Friday
1,22,2,24,2017,6,12,Monday
1,17,28,45,2018,6,5,Tuesday
6,12,7,19,2017,10,25,Wednseday
3,7,16,23,2018,2,12,Monday
1,4,17,21,2017,11,20,Monday
1,8,19,27,2018,6,21,Thursday
1,2,14,16,2018,6,18,Monday
2,8,9,17,2018,4,1,Sunday
1,13,13,26,2018,3,22,Thursday
19,29,40,69,2017,2,1,Wednseday
6,17,7,24,2017,8,11,Friday
0,1,9,10,2018,4,16,Monday
1,15,14,29,2018,4,8,Sunday
10,20,10,30,2017,7,11,Tuesday
1,7,15,22,2017,8,3,Thursday
4,11,16,27,2018,1,26,Friday
5,19,13,32,2018,2,1,Thursday
5,27,15,42,2018,4,18,Wednseday
3,18,5,23,2017,7,10,Monday
2,5,16,21,2018,8,13,Monday
1,14,9,23,2018,5,9,Wednseday
3,11,6,17,2018,7,13,Friday
1,3,20,23,2017,2,7,Tuesday
2,14,14,28,2018,2,5,Monday
4,18,5,23,2018,3,3,Saturday
1,7,14,21,2017,9,18,Monday
1,7,13,20,2017,4,26,Wednseday
6,12,22,34,2017,6,14,Wednseday
4,8,20,28,2018,3,29,Thursday
2,4,14,18,2018,2,3,Saturday
0,1,12,13,2018,7,5,Thursday
2,30,16,46,2018,2,25,Sunday
1,14,4,18,2018,5,7,Monday
3,5,8,13,2018,3,30,Friday
0,10,10,20,2018,7,13,Friday
4,7,9,16,2017,6,12,Monday
6,7,6,13,2017,6,23,Friday
2,9,28,37,2017,2,6,Monday
2,9,19,28,2018,1,18,Thursday
1,8,10,18,2018,3,8,Thursday
1,4,19,23,2018,7,2,Monday
1,2,21,23,2017,12,6,Wednseday
0,8,15,23,2018,3,27,Tuesday
8,16,4,20,2018,3,6,Tuesday
0,8,17,25,2018,4,30,Monday
4,11,15,26,2017,11,16,Thursday
5,23,8,31,2017,11,12,Sunday
1,6,14,20,2018,5,10,Thursday
3,15,10,25,2018,4,30,Monday
8,34,-13,21,2018,5,9,Wednseday
2,26,10,36,2017,12,3,Sunday
4,10,7,17,2018,7,30,Monday
5,16,10,26,2018,7,7,Saturday
7,27,-6,21,2018,5,9,Wednseday
0,4,8,12,2018,3,16,Friday
1,12,14,26,2018,1,25,Thursday
3,18,23,41,2017,4,14,Friday
2,5,14,19,2018,2,25,Sunday
5,7,7,14,2017,11,9,Thursday
1,19,14,33,2018,6,24,Sunday
1,4,11,15,2018,5,15,Tuesday
1,4,11,15,2018,7,22,Sunday
2,14,23,37,2017,8,5,Saturday
1,9,17,26,2018,1,28,Sunday
5,6,4,10,2018,7,20,Friday
3,16,-4,12,2018,3,17,Saturday
2,8,10,18,2018,7,2,Monday
1,5,21,26,2017,5,21,Sunday
5,21,7,28,2017,11,29,Wednseday
2,3,10,13,2018,5,12,Saturday
2,8,14,22,2017,7,31,Monday
4,17,4,21,2017,9,11,Monday
1,14,11,25,2018,1,25,Thursday
2,9,15,24,2018,1,15,Monday
1,9,39,48,2017,1,17,Tuesday
4,6,7,13,2017,11,18,Saturday
19,29,4,33,2018,1,7,Sunday
6,17,22,39,2017,6,2,Friday
2,8,27,35,2017,12,4,Monday
2,5,15,20,2018,1,10,Wednseday
8,11,4,15,2017,11,9,Thursday
1,5,14,19,2018,3,28,Wednseday
2,31,-3,28,2017,12,13,Wednseday
1,6,29,35,2017,2,7,Tuesday
5,8,25,33,2018,4,19,Thursday
1,7,12,19,2017,11,16,Thursday
3,11,13,24,2017,7,21,Friday
4,7,5,12,2018,8,10,Friday
4,7,14,21,2018,1,19,Friday
4,10,15,25,2017,5,19,Friday
3,8,11,19,2018,2,18,Sunday
1,3,15,18,2017,12,18,Monday
2,18,3,21,2017,11,21,Tuesday
1,8,16,24,2017,10,24,Tuesday
3,11,9,20,2017,3,24,Friday
1,5,2,7,2018,8,16,Thursday
4,27,0,27,2017,12,1,Friday
6,29,3,32,2017,12,30,Saturday
2,5,28,33,2018,7,1,Sunday
1,8,13,21,2018,7,26,Thursday
1,15,5,20,2017,10,10,Tuesday
5,12,11,23,2017,10,1,Sunday
3,16,13,29,2017,12,12,Tuesday
1,6,23,29,2017,8,22,Tuesday
2,6,10,16,2018,1,30,Tuesday
2,5,13,18,2018,4,5,Thursday
2,7,2,9,2018,8,6,Monday
1,6,20,26,2017,3,22,Wednseday
1,8,14,22,2017,10,9,Monday
1,6,8,14,2018,8,22,Wednseday
1,4,6,10,2018,6,19,Tuesday
5,20,8,28,2017,12,6,Wednseday
1,18,21,39,2018,2,4,Sunday
3,17,21,38,2017,8,25,Friday
5,7,34,41,2017,2,8,Wednseday
2,33,-11,22,2018,2,21,Wednseday
5,7,7,14,2018,8,10,Friday
1,2,11,13,2018,5,16,Wednseday
1,9,21,30,2018,4,18,Wednseday
6,13,31,44,2018,6,19,Tuesday
5,11,16,27,2018,6,28,Thursday
1,14,14,28,2018,2,14,Wednseday
5,16,8,24,2017,11,4,Saturday
2,6,4,10,2018,3,13,Tuesday
1,15,13,28,2018,3,12,Monday
0,11,14,25,2017,4,7,Friday
3,9,13,22,2017,7,31,Monday
1,21,-5,16,2018,3,13,Tuesday
1,10,21,31,2018,2,5,Monday
2,6,6,12,2017,11,22,Wednseday
3,4,1,5,2018,7,28,Saturday
3,7,17,24,2017,5,19,Friday
5,14,11,25,2018,4,27,Friday
3,5,8,13,2018,6,16,Saturday
1,7,10,17,2017,9,4,Monday
4,12,10,22,2018,2,18,Sunday
7,10,13,23,2018,4,10,Tuesday
1,11,3,14,2017,6,6,Tuesday
0,3,12,15,2018,8,14,Tuesday
1,8,23,31,2017,11,27,Monday
10,26,6,32,2017,10,22,Sunday
1,10,15,25,2018,2,18,Sunday
1,9,14,23,2017,6,18,Sunday
0,2,11,13,2017,5,30,Tuesday
1,8,22,30,2017,11,19,Sunday
5,29,0,29,2018,3,7,Wednseday
3,20,-5,15,2017,11,14,Tuesday
0,3,17,20,2017,12,19,Tuesday
0,39,-14,25,2018,3,26,Monday
1,8,20,28,2018,6,25,Monday
5,13,14,27,2017,4,14,Friday
4,5,9,14,2017,6,2,Friday
3,4,14,18,2017,8,19,Saturday
0,1,12,13,2017,8,2,Wednseday
0,6,14,20,2017,7,6,Thursday
1,9,9,18,2017,11,27,Monday
3,11,19,30,2017,7,1,Saturday
6,8,20,28,2017,8,17,Thursday
1,2,5,7,2018,7,30,Monday
1,7,28,35,2018,6,14,Thursday
3,10,14,24,2018,7,13,Friday
4,5,2,7,2018,8,2,Thursday
1,13,20,33,2017,10,4,Wednseday
3,3,14,17,2018,2,4,Sunday
1,11,29,40,2017,12,7,Thursday
11,19,8,27,2017,10,13,Friday
4,7,15,22,2018,2,1,Thursday
4,9,3,12,2018,8,4,Saturday
1,12,21,33,2018,5,3,Thursday
2,4,7,11,2017,11,20,Monday
4,12,20,32,2017,10,27,Friday
3,16,17,33,2018,2,3,Saturday
8,14,4,18,2018,8,2,Thursday
4,5,14,19,2018,5,17,Thursday
0,2,14,16,2018,6,26,Tuesday
3,6,7,13,2018,3,20,Tuesday
2,12,10,22,2017,11,12,Sunday
6,7,5,12,2018,4,5,Thursday
0,11,11,22,2018,4,26,Thursday
6,7,7,14,2018,2,9,Friday
1,7,16,23,2017,5,30,Tuesday
1,23,1,24,2018,4,24,Tuesday
2,9,8,17,2017,12,12,Tuesday
3,14,15,29,2017,5,22,Monday
3,11,21,32,2018,3,26,Monday
3,13,45,58,2017,1,28,Saturday
7,33,-7,26,2017,9,15,Friday
6,9,12,21,2018,6,14,Thursday
1,7,9,16,2018,4,4,Wednseday
1,9,16,25,2017,4,24,Monday
2,5,18,23,2017,12,13,Wednseday
6,25,4,29,2017,5,4,Thursday
3,16,8,24,2017,11,25,Saturday
3,5,6,11,2018,3,4,Sunday
1,8,14,22,2018,4,24,Tuesday
6,12,14,26,2017,7,20,Thursday
2,19,1,20,2017,10,11,Wednseday
3,20,5,25,2018,4,21,Saturday
0,6,18,24,2018,7,24,Tuesday
1,7,18,25,2017,12,11,Monday
1,13,16,29,2017,11,19,Sunday
2,31,2,33,2017,3,4,Saturday
3,10,14,24,2017,12,12,Tuesday
2,9,13,22,2018,8,19,Sunday
0,6,7,13,2018,8,14,Tuesday
1,3,22,25,2018,6,3,Sunday
1,5,27,32,2017,7,27,Thursday
5,12,13,25,2017,11,24,Friday
2,3,14,17,2018,6,26,Tuesday
5,12,7,19,2017,11,12,Sunday
4,11,6,17,2018,4,7,Saturday
1,5,14,19,2018,7,29,Sunday
2,12,30,42,2018,5,30,Wednseday
6,12,27,39,2017,1,5,Thursday
1,4,13,17,2017,5,14,Sunday
0,14,9,23,2017,9,5,Tuesday
1,6,17,23,2017,6,13,Tuesday
1,7,15,22,2018,1,16,Tuesday
1,7,-2,5,2018,8,22,Wednseday
0,3,2,5,2018,8,17,Friday
0,16,5,21,2018,3,19,Monday
1,8,19,27,2017,5,31,Wednseday
3,9,35,44,2018,7,21,Saturday
8,12,14,26,2018,7,8,Sunday
1,7,4,11,2017,7,3,Monday
4,5,9,14,2018,2,16,Friday
4,11,11,22,2017,8,3,Thursday
1,8,34,42,2017,11,23,Thursday
1,5,16,21,2018,1,17,Wednseday
0,16,47,63,2017,6,26,Monday
1,4,21,25,2018,1,4,Thursday
3,8,17,25,2018,4,22,Sunday
4,7,13,20,2017,8,11,Friday
3,6,15,21,2018,8,24,Friday
1,2,6,8,2018,5,16,Wednseday
3,15,16,31,2018,2,25,Sunday
1,10,7,17,2017,9,17,Sunday
4,11,17,28,2018,6,21,Thursday
14,17,10,27,2018,7,20,Friday
11,24,10,34,2018,5,4,Friday
1,13,19,32,2017,9,28,Thursday
1,9,9,18,2018,4,2,Monday
1,20,17,37,2017,2,14,Tuesday
1,6,9,15,2018,7,18,Wednseday
1,6,21,27,2017,10,25,Wednseday
13,21,17,38,2018,7,27,Friday
1,5,15,20,2018,5,16,Wednseday
4,6,10,16,2018,3,18,Sunday
0,10,8,18,2017,12,1,Friday
3,10,10,20,2017,7,14,Friday
1,15,18,33,2018,2,7,Wednseday
3,24,11,35,2018,1,22,Monday
4,11,13,24,2018,2,10,Saturday
5,12,10,22,2017,10,12,Thursday
1,13,12,25,2018,4,5,Thursday
3,28,8,36,2018,6,11,Monday
1,12,13,25,2018,5,10,Thursday
3,6,18,24,2017,7,28,Friday
3,15,8,23,2017,7,23,Sunday
1,7,11,18,2018,8,9,Thursday
0,6,14,20,2018,4,5,Thursday
1,8,14,22,2017,9,26,Tuesday
2,9,13,22,2017,7,26,Wednseday
3,4,6,10,2018,5,22,Tuesday
3,10,28,38,2018,8,17,Friday
1,2,9,11,2018,3,18,Sunday
5,8,19,27,2018,6,28,Thursday
1,6,6,12,2018,8,19,Sunday
11,16,12,28,2018,1,23,Tuesday
2,3,6,9,2018,7,22,Sunday
1,10,14,24,2017,5,28,Sunday
2,17,15,32,2018,5,19,Saturday
4,6,9,15,2018,6,28,Thursday
6,18,14,32,2018,8,11,Saturday
1,18,7,25,2018,2,5,Monday
8,11,44,55,2016,10,7,Friday
1,24,0,24,2018,3,26,Monday
1,7,36,43,2018,6,5,Tuesday
1,5,17,22,2017,5,17,Wednseday
2,13,13,26,2018,7,21,Saturday
1,6,23,29,2018,6,13,Wednseday
4,18,5,23,2017,11,19,Sunday
2,7,20,27,2018,5,9,Wednseday
2,9,15,24,2017,5,20,Saturday
7,20,7,27,2018,7,4,Wednseday
1,2,8,10,2018,4,10,Tuesday
4,11,14,25,2017,3,2,Thursday
1,6,37,43,2018,5,31,Thursday
6,26,9,35,2018,1,4,Thursday
3,11,10,21,2018,4,9,Monday
5,11,22,33,2017,10,27,Friday
1,5,17,22,2017,7,27,Thursday
5,8,12,20,2017,11,23,Thursday
0,20,13,33,2018,2,7,Wednseday
1,2,16,18,2018,4,19,Thursday
2,43,-12,31,2018,3,12,Monday
2,6,3,9,2018,8,8,Wednseday
1,7,13,20,2017,6,28,Wednseday
2,9,14,23,2018,5,7,Monday
1,8,18,26,2018,7,18,Wednseday
2,2,14,16,2018,4,10,Tuesday
3,12,0,12,2018,3,9,Friday
2,3,12,15,2018,4,22,Sunday
3,10,22,32,2018,5,4,Friday
1,6,20,26,2017,7,21,Friday
3,15,8,23,2017,7,30,Sunday
0,8,16,24,2017,11,24,Friday
4,13,2,15,2017,9,25,Monday
2,5,3,8,2018,8,8,Wednseday
4,10,15,25,2018,2,10,Saturday
1,9,28,37,2018,6,6,Wednseday
3,10,23,33,2018,1,20,Saturday
1,8,16,24,2018,3,5,Monday
1,3,11,14,2018,7,4,Wednseday
2,3,11,14,2018,3,21,Wednseday
3,31,2,33,2018,2,2,Friday
2,6,6,12,2018,4,5,Thursday
2,5,14,19,2017,10,29,Sunday
4,5,1,6,2018,8,16,Thursday
4,9,13,22,2017,11,23,Thursday
2,12,17,29,2018,4,25,Wednseday
1,3,9,12,2017,11,22,Wednseday
2,6,15,21,2018,6,26,Tuesday
1,9,19,28,2018,2,6,Tuesday
1,8,8,16,2018,5,16,Wednseday
1,4,9,13,2018,5,3,Thursday
17,19,-2,17,2017,11,24,Friday
7,14,12,26,2017,3,9,Thursday
2,6,26,32,2018,2,3,Saturday
1,16,18,34,2018,4,17,Tuesday
5,15,17,32,2017,12,28,Thursday
5,18,13,31,2018,4,28,Saturday
1,2,8,10,2018,5,22,Tuesday
0,8,19,27,2017,5,24,Wednseday
6,12,18,30,2018,4,28,Saturday
3,5,13,18,2017,9,10,Sunday
1,14,14,28,2018,4,18,Wednseday
1,4,24,28,2018,4,5,Thursday
2,9,13,22,2017,7,24,Monday
1,9,15,24,2018,7,31,Tuesday
5,20,8,28,2018,4,12,Thursday
4,13,23,36,2018,6,21,Thursday
1,8,18,26,2017,2,1,Wednseday
2,9,13,22,2018,4,15,Sunday
2,13,35,48,2018,6,6,Wednseday
2,20,13,33,2017,8,16,Wednseday
2,3,30,33,2018,6,2,Saturday
7,17,0,17,2018,3,27,Tuesday
1,7,17,24,2018,8,13,Monday
4,7,15,22,2017,7,6,Thursday
5,6,6,12,2018,6,14,Thursday
3,6,15,21,2018,1,12,Friday
2,8,14,22,2017,10,23,Monday
8,33,-3,30,2017,11,12,Sunday
2,15,20,35,2017,12,25,Monday
3,10,20,30,2017,5,21,Sunday
4,35,-1,34,2017,7,20,Thursday
2,9,21,30,2017,7,15,Saturday
1,9,19,28,2017,10,9,Monday
2,6,20,26,2018,2,14,Wednseday
3,16,17,33,2018,3,18,Sunday
3,10,21,31,2017,2,4,Saturday
6,9,11,20,2017,5,9,Tuesday
6,15,25,40,2017,3,30,Thursday
2,4,14,18,2017,7,10,Monday
1,6,27,33,2017,8,3,Thursday
1,6,19,25,2017,10,15,Sunday
0,5,16,21,2017,5,17,Wednseday
1,7,7,14,2018,7,17,Tuesday
0,6,12,18,2018,3,9,Friday
3,11,23,34,2017,12,15,Friday
3,21,16,37,2018,4,10,Tuesday
6,42,-13,29,2018,2,27,Tuesday
2,9,14,23,2018,7,2,Monday
0,12,14,26,2017,3,22,Wednseday
6,17,11,28,2017,8,29,Tuesday
1,8,15,23,2018,7,4,Wednseday
2,12,9,21,2018,5,21,Monday
6,27,-2,25,2017,12,2,Saturday
1,7,19,26,2018,2,7,Wednseday
2,5,22,27,2018,8,18,Saturday
1,5,17,22,2017,8,2,Wednseday
1,8,18,26,2018,2,7,Wednseday
1,12,5,17,2018,3,11,Sunday
0,26,-4,22,2018,3,21,Wednseday
9,19,19,38,2017,12,30,Saturday
1,2,8,10,2017,9,12,Tuesday
3,17,-6,11,2018,8,5,Sunday
3,8,9,17,2017,9,17,Sunday
3,37,-11,26,2018,3,31,Saturday
3,49,-12,37,2017,11,27,Monday
1,4,15,19,2017,3,23,Thursday
2,9,3,12,2018,8,12,Sunday
3,15,3,18,2017,9,17,Sunday
5,11,8,19,2017,7,2,Sunday
4,7,24,31,2018,1,5,Friday
2,38,-8,30,2017,8,27,Sunday
1,20,14,34,2018,4,10,Tuesday
0,6,26,32,2018,5,3,Thursday
1,13,16,29,2017,10,18,Wednseday
5,11,3,14,2018,7,27,Friday
6,8,12,20,2018,5,29,Tuesday
5,22,0,22,2018,5,16,Wednseday
7,29,-2,27,2018,2,13,Tuesday
0,2,14,16,2018,1,8,Monday
1,8,17,25,2017,8,24,Thursday
5,8,46,54,2016,10,9,Sunday
1,3,4,7,2018,8,8,Wednseday
1,7,26,33,2018,3,21,Wednseday
0,2,13,15,2017,7,3,Monday
11,20,13,33,2017,7,28,Friday
3,25,-2,23,2018,3,3,Saturday
2,9,11,20,2017,8,30,Wednseday
4,8,19,27,2017,2,9,Thursday
2,7,14,21,2017,9,13,Wednseday
6,13,14,27,2017,9,13,Wednseday
4,6,10,16,2018,5,12,Saturday
2,17,16,33,2018,1,21,Sunday
2,9,33,42,2018,4,16,Monday
2,18,5,23,2018,3,5,Monday
3,21,9,30,2018,2,12,Monday
4,16,12,28,2017,12,18,Monday
2,15,7,22,2017,7,10,Monday
3,17,22,39,2017,11,27,Monday
2,3,9,12,2018,5,20,Sunday
2,10,14,24,2017,8,5,Saturday
4,8,11,19,2017,9,7,Thursday
5,16,10,26,2017,12,10,Sunday
2,6,38,44,2018,5,5,Saturday
3,10,21,31,2018,4,27,Friday
9,19,14,33,2018,2,17,Saturday
5,12,22,34,2018,6,16,Saturday
2,17,21,38,2018,2,4,Sunday
1,16,12,28,2018,4,18,Wednseday
7,10,2,12,2018,7,20,Friday
1,9,3,12,2018,3,25,Sunday
1,6,11,17,2017,9,17,Sunday
1,12,22,34,2018,6,21,Thursday
0,8,22,30,2018,6,5,Tuesday
2,17,12,29,2018,2,5,Monday
7,14,20,34,2018,8,2,Thursday
1,7,16,23,2018,5,1,Tuesday
11,16,9,25,2018,8,11,Saturday
4,7,12,19,2018,3,1,Thursday
2,16,9,25,2017,12,10,Sunday
1,2,22,24,2018,6,5,Tuesday
1,7,19,26,2017,10,4,Wednseday
4,41,-10,31,2017,8,21,Monday
4,17,15,32,2018,2,23,Friday
4,18,9,27,2018,3,15,Thursday
2,3,1,4,2018,7,30,Monday
5,10,13,23,2018,1,8,Monday
6,12,7,19,2017,9,27,Wednseday
4,12,19,31,2018,2,10,Saturday
2,6,33,39,2018,6,2,Saturday
11,24,1,25,2017,11,24,Friday
3,5,12,17,2017,10,17,Tuesday
5,19,9,28,2017,11,22,Wednseday
2,9,8,17,2017,3,13,Monday
1,10,19,29,2018,2,26,Monday
3,11,24,35,2018,6,8,Friday
1,11,13,24,2018,4,29,Sunday
1,10,17,27,2017,1,17,Tuesday
1,24,-1,23,2018,4,29,Sunday
2,21,2,23,2018,3,21,Wednseday
7,18,2,20,2018,2,22,Thursday
2,3,2,5,2018,8,25,Saturday
1,10,12,22,2018,7,4,Wednseday
1,5,17,22,2017,4,2,Sunday
3,12,14,26,2018,1,19,Friday
5,13,11,24,2017,7,8,Saturday
17,25,27,52,2017,6,24,Saturday
2,14,4,18,2017,11,27,Monday
4,13,8,21,2018,7,12,Thursday
2,15,25,40,2018,4,22,Sunday
2,22,8,30,2017,4,3,Monday
4,26,11,37,2017,12,16,Saturday
4,16,14,30,2018,4,9,Monday
2,13,15,28,2018,2,28,Wednseday
1,8,12,20,2017,11,29,Wednseday
2,24,-3,21,2017,11,28,Tuesday
2,6,22,28,2017,3,21,Tuesday
6,13,23,36,2018,6,21,Thursday
7,14,13,27,2018,2,10,Saturday
1,15,18,33,2017,2,15,Wednseday
3,5,12,17,2018,4,6,Friday
2,7,13,20,2018,3,21,Wednseday
1,15,16,31,2018,3,19,Monday
2,32,-5,27,2017,12,19,Tuesday
1,9,14,23,2017,11,7,Tuesday
1,13,12,25,2018,4,23,Monday
4,13,12,25,2017,3,10,Friday
3,10,21,31,2017,12,4,Monday
8,22,2,24,2017,11,13,Monday
0,8,23,31,2018,6,25,Monday
7,13,11,24,2017,11,14,Tuesday
2,17,16,33,2017,12,17,Sunday
2,5,16,21,2018,6,20,Wednseday
4,12,8,20,2017,3,31,Friday
3,11,14,25,2018,5,12,Saturday
1,7,14,21,2018,7,23,Monday
1,31,-10,21,2018,3,5,Monday
5,12,22,34,2017,5,20,Saturday
1,22,4,26,2018,3,8,Thursday
1,4,9,13,2017,5,25,Thursday
1,7,4,11,2017,5,11,Thursday
0,6,15,21,2018,8,16,Thursday
3,9,13,22,2018,5,7,Monday
3,14,-4,10,2018,5,19,Saturday
2,7,2,9,2018,8,1,Wednseday
1,2,14,16,2018,6,12,Tuesday
3,24,0,24,2017,5,28,Sunday
4,7,14,21,2018,6,28,Thursday
2,3,3,6,2018,8,18,Saturday
3,13,11,24,2018,8,3,Friday
9,10,4,14,2018,8,14,Tuesday
1,20,4,24,2018,2,20,Tuesday
9,14,10,24,2018,7,17,Tuesday
1,5,7,12,2018,3,15,Thursday
2,4,21,25,2018,2,4,Sunday
1,20,3,23,2018,6,10,Sunday
2,9,7,16,2018,2,7,Wednseday
3,9,35,44,2018,2,5,Monday
1,20,6,26,2018,5,17,Thursday
2,7,21,28,2017,10,2,Monday
3,7,14,21,2017,8,21,Monday
4,61,-36,25,2018,2,23,Friday
3,6,14,20,2018,5,18,Friday
1,16,13,29,2018,4,16,Monday
4,27,6,33,2017,11,24,Friday
1,6,15,21,2018,5,1,Tuesday
0,16,14,30,2018,2,5,Monday
16,28,-8,20,2017,8,2,Wednseday
1,7,3,10,2018,8,20,Monday
6,10,8,18,2017,9,30,Saturday
11,24,-1,23,2017,11,25,Saturday
3,10,11,21,2017,10,13,Friday
5,19,14,33,2017,12,9,Saturday
2,4,12,16,2017,11,11,Saturday
4,25,0,25,2017,10,6,Friday
6,7,-1,6,2018,7,31,Tuesday
1,11,11,22,2018,7,26,Thursday
2,3,11,14,2018,5,8,Tuesday
11,20,1,21,2017,11,24,Friday
1,25,0,25,2017,12,4,Monday
4,11,10,21,2018,4,6,Friday
2,9,11,20,2017,9,2,Saturday
1,2,25,27,2018,6,6,Wednseday
2,19,19,38,2017,11,12,Sunday
2,4,12,16,2018,4,2,Monday
2,12,11,23,2017,8,6,Sunday
2,8,24,32,2018,6,10,Sunday
2,5,15,20,2017,12,13,Wednseday
1,6,7,13,2018,8,16,Thursday
2,2,12,14,2018,1,9,Tuesday
1,7,14,21,2018,6,13,Wednseday
2,14,9,23,2018,1,31,Wednseday
1,6,8,14,2018,8,9,Thursday
1,5,22,27,2017,9,20,Wednseday
2,5,10,15,2018,8,5,Sunday
1,7,11,18,2017,5,15,Monday
5,17,29,46,2018,6,1,Friday
1,8,16,24,2017,12,12,Tuesday
2,17,-8,9,2018,6,11,Monday
1,7,21,28,2018,5,8,Tuesday
5,7,7,14,2018,2,23,Friday
0,3,11,14,2018,2,23,Friday
2,13,11,24,2018,6,9,Saturday
1,8,8,16,2018,8,7,Tuesday
3,9,7,16,2018,7,16,Monday
2,4,13,17,2018,4,23,Monday
11,15,11,26,2017,6,11,Sunday
0,9,7,16,2018,8,13,Monday
2,29,-3,26,2018,5,3,Thursday
1,9,11,20,2017,11,15,Wednseday
1,15,5,20,2018,5,17,Thursday
0,1,12,13,2017,8,23,Wednseday
2,13,18,31,2018,1,7,Sunday
2,15,22,37,2017,9,10,Sunday
5,37,-6,31,2018,2,12,Monday
2,15,19,34,2018,6,16,Saturday
3,8,18,26,2017,12,15,Friday
4,15,9,24,2017,10,16,Monday
1,8,13,21,2017,8,21,Monday
1,14,6,20,2017,11,8,Wednseday
1,4,15,19,2018,4,19,Thursday
3,43,-8,35,2018,3,30,Friday
1,8,18,26,2018,6,7,Thursday
1,11,14,25,2017,6,18,Sunday
3,5,15,20,2017,8,11,Friday
2,9,10,19,2018,3,14,Wednseday
3,5,2,7,2018,8,6,Monday
23,29,-1,28,2017,9,20,Wednseday
1,5,5,10,2018,3,19,Monday
1,2,11,13,2018,3,27,Tuesday
1,8,21,29,2017,12,11,Monday
9,14,8,22,2017,10,23,Monday
1,36,-9,27,2018,3,7,Wednseday
4,7,19,26,2017,3,9,Thursday
2,13,9,22,2018,2,21,Wednseday
2,9,9,18,2018,3,5,Monday
1,3,19,22,2018,6,11,Monday
6,10,10,20,2017,7,8,Saturday
1,2,12,14,2018,5,2,Wednseday
4,5,14,19,2018,2,1,Thursday
7,23,13,36,2018,2,7,Wednseday
16,52,-19,33,2017,11,25,Saturday
1,23,-1,22,2017,7,19,Wednseday
1,8,33,41,2018,6,6,Wednseday
5,18,15,33,2017,10,20,Friday
4,10,14,24,2018,7,6,Friday
4,15,7,22,2017,5,18,Thursday
3,4,13,17,2018,1,19,Friday
4,8,10,18,2018,8,9,Thursday
1,8,20,28,2017,12,19,Tuesday
3,24,5,29,2018,2,18,Sunday
1,2,15,17,2018,4,22,Sunday
5,10,17,27,2017,3,24,Friday
3,8,22,30,2017,12,4,Monday
2,10,13,23,2018,3,11,Sunday
2,6,14,20,2017,6,20,Tuesday
1,27,2,29,2017,2,22,Wednseday
2,7,12,19,2018,6,27,Wednseday
5,17,9,26,2017,9,22,Friday
0,6,16,22,2018,7,26,Thursday
1,47,-6,41,2018,2,8,Thursday
2,7,11,18,2018,2,26,Monday
0,12,31,43,2018,6,7,Thursday
4,7,11,18,2018,5,17,Thursday
5,10,10,20,2017,5,19,Friday
4,10,14,24,2017,3,24,Friday
1,23,8,31,2017,12,5,Tuesday
1,7,16,23,2018,4,18,Wednseday
2,17,10,27,2017,5,30,Tuesday
2,12,8,20,2017,7,20,Thursday
1,5,53,58,2018,6,3,Sunday
5,8,13,21,2017,3,8,Wednseday
3,5,6,11,2018,5,18,Friday
1,9,17,26,2017,12,20,Wednseday
12,16,2,18,2018,8,6,Monday
12,13,9,22,2017,5,25,Thursday
3,8,14,22,2017,11,20,Monday
0,5,16,21,2018,2,21,Wednseday
1,13,5,18,2018,3,1,Thursday
6,11,7,18,2018,7,26,Thursday
4,8,18,26,2017,12,14,Thursday
1,16,6,22,2017,7,18,Tuesday
6,12,21,33,2017,5,12,Friday
1,9,22,31,2018,2,5,Monday
3,7,11,18,2017,11,27,Monday
1,6,16,22,2017,10,3,Tuesday
1,3,12,15,2018,2,14,Wednseday
4,12,13,25,2018,3,23,Friday
1,8,12,20,2017,9,12,Tuesday
1,21,7,28,2017,9,18,Monday
2,13,27,40,2017,8,12,Saturday
9,29,14,43,2017,12,11,Monday
2,37,-16,21,2017,5,3,Wednseday
2,11,13,24,2017,11,18,Saturday
1,15,8,23,2018,3,26,Monday
2,17,8,25,2018,2,25,Sunday
4,10,17,27,2017,7,14,Friday
5,11,14,25,2017,9,8,Friday
3,4,8,12,2017,11,19,Sunday
0,7,22,29,2017,12,21,Thursday
2,18,21,39,2017,12,18,Monday
4,10,11,21,2017,6,9,Friday
6,12,-3,9,2018,8,15,Wednseday
0,1,12,13,2017,8,31,Thursday
15,20,-3,17,2018,1,7,Sunday
5,12,9,21,2018,1,18,Thursday
1,2,6,8,2018,8,28,Tuesday
3,14,10,24,2018,5,4,Friday
3,7,12,19,2018,5,4,Friday
2,6,14,20,2018,3,31,Saturday
4,22,13,35,2018,1,11,Thursday
2,8,14,22,2017,7,31,Monday
2,8,16,24,2017,11,6,Monday
5,9,9,18,2018,3,4,Sunday
5,12,17,29,2017,8,30,Wednseday
1,16,33,49,2018,6,4,Monday
2,6,18,24,2018,6,10,Sunday
10,27,8,35,2017,8,8,Tuesday
17,20,2,22,2018,7,10,Tuesday
1,6,9,15,2018,1,18,Thursday
1,13,10,23,2017,10,18,Wednseday
2,11,14,25,2017,4,15,Saturday
1,10,14,24,2017,5,16,Tuesday
1,3,6,9,2018,5,13,Sunday
1,14,15,29,2017,10,5,Thursday
6,57,-13,44,2018,3,3,Saturday
5,12,10,22,2017,8,30,Wednseday
1,7,14,21,2018,7,23,Monday
5,9,16,25,2017,11,17,Friday
1,7,11,18,2017,10,30,Monday
1,7,14,21,2018,8,8,Wednseday
1,7,16,23,2017,6,12,Monday
2,7,17,24,2018,5,14,Monday
6,27,-1,26,2018,2,8,Thursday
6,13,5,18,2018,8,9,Thursday
1,12,9,21,2017,11,6,Monday
0,3,27,30,2017,10,2,Monday
3,14,13,27,2017,12,16,Saturday
3,7,9,16,2018,1,22,Monday
3,5,11,16,2018,1,21,Sunday
1,6,15,21,2018,6,27,Wednseday
1,10,22,32,2018,5,27,Sunday
17,19,3,22,2018,5,7,Monday
2,30,-5,25,2017,4,15,Saturday
5,15,14,29,2017,5,10,Wednseday
3,6,24,30,2018,1,2,Tuesday
1,3,10,13,2017,11,3,Friday
1,7,14,21,2018,5,9,Wednseday
9,15,2,17,2018,4,8,Sunday
4,17,6,23,2017,6,12,Monday
10,17,11,28,2018,3,5,Monday
8,9,7,16,2018,6,4,Monday
4,9,16,25,2018,1,11,Thursday
1,7,29,36,2018,8,20,Monday
4,11,16,27,2018,1,26,Friday
3,6,14,20,2018,5,4,Friday
2,10,5,15,2018,8,7,Tuesday
9,25,11,36,2017,7,17,Monday
5,12,12,24,2018,4,27,Friday
1,8,8,16,2018,3,6,Tuesday
1,4,9,13,2017,6,22,Thursday
2,30,-4,26,2017,11,19,Sunday
3,5,6,11,2018,5,6,Sunday
4,12,19,31,2017,9,22,Friday
1,3,7,10,2018,4,29,Sunday
2,12,12,24,2018,3,10,Saturday
1,9,11,20,2017,5,10,Wednseday
6,8,10,18,2018,7,19,Thursday
3,16,15,31,2017,5,8,Monday
2,5,20,25,2018,4,5,Thursday
1,14,12,26,2018,2,15,Thursday
1,9,20,29,2017,10,8,Sunday
4,24,15,39,2018,5,25,Friday
0,13,10,23,2017,3,21,Tuesday
1,14,16,30,2018,1,16,Tuesday
3,13,18,31,2018,7,13,Friday
1,10,13,23,2017,12,6,Wednseday
3,6,19,25,2018,6,22,Friday
4,11,13,24,2018,4,28,Saturday
2,11,13,24,2017,10,2,Monday
2,9,21,30,2017,3,27,Monday
2,9,15,24,2017,4,10,Monday
4,7,18,25,2017,8,18,Friday
6,12,10,22,2017,10,19,Thursday
2,24,4,28,2017,11,28,Tuesday
3,11,22,33,2017,5,28,Sunday
5,11,21,32,2017,3,9,Thursday
2,7,15,22,2018,1,29,Monday
1,2,5,7,2018,8,27,Monday
1,16,21,37,2018,2,4,Sunday
2,6,9,15,2018,7,29,Sunday
3,11,-2,9,2018,7,24,Tuesday
1,8,28,36,2018,6,7,Thursday
19,69,-20,49,2017,12,20,Wednseday
1,14,6,20,2018,3,20,Tuesday
2,7,15,22,2018,5,8,Tuesday
1,12,2,14,2018,5,3,Thursday
2,12,14,26,2018,3,3,Saturday
3,5,7,12,2018,7,8,Sunday
2,17,15,32,2017,8,5,Saturday
1,12,22,34,2017,12,27,Wednseday
1,14,6,20,2018,3,28,Wednseday
3,13,7,20,2018,7,13,Friday
1,2,16,18,2017,12,18,Monday
2,14,14,28,2017,11,6,Monday
1,8,19,27,2017,6,6,Tuesday
4,11,21,32,2018,4,6,Friday
2,9,15,24,2018,7,21,Saturday
2,17,10,27,2017,9,20,Wednseday
3,7,13,20,2017,5,12,Friday
3,10,14,24,2017,5,28,Sunday
3,4,29,33,2017,1,27,Friday
3,11,11,22,2017,7,24,Monday
0,2,15,17,2017,3,27,Monday
3,18,15,33,2018,2,2,Friday
1,14,16,30,2018,1,23,Tuesday
7,39,-9,30,2018,1,9,Tuesday
2,10,27,37,2018,1,13,Saturday
1,12,7,19,2017,5,14,Sunday
8,15,8,23,2017,11,26,Sunday
2,14,11,25,2017,6,5,Monday
1,8,18,26,2017,5,28,Sunday
4,13,12,25,2017,9,15,Friday
0,13,14,27,2018,2,9,Friday
1,8,23,31,2018,3,20,Tuesday
1,13,16,29,2018,6,27,Wednseday
2,4,12,16,2017,11,25,Saturday
1,12,30,42,2018,6,6,Wednseday
1,9,26,35,2017,5,23,Tuesday
1,7,16,23,2018,6,11,Monday
4,32,4,36,2018,3,19,Monday
4,17,21,38,2017,1,23,Monday
0,9,13,22,2018,3,14,Wednseday
6,7,1,8,2018,8,15,Wednseday
3,5,7,12,2017,8,13,Sunday
0,5,14,19,2017,9,8,Friday
5,21,15,36,2017,12,28,Thursday
4,5,13,18,2018,4,6,Friday
5,11,24,35,2018,6,29,Friday
3,16,8,24,2017,11,18,Saturday
4,30,5,35,2017,7,3,Monday
5,18,4,22,2018,7,5,Thursday
4,16,7,23,2017,5,6,Saturday
4,9,14,23,2017,9,24,Sunday
6,12,9,21,2018,2,15,Thursday
0,7,21,28,2018,6,20,Wednseday
8,28,-5,23,2017,10,17,Tuesday
3,9,8,17,2017,3,13,Monday
5,8,10,18,2017,9,14,Thursday
12,17,13,30,2017,10,22,Sunday
3,27,32,59,2018,3,6,Tuesday
2,5,13,18,2017,8,28,Monday
1,2,6,8,2018,7,25,Wednseday
3,4,1,5,2018,8,19,Sunday
4,7,7,14,2017,6,5,Monday
1,8,13,21,2018,8,6,Monday
3,18,1,19,2018,7,20,Friday
3,7,17,24,2018,4,2,Monday
1,12,11,23,2018,5,6,Sunday
2,3,10,13,2018,7,21,Saturday
1,21,5,26,2018,1,10,Wednseday
2,9,9,18,2018,4,30,Monday
1,9,13,22,2017,7,25,Tuesday
0,7,15,22,2018,7,16,Monday
2,12,28,40,2017,8,30,Wednseday
1,7,7,14,2018,8,23,Thursday
1,12,21,33,2017,2,23,Thursday
2,13,3,16,2018,3,13,Tuesday
4,11,16,27,2018,3,23,Friday
4,14,17,31,2018,4,16,Monday
1,7,20,27,2018,4,17,Tuesday
2,13,7,20,2017,9,13,Wednseday
4,52,-29,23,2017,3,26,Sunday
3,4,8,12,2018,5,6,Sunday
2,20,3,23,2017,8,8,Tuesday
4,20,12,32,2017,10,21,Saturday
4,21,7,28,2017,11,24,Friday
7,27,13,40,2017,12,28,Thursday
4,7,14,21,2018,1,12,Friday
1,12,17,29,2017,12,14,Thursday
8,11,18,29,2017,2,23,Thursday
1,12,9,21,2018,2,14,Wednseday
2,9,21,30,2018,1,20,Saturday
2,18,8,26,2018,3,15,Thursday
4,6,6,12,2018,7,26,Thursday
4,12,7,19,2017,9,1,Friday
1,3,11,14,2017,11,29,Wednseday
4,5,8,13,2017,7,14,Friday
1,12,7,19,2017,4,26,Wednseday
2,15,2,17,2017,8,29,Tuesday
3,10,4,14,2018,8,3,Friday
5,12,7,19,2017,3,16,Thursday
3,15,15,30,2017,6,4,Sunday
3,18,2,20,2017,9,12,Tuesday
4,18,7,25,2018,3,22,Thursday
1,4,3,7,2018,8,2,Thursday
6,12,17,29,2017,2,23,Thursday
1,9,38,47,2018,6,6,Wednseday
6,28,6,34,2017,8,18,Friday
2,34,22,56,2018,4,17,Tuesday
2,15,20,35,2017,10,3,Tuesday
1,18,9,27,2017,11,30,Thursday
0,6,20,26,2018,1,25,Thursday
2,8,8,16,2018,1,30,Tuesday
1,4,2,6,2018,8,9,Thursday
4,25,1,26,2018,2,22,Thursday
2,20,4,24,2017,11,21,Tuesday
6,19,11,30,2017,10,4,Wednseday
6,10,25,35,2018,1,4,Thursday
2,10,18,28,2018,4,10,Tuesday
7,49,-27,22,2017,7,4,Tuesday
1,2,8,10,2018,4,3,Tuesday
3,11,28,39,2017,1,29,Sunday
3,5,2,7,2018,7,27,Friday
14,23,7,30,2018,7,31,Tuesday
0,5,6,11,2018,8,9,Thursday
4,15,11,26,2018,1,11,Thursday
3,7,12,19,2017,9,9,Saturday
2,5,7,12,2017,10,14,Saturday
1,10,12,22,2017,7,17,Monday
1,18,16,34,2017,11,23,Thursday
1,8,10,18,2017,11,19,Sunday
6,7,4,11,2018,8,16,Thursday
8,29,1,30,2017,9,10,Sunday
5,32,-7,25,2018,2,17,Saturday
2,10,14,24,2017,5,15,Monday
5,22,6,28,2018,1,4,Thursday
1,7,10,17,2018,7,10,Tuesday
3,10,12,22,2018,4,1,Sunday
2,17,6,23,2018,5,7,Monday
1,14,27,41,2017,12,21,Thursday
1,15,7,22,2018,3,22,Thursday
2,5,27,32,2018,5,5,Saturday
2,9,31,40,2018,6,3,Sunday
3,10,15,25,2018,1,5,Friday
1,10,10,20,2017,11,24,Friday
0,9,13,22,2017,6,19,Monday
0,5,15,20,2018,7,20,Friday
0,15,18,33,2017,12,13,Wednseday
6,15,18,33,2017,8,9,Wednseday
1,13,13,26,2018,5,16,Wednseday
5,16,21,37,2018,1,24,Wednseday
1,1,12,13,2018,4,6,Friday
0,3,25,28,2018,7,17,Tuesday
1,4,25,29,2018,6,18,Monday
3,18,7,25,2018,3,30,Friday
1,5,9,14,2017,8,9,Wednseday
3,4,24,28,2017,8,21,Monday
4,12,18,30,2018,1,1,Monday
5,10,13,23,2018,7,22,Sunday
3,10,14,24,2017,12,3,Sunday
0,7,15,22,2017,8,10,Thursday
2,5,17,22,2017,8,27,Sunday
1,28,1,29,2018,2,20,Tuesday
3,8,4,12,2017,5,7,Sunday
1,32,-15,17,2018,3,20,Tuesday
2,82,-58,24,2017,7,24,Monday
2,7,15,22,2017,5,17,Wednseday
0,1,2,3,2018,8,13,Monday
2,6,6,12,2017,6,25,Sunday
6,14,14,28,2018,1,4,Thursday
5,11,11,22,2017,9,21,Thursday
2,5,26,31,2018,6,10,Sunday
5,6,13,19,2018,1,10,Wednseday
1,7,32,39,2018,6,14,Thursday
3,20,6,26,2018,1,26,Friday
12,35,13,48,2018,1,5,Friday
1,9,16,25,2017,12,18,Monday
2,12,8,20,2018,5,12,Saturday
3,17,21,38,2017,9,24,Sunday
3,12,15,27,2018,4,13,Friday
1,9,12,21,2018,2,26,Monday
6,13,16,29,2018,1,11,Thursday
2,5,14,19,2017,11,26,Sunday
1,9,12,21,2017,4,3,Monday
0,1,11,12,2018,4,5,Thursday
1,3,7,10,2018,3,19,Monday
2,3,12,15,2018,1,16,Tuesday
1,6,7,13,2018,7,31,Tuesday
1,2,2,4,2018,8,13,Monday
3,11,15,26,2017,6,23,Friday
5,13,16,29,2017,9,28,Thursday
1,12,28,40,2017,12,7,Thursday
1,2,12,14,2017,11,28,Tuesday
5,13,10,23,2018,2,21,Wednseday
4,8,6,14,2018,8,9,Thursday
9,19,9,28,2017,5,10,Wednseday
4,12,4,16,2018,7,28,Saturday
1,7,21,28,2018,6,14,Thursday
1,5,13,18,2018,7,23,Monday
1,3,20,23,2018,6,19,Tuesday
2,19,5,24,2017,5,28,Sunday
2,10,6,16,2017,11,26,Sunday
2,36,-8,28,2018,2,26,Monday
3,9,9,18,2018,8,4,Saturday
4,19,19,38,2017,12,16,Saturday
1,8,22,30,2018,6,13,Wednseday
5,22,13,35,2017,7,13,Thursday
2,24,0,24,2018,3,25,Sunday
10,18,20,38,2018,7,14,Saturday
8,15,19,34,2018,7,31,Tuesday
7,14,20,34,2017,6,22,Thursday
0,19,26,45,2017,12,15,Friday
4,6,20,26,2018,3,17,Saturday
2,10,12,22,2017,5,16,Tuesday
1,10,32,42,2018,1,29,Monday
3,8,16,24,2018,5,6,Sunday
2,20,9,29,2017,2,15,Wednseday
3,8,29,37,2018,6,5,Tuesday
2,7,14,21,2018,8,1,Wednseday
5,18,8,26,2018,2,11,Sunday
1,6,24,30,2017,2,7,Tuesday
4,31,-10,21,2017,11,27,Monday
2,7,15,22,2018,4,23,Monday
7,19,9,28,2018,4,5,Thursday
0,10,11,21,2017,11,24,Friday
5,13,19,32,2017,7,1,Saturday
5,36,-3,33,2018,4,22,Sunday
4,10,15,25,2018,7,16,Monday
4,9,17,26,2017,9,23,Saturday
0,12,21,33,2018,6,29,Friday
2,32,-9,23,2018,3,19,Monday
1,28,0,28,2018,3,19,Monday
2,3,10,13,2018,4,21,Saturday
1,11,13,24,2018,2,5,Monday
4,9,18,27,2017,12,2,Saturday
2,9,13,22,2017,8,14,Monday
1,13,20,33,2017,8,17,Thursday
3,13,15,28,2017,6,6,Tuesday
2,9,9,18,2017,10,7,Saturday
2,4,12,16,2017,10,2,Monday
2,6,22,28,2017,2,7,Tuesday
0,7,24,31,2018,7,13,Friday
4,25,2,27,2018,1,12,Friday
2,5,9,14,2018,4,25,Wednseday
1,17,0,17,2018,8,14,Tuesday
1,6,5,11,2018,8,16,Thursday
6,7,7,14,2018,7,6,Friday
2,11,32,43,2018,6,3,Sunday
3,8,12,20,2018,3,20,Tuesday
0,7,20,27,2017,2,10,Friday
1,14,23,37,2018,6,27,Wednseday
11,14,2,16,2018,8,6,Monday
1,16,5,21,2018,3,20,Tuesday
6,9,11,20,2017,11,1,Wednseday
4,6,5,11,2018,5,12,Saturday
16,17,36,53,2016,10,8,Saturday
3,11,28,39,2018,4,14,Saturday
3,5,7,12,2017,10,29,Sunday
1,7,10,17,2017,10,24,Tuesday
3,13,26,39,2018,5,25,Friday
1,2,6,8,2018,7,18,Wednseday
1,5,18,23,2018,4,25,Wednseday
2,6,0,6,2018,8,7,Tuesday
4,6,6,12,2017,7,23,Sunday
2,4,17,21,2017,11,27,Monday
1,13,14,27,2017,10,10,Tuesday
5,12,15,27,2018,6,23,Saturday
1,5,11,16,2018,7,23,Monday
2,7,20,27,2018,6,26,Tuesday
3,24,13,37,2017,12,10,Sunday
5,7,10,17,2017,9,24,Sunday
1,8,20,28,2017,4,27,Thursday
4,10,9,19,2018,5,11,Friday
1,21,19,40,2017,3,16,Thursday
1,6,23,29,2017,10,3,Tuesday
5,25,2,27,2018,4,5,Thursday
3,6,18,24,2017,12,11,Monday
1,26,9,35,2018,1,25,Thursday
0,18,15,33,2017,8,23,Wednseday
4,6,13,19,2018,4,21,Saturday
8,13,12,25,2018,1,11,Thursday
1,12,10,22,2018,3,22,Thursday
3,10,10,20,2017,8,1,Tuesday
5,70,-43,27,2018,2,9,Friday
1,3,8,11,2018,5,7,Monday
15,16,6,22,2018,5,6,Sunday
2,4,4,8,2018,7,29,Sunday
2,6,14,20,2017,5,24,Wednseday
2,3,0,3,2018,8,13,Monday
3,27,4,31,2018,5,11,Friday
5,16,23,39,2017,12,28,Thursday
4,13,13,26,2017,4,6,Thursday
1,7,22,29,2018,7,18,Wednseday
3,9,16,25,2017,6,10,Saturday
2,2,4,6,2018,8,8,Wednseday
3,12,18,30,2017,10,8,Sunday
2,23,6,29,2017,12,11,Monday
2,8,25,33,2018,6,2,Saturday
4,7,7,14,2017,11,23,Thursday
6,18,8,26,2018,2,8,Thursday
0,20,19,39,2017,12,22,Friday
3,5,19,24,2017,10,6,Friday
4,11,3,14,2017,11,10,Friday
3,5,7,12,2017,9,9,Saturday
1,14,24,38,2018,3,12,Monday
13,24,-3,21,2018,3,30,Friday
2,8,17,25,2017,8,6,Sunday
5,12,15,27,2018,3,9,Friday
35,48,-13,35,2017,6,1,Thursday
2,8,22,30,2018,1,22,Monday
17,18,17,35,2017,5,1,Monday
4,12,14,26,2017,5,19,Friday
0,13,35,48,2017,1,24,Tuesday
1,6,15,21,2018,8,22,Wednseday
3,23,2,25,2018,3,11,Sunday
2,10,16,26,2017,8,5,Saturday
13,44,-2,42,2017,5,16,Tuesday
1,4,9,13,2017,8,15,Tuesday
1,12,15,27,2017,11,9,Thursday
1,5,11,16,2017,11,22,Wednseday
1,2,6,8,2018,7,12,Thursday
1,14,6,20,2017,11,24,Friday
2,7,16,23,2017,11,4,Saturday
0,8,27,35,2018,5,10,Thursday
2,5,20,25,2017,6,3,Saturday
3,7,16,23,2017,10,1,Sunday
2,4,11,15,2018,1,22,Monday
1,5,7,12,2018,8,8,Wednseday
2,17,15,32,2018,2,24,Saturday
5,7,13,20,2017,11,23,Thursday
7,10,13,23,2017,8,21,Monday
1,4,18,22,2017,8,24,Thursday
3,16,0,16,2018,5,21,Monday
1,22,-2,20,2018,5,16,Wednseday
3,10,11,21,2017,11,3,Friday
2,9,27,36,2018,5,2,Wednseday
6,7,6,13,2018,3,20,Tuesday
2,13,12,25,2017,4,30,Sunday
1,2,8,10,2018,4,10,Tuesday
2,11,13,24,2018,3,25,Sunday
2,12,19,31,2017,12,18,Monday
1,9,22,31,2018,6,26,Tuesday
2,19,-3,16,2018,5,14,Monday
5,12,13,25,2018,1,4,Thursday
3,8,8,16,2018,7,22,Sunday
2,24,14,38,2017,4,16,Sunday
1,7,14,21,2018,6,12,Tuesday
1,4,13,17,2017,3,20,Monday
3,23,-2,21,2018,3,5,Monday
2,13,6,19,2018,3,21,Wednseday
1,9,13,22,2018,5,16,Wednseday
1,10,11,21,2017,3,14,Tuesday
6,13,10,23,2017,9,6,Wednseday
2,3,7,10,2018,5,13,Sunday
2,14,19,33,2017,12,3,Sunday
1,11,22,33,2018,8,16,Thursday
2,8,43,51,2017,11,27,Monday
4,7,7,14,2018,5,10,Thursday
1,18,-8,10,2018,8,5,Sunday
2,9,11,20,2017,5,20,Saturday
3,4,9,13,2018,6,22,Friday
2,23,-6,17,2017,4,25,Tuesday
5,12,29,41,2018,6,16,Saturday
3,17,16,33,2017,6,2,Friday
1,15,20,35,2018,8,7,Tuesday
1,22,5,27,2018,5,17,Thursday
9,12,7,19,2017,7,22,Saturday
7,16,15,31,2018,6,18,Monday
2,16,12,28,2017,11,1,Wednseday
0,5,2,7,2018,8,9,Thursday
2,7,10,17,2018,7,17,Tuesday
3,28,2,30,2017,7,4,Tuesday
1,3,6,9,2018,8,6,Monday
3,5,11,16,2018,6,17,Sunday
0,4,30,34,2018,7,20,Friday
2,18,21,39,2017,1,30,Monday
13,30,-10,20,2018,2,22,Thursday
5,10,11,21,2017,3,3,Friday
1,17,7,24,2018,2,20,Tuesday
1,3,21,24,2017,8,20,Sunday
3,22,1,23,2017,11,27,Monday
0,13,15,28,2018,2,1,Thursday
1,6,13,19,2017,10,18,Wednseday
3,6,5,11,2018,8,24,Friday
2,13,8,21,2018,3,22,Thursday
5,13,13,26,2017,3,10,Friday
1,6,22,28,2017,10,3,Tuesday
2,11,11,22,2017,8,14,Monday
2,8,22,30,2018,7,2,Monday
2,5,14,19,2018,7,21,Saturday
1,8,10,18,2018,5,14,Monday
4,9,15,24,2017,7,22,Saturday
3,5,15,20,2017,8,4,Friday
2,18,3,21,2017,10,19,Thursday
2,5,19,24,2017,10,3,Tuesday
4,19,5,24,2018,1,27,Saturday
6,28,9,37,2017,4,18,Tuesday
1,6,28,34,2018,6,28,Thursday
41,49,-5,44,2017,12,5,Tuesday
0,2,6,8,2018,7,10,Tuesday
3,13,13,26,2018,3,16,Friday
5,14,10,24,2018,2,17,Saturday
2,9,8,17,2018,5,8,Tuesday
1,2,11,13,2018,7,3,Tuesday
1,14,8,22,2017,11,20,Monday
7,15,16,31,2017,6,12,Monday
1,12,10,22,2018,1,14,Sunday
1,13,8,21,2018,2,21,Wednseday
3,4,16,20,2018,1,20,Saturday
1,7,14,21,2017,5,16,Tuesday
3,7,28,35,2018,6,8,Friday
0,15,14,29,2017,12,20,Wednseday
2,14,15,29,2018,1,16,Tuesday
10,14,14,28,2017,7,10,Monday
4,8,10,18,2018,5,7,Monday
2,10,15,25,2017,3,4,Saturday
2,11,13,24,2018,4,24,Tuesday
11,17,2,19,2018,3,30,Friday
1,2,6,8,2018,8,19,Sunday
2,6,7,13,2018,3,20,Tuesday
5,10,13,23,2018,7,22,Sunday
1,5,34,39,2018,6,11,Monday
5,9,14,23,2018,4,28,Saturday
2,10,15,25,2018,3,11,Sunday
4,6,26,32,2017,2,17,Friday
1,12,13,25,2018,1,22,Monday
7,12,9,21,2018,8,1,Wednseday
3,44,-24,20,2018,2,24,Saturday
4,16,13,29,2018,1,21,Sunday
0,5,9,14,2017,7,21,Friday
1,7,27,34,2018,6,7,Thursday
0,19,3,22,2018,7,25,Wednseday
3,6,16,22,2017,7,11,Tuesday
3,5,19,24,2018,2,2,Friday
2,8,19,27,2017,8,16,Wednseday
6,16,13,29,2018,2,1,Thursday
7,8,17,25,2018,6,21,Thursday
2,6,7,13,2018,8,21,Tuesday
7,10,9,19,2017,3,24,Friday
2,5,9,14,2018,2,21,Wednseday
5,8,19,27,2017,12,22,Friday
3,7,13,20,2018,5,16,Wednseday
3,4,9,13,2018,5,12,Saturday
2,5,11,16,2018,8,12,Sunday
5,23,-1,22,2018,5,17,Thursday
1,7,15,22,2017,4,11,Tuesday
1,44,-13,31,2018,3,5,Monday
1,7,7,14,2018,5,10,Thursday
13,15,13,28,2018,3,7,Wednseday
7,11,11,22,2018,7,23,Monday
12,17,24,41,2018,8,3,Friday
3,5,9,14,2018,1,26,Friday
3,14,4,18,2018,3,9,Friday
1,31,4,35,2018,6,19,Tuesday
1,5,32,37,2017,2,8,Wednseday
4,11,10,21,2017,11,24,Friday
7,9,26,35,2017,12,13,Wednseday
2,10,21,31,2017,12,2,Saturday
2,3,10,13,2017,8,26,Saturday
7,10,13,23,2018,1,8,Monday
3,10,16,26,2017,4,7,Friday
1,8,16,24,2017,6,4,Sunday
7,14,12,26,2018,6,8,Friday
0,13,12,25,2017,3,17,Friday
1,12,23,35,2018,7,18,Wednseday
1,15,17,32,2018,1,14,Sunday
1,10,15,25,2017,8,27,Sunday
0,5,8,13,2018,8,24,Friday
2,9,14,23,2017,8,23,Wednseday
1,22,7,29,2018,4,22,Sunday
0,11,20,31,2018,2,9,Friday
5,12,11,23,2017,3,11,Saturday
1,7,22,29,2017,4,11,Tuesday
4,19,13,32,2017,8,4,Friday
1,6,16,22,2017,5,18,Thursday
2,29,25,54,2018,5,30,Wednseday
5,6,9,15,2018,1,25,Thursday
4,12,21,33,2017,12,15,Friday
3,4,9,13,2017,8,11,Friday
8,17,7,24,2017,4,25,Tuesday
5,7,15,22,2018,5,2,Wednseday
1,5,11,16,2017,9,27,Wednseday
1,16,3,19,2018,3,21,Wednseday
5,9,20,29,2018,4,11,Wednseday
2,16,12,28,2018,2,14,Wednseday
2,25,5,30,2018,1,15,Monday
7,15,19,34,2017,8,8,Tuesday
0,11,10,21,2017,3,2,Thursday
3,10,15,25,2017,5,6,Saturday
3,11,13,24,2018,5,5,Saturday
3,17,7,24,2018,5,5,Saturday
2,6,23,29,2018,6,12,Tuesday
9,46,-17,29,2018,2,27,Tuesday
0,3,15,18,2017,6,26,Monday
1,10,7,17,2018,1,9,Tuesday
3,14,13,27,2017,5,9,Tuesday
0,6,8,14,2018,7,25,Wednseday
1,5,24,29,2018,6,18,Monday
2,7,19,26,2017,11,30,Thursday
4,10,7,17,2018,2,4,Sunday
1,22,-2,20,2017,4,19,Wednseday
4,9,19,28,2017,12,8,Friday
4,21,-2,19,2017,11,16,Thursday
1,9,11,20,2017,5,10,Wednseday
5,17,9,26,2017,10,15,Sunday
1,5,8,13,2018,3,22,Thursday
4,12,22,34,2018,6,29,Friday
0,6,22,28,2018,4,26,Thursday
1,4,2,6,2018,8,2,Thursday
1,7,12,19,2018,5,3,Thursday
3,24,5,29,2018,4,8,Sunday
2,9,11,20,2018,3,6,Tuesday
2,6,7,13,2017,8,19,Saturday
1,24,1,25,2018,2,19,Monday
7,14,9,23,2017,6,12,Monday
2,19,3,22,2017,11,27,Monday
4,11,8,19,2018,4,7,Saturday
5,19,16,35,2017,1,27,Friday
2,28,3,31,2018,3,20,Tuesday
1,16,9,25,2018,2,5,Monday
5,10,21,31,2017,6,9,Friday
4,15,14,29,2018,1,22,Monday
3,18,6,24,2017,11,19,Sunday
1,13,15,28,2018,3,28,Wednseday
1,18,13,31,2017,10,9,Monday
1,15,7,22,2018,5,1,Tuesday
5,32,1,33,2018,4,12,Thursday
2,12,10,22,2017,8,9,Wednseday
0,18,3,21,2018,5,18,Friday
1,5,23,28,2017,1,25,Wednseday
3,9,11,20,2017,11,14,Tuesday
5,6,7,13,2018,5,16,Wednseday
1,17,11,28,2017,6,19,Monday
2,24,7,31,2018,3,11,Sunday
2,7,11,18,2017,7,24,Monday
4,34,-16,18,2017,9,16,Saturday
3,25,-5,20,2018,5,18,Friday
1,3,5,8,2018,5,17,Thursday
1,13,6,19,2018,5,17,Thursday
2,5,12,17,2017,9,23,Saturday
4,14,17,31,2017,12,2,Saturday
3,6,8,14,2018,7,20,Friday
2,4,6,10,2017,9,11,Monday
6,8,5,13,2018,3,8,Thursday
2,10,18,28,2017,7,11,Tuesday
2,22,10,32,2017,8,14,Monday
2,8,14,22,2017,7,24,Monday
1,17,7,24,2018,1,23,Tuesday
4,18,9,27,2017,3,30,Thursday
6,13,7,20,2017,9,2,Saturday
2,6,17,23,2017,8,19,Saturday
2,7,10,17,2017,3,6,Monday
3,7,16,23,2017,2,7,Tuesday
2,9,23,32,2017,9,30,Saturday
2,17,16,33,2017,4,30,Sunday
0,6,15,21,2018,5,11,Friday
7,8,8,16,2018,1,2,Tuesday
3,5,0,5,2018,8,11,Saturday
1,3,13,16,2018,4,24,Tuesday
0,5,20,25,2017,4,13,Thursday
6,14,17,31,2017,11,10,Friday
4,27,-10,17,2018,1,19,Friday
9,11,12,23,2017,8,19,Saturday
1,13,2,15,2018,5,17,Thursday
3,16,5,21,2018,5,21,Monday
7,18,15,33,2018,1,5,Friday
1,2,9,11,2018,6,17,Sunday
6,12,14,26,2018,6,23,Saturday
9,21,-10,11,2017,5,29,Monday
3,10,15,25,2018,1,6,Saturday
1,7,21,28,2018,1,8,Monday
1,11,13,24,2018,1,14,Sunday
3,12,11,23,2017,12,5,Tuesday
6,11,15,26,2018,4,28,Saturday
3,17,10,27,2018,1,5,Friday
1,2,4,6,2018,8,22,Wednseday
4,20,14,34,2018,1,6,Saturday
4,17,15,32,2017,5,5,Friday
2,11,10,21,2017,9,11,Monday
0,3,15,18,2017,5,26,Friday
1,30,-7,23,2018,3,5,Monday
2,14,14,28,2017,4,5,Wednseday
4,6,13,19,2018,5,19,Saturday
1,7,10,17,2018,5,8,Tuesday
1,7,11,18,2017,3,13,Monday
5,11,21,32,2018,7,19,Thursday
1,14,12,26,2018,5,23,Wednseday
4,14,14,28,2017,6,23,Friday
0,7,13,20,2018,3,16,Friday
0,6,13,19,2018,5,2,Wednseday
2,9,11,20,2018,7,25,Wednseday
4,11,2,13,2018,8,4,Saturday
1,2,13,15,2017,9,20,Wednseday
1,8,22,30,2017,12,13,Wednseday
4,24,2,26,2017,12,16,Saturday
1,10,22,32,2017,12,3,Sunday
4,10,14,24,2017,2,5,Sunday
1,2,22,24,2018,7,30,Monday
2,6,10,16,2018,8,1,Wednseday
6,13,5,18,2017,5,12,Friday
2,14,17,31,2017,12,12,Tuesday
1,3,32,35,2017,12,25,Monday
2,4,20,24,2017,7,1,Saturday
1,13,34,47,2017,1,26,Thursday
0,6,17,23,2017,6,13,Tuesday
13,21,12,33,2017,10,7,Saturday
2,5,12,17,2018,2,4,Sunday
2,18,15,33,2018,1,28,Sunday
1,16,12,28,2017,12,18,Monday
3,17,7,24,2017,11,13,Monday
5,7,12,19,2017,12,8,Friday
1,16,26,42,2018,5,31,Thursday
2,12,17,29,2018,2,7,Wednseday
5,12,11,23,2017,8,2,Wednseday
2,4,6,10,2018,3,5,Monday
3,9,14,23,2018,1,22,Monday
2,7,36,43,2017,1,18,Wednseday
3,6,13,19,2017,12,8,Friday
3,6,6,12,2018,3,10,Saturday
2,3,16,19,2017,12,9,Saturday
5,7,5,12,2018,3,10,Saturday
2,8,16,24,2018,3,4,Sunday
4,8,14,22,2018,2,22,Thursday
1,14,0,14,2018,8,8,Wednseday
1,12,9,21,2017,3,2,Thursday
2,5,14,19,2017,12,7,Thursday
5,6,9,15,2017,5,10,Wednseday
1,20,4,24,2018,1,16,Tuesday
12,20,12,32,2018,6,1,Friday
4,8,12,20,2018,5,3,Thursday
1,5,15,20,2018,5,2,Wednseday
2,10,18,28,2017,8,22,Tuesday
2,8,9,17,2017,3,13,Monday
3,8,7,15,2018,7,22,Sunday
2,9,16,25,2017,10,9,Monday
2,7,13,20,2018,2,28,Wednseday
18,23,25,48,2018,5,25,Friday
3,8,12,20,2017,11,14,Tuesday
3,6,15,21,2017,3,10,Friday
0,5,16,21,2017,3,23,Thursday
0,4,22,26,2017,4,7,Friday
5,19,14,33,2017,7,9,Sunday
0,29,2,31,2017,11,28,Tuesday
9,15,9,24,2017,4,11,Tuesday
10,17,10,27,2017,4,15,Saturday
1,8,19,27,2018,2,7,Wednseday
5,11,13,24,2017,6,24,Saturday
6,14,15,29,2018,1,2,Tuesday
1,10,23,33,2017,12,3,Sunday
3,10,15,25,2018,8,12,Sunday
3,12,20,32,2018,6,30,Saturday
1,7,14,21,2018,8,20,Monday
2,8,15,23,2017,9,10,Sunday
2,4,18,22,2018,8,19,Sunday
8,10,17,27,2017,10,10,Tuesday
1,9,28,37,2017,5,16,Tuesday
6,13,14,27,2017,8,17,Thursday
2,12,15,27,2017,12,6,Wednseday
11,13,21,34,2017,12,16,Saturday
3,10,15,25,2018,5,11,Friday
1,4,5,9,2018,8,20,Monday
5,13,9,22,2017,6,21,Wednseday
3,4,13,17,2017,12,11,Monday
1,5,8,13,2018,7,5,Thursday
1,14,12,26,2018,4,26,Thursday
3,4,9,13,2017,9,8,Friday
10,24,14,38,2018,7,14,Saturday
5,10,9,19,2018,3,29,Thursday
3,18,6,24,2018,2,19,Monday
6,10,29,39,2017,11,24,Friday
1,18,12,30,2017,12,17,Sunday
5,9,23,32,2018,2,10,Saturday
1,5,11,16,2018,1,8,Monday
4,11,14,25,2017,6,3,Saturday
3,25,4,29,2017,12,17,Sunday
3,6,0,6,2018,8,24,Friday
3,11,9,20,2017,9,8,Friday
4,11,18,29,2017,10,9,Monday
5,13,13,26,2018,2,11,Sunday
1,4,10,14,2017,7,6,Thursday
1,2,24,26,2018,5,31,Thursday
24,35,-8,27,2018,2,27,Tuesday
1,3,5,8,2018,8,14,Tuesday
3,11,15,26,2017,12,1,Friday
3,12,15,27,2018,2,3,Saturday
5,7,18,25,2017,5,4,Thursday
2,3,13,16,2017,12,4,Monday
0,2,12,14,2018,5,9,Wednseday
2,5,12,17,2018,8,4,Saturday
0,5,31,36,2018,5,9,Wednseday
2,11,19,30,2017,10,23,Monday
3,5,12,17,2018,8,25,Saturday
1,6,8,14,2018,8,22,Wednseday
2,11,-2,9,2018,2,12,Monday
1,15,13,28,2017,11,21,Tuesday
2,9,14,23,2017,3,18,Saturday
5,18,16,34,2017,6,15,Thursday
4,25,-1,24,2018,3,16,Friday
2,11,6,17,2017,11,20,Monday
4,9,14,23,2018,7,14,Saturday
2,3,11,14,2017,11,28,Tuesday
2,6,5,11,2018,8,5,Sunday
4,20,9,29,2017,8,17,Thursday
1,7,15,22,2018,3,26,Monday
4,5,10,15,2017,7,20,Thursday
2,23,7,30,2018,1,6,Saturday
3,9,13,22,2017,3,20,Monday
3,6,3,9,2018,7,31,Tuesday
5,8,4,12,2018,3,7,Wednseday
4,16,22,38,2018,5,5,Saturday
3,21,10,31,2017,10,16,Monday
3,14,9,23,2018,1,1,Monday
6,13,9,22,2017,5,18,Thursday
5,16,2,18,2018,3,3,Saturday
3,9,15,24,2017,5,27,Saturday
5,19,12,31,2017,10,13,Friday
1,7,14,21,2018,7,18,Wednseday
0,7,10,17,2018,2,16,Friday
1,5,8,13,2018,3,28,Wednseday
1,5,22,27,2017,6,1,Thursday
5,13,22,35,2018,6,20,Wednseday
8,49,-22,27,2018,2,28,Wednseday
1,7,16,23,2018,4,23,Monday
7,8,11,19,2017,12,7,Thursday
3,11,14,25,2018,7,13,Friday
3,5,15,20,2017,12,8,Friday
7,14,22,36,2017,12,26,Tuesday
3,15,15,30,2018,1,7,Sunday
4,12,10,22,2018,4,26,Thursday
0,7,16,23,2017,9,27,Wednseday
3,27,1,28,2018,4,13,Friday
3,4,10,14,2017,11,24,Friday
1,9,26,35,2017,10,4,Wednseday
1,10,14,24,2017,5,7,Sunday
5,20,9,29,2018,1,25,Thursday
7,36,-12,24,2018,3,12,Monday
1,4,9,13,2018,3,22,Thursday
0,7,21,28,2018,6,18,Monday
2,7,7,14,2018,8,20,Monday
2,18,-2,16,2017,12,5,Tuesday
1,6,20,26,2017,10,8,Sunday
1,6,14,20,2017,11,28,Tuesday
3,10,10,20,2017,7,8,Saturday
5,50,-14,36,2018,2,15,Thursday
1,6,19,25,2018,8,16,Thursday
4,6,22,28,2017,8,25,Friday
5,15,11,26,2017,8,9,Wednseday
1,6,17,23,2018,5,16,Wednseday
1,2,3,5,2018,8,2,Thursday
0,6,16,22,2017,10,18,Wednseday
2,24,2,26,2017,11,25,Saturday
6,13,23,36,2018,5,30,Wednseday
2,6,18,24,2017,9,23,Saturday
1,23,-5,18,2017,11,27,Monday
1,5,15,20,2018,6,13,Wednseday
5,6,8,14,2018,8,2,Thursday
1,44,-12,32,2017,3,5,Sunday
0,43,-16,27,2018,3,14,Wednseday
2,6,17,23,2017,11,4,Saturday
6,14,7,21,2017,8,23,Wednseday
5,22,44,66,2016,10,9,Sunday
1,12,8,20,2017,11,23,Thursday
4,11,21,32,2018,1,5,Friday
1,13,20,33,2017,12,6,Wednseday
2,8,14,22,2018,5,2,Wednseday
3,10,3,13,2018,3,23,Friday
1,7,16,23,2017,3,6,Monday
1,6,14,20,2017,10,19,Thursday
2,8,7,15,2018,7,18,Wednseday
1,7,22,29,2017,5,24,Wednseday
2,11,16,27,2018,6,30,Saturday
18,25,19,44,2018,6,4,Monday
4,10,8,18,2018,2,19,Monday
5,12,15,27,2017,7,19,Wednseday
1,15,18,33,2018,1,31,Wednseday
1,6,19,25,2017,6,8,Thursday
7,10,7,17,2017,10,31,Tuesday
3,6,21,27,2018,2,16,Friday
4,18,5,23,2018,4,16,Monday
5,13,7,20,2018,2,15,Thursday
2,14,15,29,2017,8,22,Tuesday
1,4,14,18,2018,6,8,Friday
2,8,14,22,2017,6,19,Monday
7,14,11,25,2017,8,14,Monday
3,10,20,30,2018,1,20,Saturday
3,6,38,44,2017,10,28,Saturday
4,11,7,18,2017,10,23,Monday
1,13,7,20,2018,3,22,Thursday
1,4,21,25,2017,12,25,Monday
1,8,13,21,2018,5,2,Wednseday
1,9,15,24,2018,4,24,Tuesday
5,18,13,31,2017,12,22,Friday
4,19,8,27,2017,8,12,Saturday
4,7,6,13,2017,6,23,Friday
2,26,1,27,2018,2,13,Tuesday
6,9,17,26,2017,8,9,Wednseday
3,13,11,24,2018,2,25,Sunday
1,5,21,26,2018,5,13,Sunday
1,9,13,22,2017,11,19,Sunday
5,9,11,20,2017,5,24,Wednseday
11,12,0,12,2018,3,8,Thursday
2,7,14,21,2018,8,7,Tuesday
3,8,12,20,2017,7,28,Friday
4,8,14,22,2018,1,15,Monday
5,10,9,19,2017,10,4,Wednseday
4,10,16,26,2018,2,10,Saturday
1,7,21,28,2017,12,27,Wednseday
1,2,9,11,2018,8,5,Sunday
1,5,3,8,2018,5,17,Thursday
7,19,13,32,2017,11,9,Thursday
5,16,14,30,2017,2,19,Sunday
0,8,12,20,2017,9,6,Wednseday
4,13,-1,12,2018,3,8,Thursday
3,10,26,36,2018,4,4,Wednseday
2,7,16,23,2018,4,17,Tuesday
5,12,30,42,2018,5,31,Thursday
7,10,10,20,2017,7,28,Friday
9,16,13,29,2018,8,1,Wednseday
9,16,5,21,2017,3,21,Tuesday
1,6,16,22,2017,9,26,Tuesday
5,6,5,11,2018,8,10,Friday
3,10,36,46,2017,1,30,Monday
3,8,14,22,2018,6,25,Monday
2,11,7,18,2018,3,18,Sunday
3,14,10,24,2018,6,19,Tuesday
5,11,19,30,2018,3,11,Sunday
1,3,11,14,2017,11,28,Tuesday
1,10,7,17,2018,3,11,Sunday
3,16,8,24,2017,8,15,Tuesday
8,14,12,26,2017,7,13,Thursday
2,4,37,41,2017,7,22,Saturday
5,13,13,26,2017,11,9,Thursday
5,12,15,27,2017,9,22,Friday
0,12,9,21,2017,11,16,Thursday
3,9,28,37,2017,5,6,Saturday
2,3,13,16,2018,1,14,Sunday
2,12,22,34,2018,4,11,Wednseday
3,12,14,26,2018,3,24,Saturday
3,11,17,28,2017,12,1,Friday
1,5,15,20,2017,12,13,Wednseday
5,11,40,51,2016,10,10,Monday
8,10,18,28,2018,1,25,Thursday
1,13,16,29,2018,2,1,Thursday
4,12,8,20,2018,8,9,Thursday
2,17,6,23,2018,4,24,Tuesday
3,8,31,39,2017,12,3,Sunday
3,7,14,21,2017,8,25,Friday
4,14,16,30,2018,7,2,Monday
6,33,-11,22,2018,5,16,Wednseday
1,2,10,12,2018,6,17,Sunday
2,24,11,35,2018,3,13,Tuesday
1,14,6,20,2018,3,1,Thursday
2,9,29,38,2017,3,21,Tuesday
2,7,6,13,2018,8,15,Wednseday
3,15,18,33,2017,5,14,Sunday
5,21,13,34,2018,1,13,Saturday
1,2,16,18,2018,2,1,Thursday
0,12,22,34,2017,3,31,Friday
2,19,7,26,2018,2,22,Thursday
2,13,11,24,2017,5,13,Saturday
1,13,8,21,2017,9,18,Monday
4,6,6,12,2017,9,8,Friday
1,16,18,34,2018,2,1,Thursday
8,39,-3,36,2018,2,8,Thursday
6,15,14,29,2018,1,24,Wednseday
2,17,16,33,2018,5,26,Saturday
3,14,21,35,2018,1,26,Friday
1,13,16,29,2018,2,1,Thursday
1,15,15,30,2017,12,13,Wednseday
1,13,11,24,2018,1,8,Monday
5,13,16,29,2018,2,1,Thursday
5,12,15,27,2018,4,18,Wednseday
1,2,10,12,2017,5,21,Sunday
6,12,19,31,2017,4,21,Friday
2,18,6,24,2017,11,6,Monday
1,14,15,29,2018,1,2,Tuesday
9,19,5,24,2017,9,17,Sunday
3,18,9,27,2018,2,2,Friday
1,5,7,12,2018,3,8,Thursday
0,18,21,39,2018,6,21,Thursday
2,9,18,27,2018,4,7,Saturday
6,8,6,14,2017,11,8,Wednseday
3,11,21,32,2017,11,24,Friday
2,21,1,22,2018,1,29,Monday
3,14,18,32,2018,7,20,Friday
0,1,7,8,2018,8,22,Wednseday
7,23,27,50,2018,1,17,Wednseday
5,34,-8,26,2017,4,12,Wednseday
0,17,18,35,2017,12,22,Friday
3,23,2,25,2017,9,15,Friday
7,19,-2,17,2017,10,30,Monday
3,14,19,33,2017,2,17,Friday
3,21,3,24,2018,2,26,Monday
2,3,9,12,2018,7,21,Saturday
1,18,28,46,2018,8,9,Thursday
13,22,7,29,2017,8,10,Thursday
1,12,14,26,2018,2,28,Wednseday
10,25,0,25,2018,5,4,Friday
15,21,40,61,2016,10,6,Thursday
19,27,-1,26,2017,3,24,Friday
12,25,1,26,2017,7,13,Thursday
10,14,14,28,2017,12,8,Friday
1,8,15,23,2017,11,27,Monday
12,19,17,36,2017,6,7,Wednseday
1,4,9,13,2017,8,3,Thursday
13,36,-7,29,2017,12,7,Thursday
0,11,9,20,2018,6,22,Friday
3,14,15,29,2017,12,4,Monday
7,20,12,32,2017,4,13,Thursday
0,12,15,27,2017,12,22,Friday
2,7,13,20,2017,7,5,Wednseday
1,7,25,32,2018,6,14,Thursday
6,43,-10,33,2018,5,2,Wednseday
3,9,9,18,2017,8,7,Monday
4,20,-1,19,2018,3,30,Friday
2,5,12,17,2018,8,20,Monday
2,2,9,11,2018,3,4,Sunday
3,4,14,18,2018,4,7,Saturday
1,7,6,13,2018,7,31,Tuesday
2,6,19,25,2018,8,11,Saturday
1,7,6,13,2018,3,8,Thursday
1,10,18,28,2017,11,28,Tuesday
2,9,17,26,2017,3,22,Wednseday
8,28,-1,27,2018,2,8,Thursday
7,18,16,34,2018,1,6,Saturday
3,11,9,20,2018,2,23,Friday
9,16,25,41,2018,6,5,Tuesday
2,9,3,12,2018,3,14,Wednseday
2,5,10,15,2018,5,3,Thursday
0,7,16,23,2018,5,14,Monday
3,11,14,25,2017,11,24,Friday
0,3,14,17,2017,8,25,Friday
5,10,4,14,2017,10,27,Friday
14,63,-26,37,2018,3,20,Tuesday
2,7,5,12,2018,8,8,Wednseday
0,8,6,14,2018,8,8,Wednseday
4,13,8,21,2018,3,1,Thursday
2,7,14,21,2018,3,5,Monday
6,8,5,13,2017,11,16,Thursday
1,15,20,35,2017,8,16,Wednseday
2,14,9,23,2017,7,26,Wednseday
2,21,3,24,2018,3,19,Monday
0,18,17,35,2018,1,29,Monday
4,9,5,14,2018,8,6,Monday
12,55,-29,26,2017,11,30,Thursday
3,7,4,11,2018,5,18,Friday
0,5,17,22,2017,7,19,Wednseday
1,13,16,29,2017,12,6,Wednseday
9,22,15,37,2018,6,19,Tuesday
5,7,15,22,2018,6,28,Thursday
2,7,10,17,2017,10,24,Tuesday
2,4,7,11,2017,11,20,Monday
1,2,4,6,2018,8,28,Tuesday
4,22,4,26,2017,3,12,Sunday
4,12,14,26,2017,11,30,Thursday
1,5,21,26,2017,11,19,Sunday
1,3,20,23,2018,1,29,Monday
1,4,9,13,2018,3,22,Thursday
2,6,19,25,2018,8,18,Saturday
4,11,17,28,2018,1,5,Friday
1,4,17,21,2018,6,12,Tuesday
6,22,13,35,2017,12,15,Friday
6,9,13,22,2017,4,11,Tuesday
4,17,27,44,2017,8,19,Saturday
1,4,9,13,2018,7,31,Tuesday
7,21,2,23,2017,9,5,Tuesday
1,6,14,20,2017,11,22,Wednseday
8,14,12,26,2017,7,5,Wednseday
1,14,15,29,2018,1,22,Monday
4,14,12,26,2017,9,14,Thursday
3,4,12,16,2017,9,17,Sunday
1,14,-6,8,2017,5,11,Thursday
1,11,20,31,2018,2,4,Sunday
2,8,29,37,2018,6,25,Monday
2,15,11,26,2017,2,5,Sunday
2,22,8,30,2018,2,6,Tuesday
6,9,13,22,2017,7,12,Wednseday
4,9,8,17,2017,12,12,Tuesday
7,11,8,19,2017,3,17,Friday
3,5,9,14,2018,4,27,Friday
3,6,18,24,2017,9,9,Saturday
2,21,2,23,2017,11,27,Monday
0,17,19,36,2017,5,17,Wednseday
2,19,9,28,2018,1,10,Wednseday
2,6,21,27,2018,6,19,Tuesday
6,9,13,22,2017,9,27,Wednseday
1,2,8,10,2018,3,5,Monday
6,14,22,36,2017,12,5,Tuesday
1,30,0,30,2017,12,19,Tuesday
3,41,-6,35,2017,11,24,Friday
1,21,5,26,2018,2,8,Thursday
3,6,17,23,2017,5,30,Tuesday
6,13,41,54,2017,1,18,Wednseday
3,4,5,9,2018,8,4,Saturday
5,19,15,34,2017,8,30,Wednseday
5,25,13,38,2018,1,12,Friday
1,4,14,18,2018,4,26,Thursday
3,11,36,47,2018,8,17,Friday
6,18,-1,17,2018,3,19,Monday
5,57,-29,28,2017,11,30,Thursday
1,8,28,36,2018,4,9,Monday
1,5,21,26,2017,2,19,Sunday
1,34,2,36,2018,5,2,Wednseday
2,21,21,42,2017,9,25,Monday
1,15,21,36,2017,5,28,Sunday
1,9,13,22,2018,2,25,Sunday
0,11,14,25,2017,5,26,Friday
2,8,3,11,2018,8,20,Monday
6,20,-8,12,2017,11,22,Wednseday
1,9,15,24,2018,2,5,Monday
1,15,5,20,2018,5,17,Thursday
3,8,14,22,2018,7,30,Monday
2,13,13,26,2017,11,4,Saturday
1,10,11,21,2017,12,19,Tuesday
2,12,7,19,2017,10,25,Wednseday
3,5,25,30,2018,6,30,Saturday
3,12,33,45,2018,1,5,Friday
0,10,12,22,2018,4,2,Monday
5,14,5,19,2017,3,24,Friday
5,15,25,40,2017,11,3,Friday
2,30,-7,23,2018,1,24,Wednseday
1,12,13,25,2017,11,6,Monday
2,7,8,15,2018,8,14,Tuesday
2,18,-1,17,2018,4,3,Tuesday
5,11,14,25,2018,6,28,Thursday
2,8,36,44,2017,11,6,Monday
1,16,12,28,2018,1,9,Tuesday
2,8,26,34,2018,4,18,Wednseday
0,10,14,24,2017,7,4,Tuesday
5,9,18,27,2017,10,11,Wednseday
0,4,24,28,2018,5,14,Monday
3,11,13,24,2017,9,30,Saturday
4,11,16,27,2017,4,29,Saturday
3,18,8,26,2017,12,17,Sunday
2,3,9,12,2018,3,25,Sunday
4,18,23,41,2018,5,3,Thursday
1,12,14,26,2018,4,11,Wednseday
1,15,28,43,2017,11,23,Thursday
6,12,31,43,2018,8,8,Wednseday
0,11,15,26,2017,7,20,Thursday
1,3,27,30,2018,8,7,Tuesday
7,12,14,26,2017,10,11,Wednseday
2,15,34,49,2017,2,1,Wednseday
1,7,13,20,2017,7,27,Thursday
2,11,12,23,2017,8,13,Sunday
6,14,6,20,2018,3,21,Wednseday
4,44,-12,32,2017,12,4,Monday
2,16,26,42,2017,4,18,Tuesday
3,9,17,26,2018,4,21,Saturday
13,14,7,21,2018,4,19,Thursday
4,6,11,17,2017,9,23,Saturday
4,8,20,28,2018,1,22,Monday
3,15,10,25,2017,7,30,Sunday
1,11,13,24,2017,9,11,Monday
4,7,10,17,2018,7,16,Monday
3,4,11,15,2018,1,22,Monday
3,4,12,16,2018,8,4,Saturday
3,7,3,10,2018,4,17,Tuesday
4,11,15,26,2018,4,7,Saturday
7,11,7,18,2018,1,4,Thursday
1,13,13,26,2018,1,28,Sunday
3,18,7,25,2017,4,21,Friday
3,9,19,28,2018,1,8,Monday
3,4,8,12,2017,9,15,Friday
5,9,18,27,2017,5,31,Wednseday
2,16,4,20,2018,2,20,Tuesday
2,7,17,24,2017,7,18,Tuesday
2,6,19,25,2017,3,18,Saturday
2,16,18,34,2017,2,28,Tuesday
6,7,19,26,2018,5,30,Wednseday
4,19,6,25,2017,11,9,Thursday
2,11,13,24,2017,10,14,Saturday
2,4,11,15,2018,8,12,Sunday
5,41,-7,34,2018,3,7,Wednseday
4,15,8,23,2017,10,30,Monday
13,19,15,34,2017,5,25,Thursday
9,16,14,30,2017,7,11,Tuesday
2,4,8,12,2017,7,30,Sunday
3,5,23,28,2017,5,26,Friday
0,3,15,18,2017,12,18,Monday
2,10,9,19,2017,11,19,Sunday
2,16,16,32,2017,12,25,Monday
3,9,19,28,2018,1,8,Monday
4,33,0,33,2018,1,6,Saturday
1,2,11,13,2017,6,28,Wednseday
7,17,19,36,2018,6,5,Tuesday
1,6,6,12,2018,8,22,Wednseday
1,2,4,6,2018,8,14,Tuesday
3,6,18,24,2017,7,21,Friday
2,7,15,22,2017,8,29,Tuesday
9,12,13,25,2017,2,13,Monday
1,2,9,11,2018,7,22,Sunday
6,9,7,16,2018,1,2,Tuesday
2,5,8,13,2017,8,9,Wednseday
3,27,-4,23,2018,5,12,Saturday
3,6,18,24,2018,5,11,Friday
1,5,15,20,2018,7,25,Wednseday
1,4,22,26,2017,8,24,Thursday
0,3,20,23,2018,7,31,Tuesday
0,7,23,30,2017,4,4,Tuesday
5,7,19,26,2017,12,29,Friday
6,7,7,14,2018,7,4,Wednseday
0,8,12,20,2018,5,9,Wednseday
2,11,12,23,2017,8,6,Sunday
1,5,25,30,2018,4,23,Monday
2,23,7,30,2018,2,7,Wednseday
1,10,12,22,2017,8,1,Tuesday
7,15,6,21,2018,1,31,Wednseday
1,9,20,29,2018,1,9,Tuesday
4,10,17,27,2018,6,22,Friday
1,25,-2,23,2017,11,27,Monday
4,37,-6,31,2017,11,20,Monday
3,13,13,26,2017,12,10,Sunday
2,12,21,33,2018,3,3,Saturday
2,15,8,23,2018,2,18,Sunday
3,8,22,30,2018,4,3,Tuesday
1,10,13,23,2017,12,4,Monday
2,9,15,24,2017,11,26,Sunday
13,22,11,33,2018,4,12,Thursday
1,8,27,35,2017,7,25,Tuesday
0,8,20,28,2018,6,14,Thursday
3,9,10,19,2017,10,22,Sunday
0,11,5,16,2017,11,22,Wednseday
2,7,14,21,2018,4,17,Tuesday
3,4,15,19,2018,8,24,Friday
5,10,18,28,2017,12,29,Friday
2,6,2,8,2018,8,22,Wednseday
4,18,3,21,2018,2,22,Thursday
1,7,18,25,2017,2,6,Monday
1,7,23,30,2017,6,5,Monday
2,5,8,13,2017,8,9,Wednseday
2,3,10,13,2017,8,5,Saturday
1,2,11,13,2018,5,3,Thursday
3,7,13,20,2017,6,23,Friday
6,12,10,22,2018,8,9,Thursday
2,8,16,24,2018,6,5,Tuesday
15,24,6,30,2017,9,25,Monday
1,15,8,23,2017,4,24,Monday
1,2,11,13,2017,5,17,Wednseday
2,6,13,19,2018,8,18,Saturday
2,44,-10,34,2018,4,18,Wednseday
0,6,33,39,2018,4,27,Friday
1,7,16,23,2017,5,30,Tuesday
5,11,10,21,2017,6,15,Thursday
1,3,15,18,2017,9,10,Sunday
2,9,7,16,2017,5,9,Tuesday
1,6,15,21,2018,5,16,Wednseday
1,12,22,34,2017,12,21,Thursday
2,15,17,32,2017,10,29,Sunday
8,25,13,38,2018,5,28,Monday
4,5,11,16,2018,8,5,Sunday
1,6,25,31,2018,8,21,Tuesday
3,14,22,36,2017,6,26,Monday
1,9,18,27,2018,3,27,Tuesday
3,8,36,44,2018,7,29,Sunday
4,28,2,30,2017,12,25,Monday
1,7,13,20,2018,5,10,Thursday
1,25,2,27,2017,11,16,Thursday
1,5,16,21,2017,6,7,Wednseday
1,5,14,19,2017,8,31,Thursday
1,9,5,14,2017,11,13,Monday
5,14,13,27,2017,9,1,Friday
3,12,8,20,2017,11,29,Wednseday
8,21,-11,10,2018,7,16,Monday
3,20,7,27,2018,2,13,Tuesday
3,27,11,38,2018,2,3,Saturday
3,10,15,25,2017,4,9,Sunday
2,23,12,35,2018,2,5,Monday
2,4,19,23,2017,10,2,Monday
1,7,10,17,2018,7,31,Tuesday
3,45,-22,23,2018,3,11,Sunday
1,12,26,38,2018,4,8,Sunday
3,11,24,35,2017,11,14,Tuesday
1,7,14,21,2017,8,21,Monday
2,7,7,14,2018,7,31,Tuesday
5,15,7,22,2018,2,1,Thursday
1,7,13,20,2017,5,17,Wednseday
3,3,13,16,2018,4,3,Tuesday
7,18,2,20,2017,9,15,Friday
1,19,3,22,2017,11,30,Thursday
1,6,23,29,2018,3,7,Wednseday
2,3,9,12,2018,3,25,Sunday
1,2,12,14,2018,2,19,Monday
2,5,22,27,2018,1,6,Saturday
0,12,20,32,2018,3,5,Monday
8,15,2,17,2018,3,19,Monday
17,24,15,39,2018,5,12,Saturday
3,6,17,23,2017,4,22,Saturday
0,4,14,18,2018,8,3,Friday
2,3,9,12,2018,6,16,Saturday
2,17,6,23,2017,2,6,Monday
6,7,11,18,2017,9,29,Friday
1,23,7,30,2017,12,11,Monday
2,6,17,23,2018,4,11,Wednseday
1,13,14,27,2018,3,15,Thursday
4,28,-2,26,2017,11,24,Friday
1,4,13,17,2018,7,30,Monday
7,14,20,34,2017,6,27,Tuesday
7,11,3,14,2017,11,14,Tuesday
9,9,41,50,2017,6,25,Sunday
4,9,15,24,2017,7,1,Saturday
1,9,17,26,2018,1,14,Sunday
1,2,2,4,2018,8,5,Sunday
2,33,-10,23,2018,3,10,Saturday
2,3,7,10,2018,4,9,Monday
1,2,14,16,2018,6,12,Tuesday
1,8,18,26,2018,3,11,Sunday
10,12,43,55,2016,10,5,Wednseday
1,2,10,12,2017,10,29,Sunday
1,4,21,25,2018,1,7,Sunday
3,18,17,35,2018,3,16,Friday
2,6,4,10,2018,8,12,Sunday
0,1,12,13,2018,5,3,Thursday
2,7,21,28,2018,8,15,Wednseday
0,22,5,27,2017,12,22,Friday
29,33,1,34,2018,4,5,Thursday
6,14,8,22,2018,2,28,Wednseday
3,9,32,41,2018,6,5,Tuesday
1,19,11,30,2018,4,16,Monday
7,19,13,32,2017,5,18,Thursday
1,12,11,23,2017,11,15,Wednseday
4,14,27,41,2018,6,1,Friday
3,6,12,18,2018,7,27,Friday
1,11,12,23,2018,4,1,Sunday
9,66,-43,23,2018,1,22,Monday
2,3,3,6,2018,8,11,Saturday
6,13,28,41,2018,8,15,Wednseday
6,10,13,23,2018,6,12,Tuesday
3,12,13,25,2017,12,2,Saturday
2,8,6,14,2018,5,14,Monday
1,3,24,27,2017,12,6,Wednseday
1,9,14,23,2018,2,14,Wednseday
3,6,15,21,2017,8,18,Friday
1,8,15,23,2018,6,11,Monday
3,7,14,21,2018,5,4,Friday
3,13,14,27,2017,11,24,Friday
2,23,-2,21,2018,3,19,Monday
1,21,20,41,2017,2,1,Wednseday
0,6,14,20,2017,6,28,Wednseday
4,23,5,28,2017,12,14,Thursday
0,3,20,23,2017,8,1,Tuesday
1,3,9,12,2018,6,17,Sunday
0,6,14,20,2017,7,20,Thursday
1,4,25,29,2018,5,10,Thursday
2,37,-6,31,2017,10,29,Sunday
1,11,18,29,2018,1,11,Thursday
9,14,19,33,2018,3,7,Wednseday
0,1,10,11,2018,6,18,Monday
1,8,14,22,2017,9,19,Tuesday
2,10,11,21,2017,9,11,Monday
5,13,30,43,2018,6,7,Thursday
7,24,-2,22,2017,11,9,Thursday
3,10,18,28,2018,1,19,Friday
2,7,20,27,2018,7,3,Tuesday
2,10,20,30,2018,6,16,Saturday
11,13,8,21,2017,5,4,Thursday
1,14,23,37,2017,8,16,Wednseday
3,22,4,26,2017,11,24,Friday
4,9,20,29,2018,4,29,Sunday
0,5,26,31,2017,9,22,Friday
1,9,18,27,2017,10,12,Thursday
1,14,10,24,2017,6,27,Tuesday
4,7,20,27,2018,2,3,Saturday
2,9,10,19,2018,8,15,Wednseday
2,9,17,26,2018,2,25,Sunday
3,13,11,24,2017,7,15,Saturday
1,7,19,26,2018,1,24,Wednseday
3,20,4,24,2018,3,31,Saturday
6,22,10,32,2018,2,8,Thursday
6,9,21,30,2017,11,1,Wednseday
4,13,7,20,2017,10,12,Thursday
6,22,14,36,2018,3,13,Tuesday
3,17,14,31,2018,6,4,Monday
2,4,23,27,2018,4,28,Saturday
0,20,24,44,2017,12,19,Tuesday
1,11,13,24,2017,11,20,Monday
0,6,21,27,2018,5,16,Wednseday
1,6,16,22,2017,9,21,Thursday
2,14,24,38,2017,6,12,Monday
3,14,7,21,2017,11,13,Monday
15,71,-50,21,2018,5,2,Wednseday
5,15,5,20,2017,11,9,Thursday
2,22,6,28,2018,4,30,Monday
2,6,20,26,2017,7,1,Saturday
16,30,-18,12,2017,6,18,Sunday
1,23,1,24,2018,1,16,Tuesday
10,10,4,14,2017,6,2,Friday
2,13,12,25,2017,11,4,Saturday
1,4,19,23,2018,6,18,Monday
3,13,21,34,2018,2,28,Wednseday
5,6,10,16,2017,7,15,Saturday
1,9,23,32,2017,2,13,Monday
1,6,21,27,2017,5,23,Tuesday
1,17,14,31,2017,8,6,Sunday
8,21,5,26,2018,2,8,Thursday
2,12,18,30,2017,12,24,Sunday
2,11,20,31,2017,5,14,Sunday
1,13,6,19,2018,3,21,Wednseday
1,19,14,33,2017,8,23,Wednseday
1,7,34,41,2017,2,8,Wednseday
1,5,10,15,2018,7,15,Sunday
4,7,13,20,2018,6,29,Friday
7,22,4,26,2018,5,16,Wednseday
6,14,27,41,2018,6,6,Wednseday
2,15,7,22,2017,9,26,Tuesday
1,7,15,22,2017,6,5,Monday
1,7,16,23,2018,5,15,Tuesday
8,27,2,29,2017,12,13,Wednseday
1,9,5,14,2017,11,23,Thursday
7,8,18,26,2018,5,31,Thursday
5,18,18,36,2017,11,30,Thursday
2,24,-1,23,2018,2,24,Saturday
4,17,3,20,2018,3,16,Friday
3,17,23,40,2018,6,2,Saturday
7,25,22,47,2017,6,9,Friday
2,8,7,15,2018,8,5,Sunday
2,17,6,23,2018,6,11,Monday
2,3,8,11,2018,3,26,Monday
1,6,7,13,2018,8,15,Wednseday
1,4,10,14,2018,2,20,Tuesday
5,13,14,27,2018,1,18,Thursday
2,8,14,22,2017,8,1,Tuesday
1,11,11,22,2018,5,7,Monday
2,34,-11,23,2018,3,6,Tuesday
2,8,22,30,2018,1,21,Sunday
1,33,3,36,2017,4,6,Thursday
3,24,7,31,2018,5,4,Friday
3,9,14,23,2017,6,13,Tuesday
1,3,12,15,2017,6,26,Monday
1,11,14,25,2018,4,8,Sunday
4,21,24,45,2017,2,10,Friday
1,5,15,20,2017,11,30,Thursday
0,5,20,25,2017,12,18,Monday
6,35,-9,26,2017,4,28,Friday
1,3,13,16,2018,7,24,Tuesday
4,11,-4,7,2018,8,9,Thursday
1,6,14,20,2018,6,14,Thursday
7,12,14,26,2017,6,2,Friday
8,14,3,17,2018,7,30,Monday
2,3,9,12,2017,8,13,Sunday
3,9,24,33,2017,6,10,Saturday
0,11,11,22,2017,6,19,Monday
18,24,14,38,2017,4,21,Friday
4,13,26,39,2018,4,19,Thursday
6,9,9,18,2017,10,7,Saturday
1,8,46,54,2018,6,3,Sunday
1,6,18,24,2018,7,3,Tuesday
1,2,15,17,2018,4,23,Monday
3,4,10,14,2017,11,24,Friday
3,10,31,41,2017,1,14,Saturday
1,6,36,42,2017,7,20,Thursday
0,7,21,28,2018,4,20,Friday
2,4,12,16,2018,5,19,Saturday
6,11,2,13,2018,3,29,Thursday
2,16,8,24,2017,12,4,Monday
1,5,9,14,2018,7,18,Wednseday
3,8,14,22,2017,10,2,Monday
11,67,-40,27,2017,11,17,Friday
2,36,-13,23,2018,4,2,Monday
1,14,9,23,2018,7,31,Tuesday
1,9,42,51,2018,6,3,Sunday
1,6,15,21,2018,4,24,Tuesday
2,14,10,24,2017,4,8,Saturday
3,4,14,18,2017,11,25,Saturday
5,6,2,8,2018,5,17,Thursday
2,9,13,22,2017,7,18,Tuesday
2,20,12,32,2017,8,5,Saturday
4,8,17,25,2018,7,5,Thursday
1,27,-7,20,2018,3,28,Wednseday
5,8,12,20,2018,2,15,Thursday
2,11,25,36,2018,2,4,Sunday
5,20,1,21,2017,11,15,Wednseday
22,36,-9,27,2017,4,19,Wednseday
2,10,15,25,2017,5,13,Saturday
7,8,0,8,2018,8,2,Thursday
7,12,15,27,2017,6,7,Wednseday
4,9,21,30,2017,12,30,Saturday
1,7,6,13,2018,8,2,Thursday
2,13,10,23,2018,3,13,Tuesday
1,11,28,39,2017,1,26,Thursday
1,13,17,30,2017,6,6,Tuesday
3,22,1,23,2017,11,14,Tuesday
2,10,15,25,2018,2,4,Sunday
6,15,20,35,2017,12,7,Thursday
1,13,13,26,2018,8,16,Thursday
2,3,5,8,2018,7,24,Tuesday
1,2,13,15,2018,2,18,Sunday
2,33,-14,19,2018,2,28,Wednseday
3,16,27,43,2017,2,7,Tuesday
2,25,2,27,2018,1,27,Saturday
3,21,4,25,2018,5,11,Friday
1,2,8,10,2018,7,9,Monday
6,18,18,36,2017,12,12,Tuesday
1,6,23,29,2018,4,26,Thursday
5,20,3,23,2017,11,29,Wednseday
8,78,-57,21,2018,2,22,Thursday
3,10,3,13,2018,8,10,Friday
1,22,8,30,2018,1,15,Monday
22,43,-11,32,2017,11,24,Friday
4,5,7,12,2017,11,19,Sunday
40,46,8,54,2018,6,28,Thursday
1,2,8,10,2018,6,19,Tuesday
25,30,33,63,2016,10,5,Wednseday
3,5,6,11,2018,5,12,Saturday
5,6,6,12,2018,4,12,Thursday
0,8,27,35,2018,6,19,Tuesday
1,6,14,20,2017,7,26,Wednseday
1,7,22,29,2018,1,22,Monday
2,11,22,33,2018,5,27,Sunday
3,10,16,26,2018,6,23,Saturday
0,4,18,22,2018,6,21,Thursday
2,3,14,17,2017,9,24,Sunday
1,2,16,18,2018,7,1,Sunday
1,1,11,12,2018,4,6,Friday
1,8,18,26,2017,7,27,Thursday
1,5,21,26,2018,1,7,Sunday
16,34,10,44,2018,1,16,Tuesday
6,23,-3,20,2018,2,20,Tuesday
2,4,7,11,2018,8,4,Saturday
2,9,20,29,2018,4,11,Wednseday
7,8,2,10,2018,7,20,Friday
1,6,14,20,2017,5,9,Tuesday
2,12,21,33,2017,6,14,Wednseday
1,7,15,22,2017,10,3,Tuesday
2,9,17,26,2017,11,12,Sunday
2,4,10,14,2018,2,22,Thursday
4,29,1,30,2018,2,26,Monday
1,13,20,33,2017,11,8,Wednseday
3,6,10,16,2017,11,26,Sunday
13,22,0,22,2018,2,27,Tuesday
1,12,15,27,2017,8,31,Thursday
5,9,6,15,2018,4,25,Wednseday
1,13,8,21,2017,4,4,Tuesday
7,27,5,32,2018,1,19,Friday
5,10,11,21,2018,5,4,Friday
3,12,18,30,2017,11,11,Saturday
2,9,15,24,2018,2,17,Saturday
0,6,13,19,2018,5,9,Wednseday
1,10,15,25,2017,10,30,Monday
5,20,2,22,2018,3,14,Wednseday
2,3,9,12,2018,3,31,Saturday
3,8,18,26,2017,12,2,Saturday
1,6,14,20,2018,6,14,Thursday
4,12,13,25,2017,11,9,Thursday
0,1,5,6,2018,8,7,Tuesday
6,8,5,13,2017,6,20,Tuesday
5,6,7,13,2018,3,28,Wednseday
2,34,-6,28,2018,3,6,Tuesday
7,15,7,22,2017,9,5,Tuesday
8,9,8,17,2018,1,7,Sunday
1,8,10,18,2018,7,23,Monday
1,12,20,32,2017,2,23,Thursday
3,17,7,24,2018,3,19,Monday
4,6,19,25,2017,8,26,Saturday
3,7,11,18,2017,9,29,Friday
7,8,5,13,2017,7,19,Wednseday
5,14,18,32,2018,2,22,Thursday
2,11,13,24,2018,4,15,Sunday
1,20,4,24,2018,1,16,Tuesday
2,15,14,29,2017,12,5,Tuesday
5,7,7,14,2018,8,17,Friday
2,9,22,31,2017,12,26,Tuesday
5,12,19,31,2017,9,29,Friday
7,12,17,29,2018,4,25,Wednseday
2,11,12,23,2018,3,25,Sunday
3,4,8,12,2017,8,25,Friday
1,4,4,8,2018,8,6,Monday
2,4,5,9,2018,5,21,Monday
1,2,19,21,2017,11,23,Thursday
0,8,20,28,2018,4,18,Wednseday
2,6,11,17,2018,4,17,Tuesday
2,13,14,27,2017,3,14,Tuesday
5,16,45,61,2017,1,18,Wednseday
4,6,1,7,2018,8,2,Thursday
1,14,10,24,2018,4,3,Tuesday
2,9,11,20,2017,6,20,Tuesday
2,3,6,9,2018,7,23,Monday
0,4,13,17,2017,10,23,Monday
6,7,6,13,2017,10,12,Thursday
1,2,14,16,2018,2,13,Tuesday
6,13,11,24,2017,6,13,Tuesday
0,17,2,19,2018,3,23,Friday
1,6,14,20,2017,7,6,Thursday
1,14,14,28,2018,1,23,Tuesday
13,35,-5,30,2017,10,28,Saturday
0,7,8,15,2018,8,21,Tuesday
6,36,-9,27,2018,1,25,Thursday
1,2,10,12,2017,10,18,Wednseday
1,7,21,28,2017,11,2,Thursday
2,11,15,26,2018,5,12,Saturday
1,3,15,18,2017,7,24,Monday
3,22,4,26,2018,5,13,Sunday
6,8,6,14,2017,11,24,Friday
7,23,12,35,2018,8,6,Monday
2,19,12,31,2018,1,21,Sunday
1,27,0,27,2018,5,8,Tuesday
4,12,22,34,2017,12,1,Friday
1,8,14,22,2017,9,26,Tuesday
0,12,16,28,2018,6,13,Wednseday
7,13,12,25,2017,11,9,Thursday
3,5,25,30,2017,5,28,Sunday
1,17,17,34,2017,12,5,Tuesday
1,4,2,6,2018,8,9,Thursday
1,6,14,20,2018,6,28,Thursday
3,6,19,25,2017,6,2,Friday
6,12,9,21,2017,9,6,Wednseday
1,6,10,16,2017,5,9,Tuesday
3,10,16,26,2017,6,11,Sunday
1,20,13,33,2018,3,21,Wednseday
3,8,21,29,2017,5,7,Sunday
4,18,9,27,2018,2,10,Saturday
11,24,-3,21,2017,11,24,Friday
4,19,-1,18,2017,9,16,Saturday
7,22,17,39,2017,12,8,Friday
4,10,4,14,2018,8,3,Friday
0,6,20,26,2018,5,2,Wednseday
4,13,5,18,2017,10,13,Friday
3,9,15,24,2017,10,21,Saturday
5,44,-17,27,2018,2,28,Wednseday
2,26,3,29,2018,2,25,Sunday
8,16,18,34,2017,12,20,Wednseday
1,7,14,21,2017,10,17,Tuesday
1,8,24,32,2017,3,9,Thursday
1,14,14,28,2017,6,15,Thursday
1,8,33,41,2017,1,17,Tuesday
3,6,24,30,2018,7,14,Saturday
12,20,5,25,2017,3,10,Friday
1,14,36,50,2017,1,25,Wednseday
4,7,18,25,2017,3,3,Friday
3,11,20,31,2017,9,15,Friday
1,16,8,24,2018,4,23,Monday
0,3,4,7,2018,7,31,Tuesday
2,6,16,22,2018,5,1,Tuesday
4,19,15,34,2017,12,2,Saturday
2,10,8,18,2018,2,19,Monday
2,6,18,24,2017,3,25,Saturday
11,21,8,29,2017,4,24,Monday
4,16,5,21,2017,9,1,Friday
1,2,18,20,2017,12,26,Tuesday
3,9,15,24,2018,1,16,Tuesday
1,2,9,11,2017,5,8,Monday
1,13,16,29,2017,8,15,Tuesday
1,7,19,26,2017,12,27,Wednseday
1,4,46,50,2018,6,5,Tuesday
0,2,5,7,2018,8,14,Tuesday
1,18,4,22,2017,6,27,Tuesday
5,20,16,36,2017,12,21,Thursday
1,22,0,22,2018,4,22,Sunday
1,22,6,28,2018,3,13,Tuesday
2,15,13,28,2017,10,30,Monday
3,12,14,26,2017,11,4,Saturday
2,4,20,24,2018,2,18,Sunday
0,31,-9,22,2017,7,10,Monday
1,9,32,41,2017,2,22,Wednseday
4,18,15,33,2017,8,10,Thursday
9,15,2,17,2017,11,20,Monday
1,7,9,16,2017,11,22,Wednseday
1,2,10,12,2017,5,21,Sunday
1,22,-1,21,2018,2,26,Monday
1,11,9,20,2018,5,15,Tuesday
4,15,17,32,2017,10,12,Thursday
2,15,19,34,2018,1,16,Tuesday
4,23,-3,20,2017,5,11,Thursday
4,14,0,14,2018,7,16,Monday
1,17,18,35,2017,5,4,Thursday
1,6,16,22,2018,4,12,Thursday
1,8,21,29,2018,7,25,Wednseday
1,6,22,28,2017,9,12,Tuesday
1,9,7,16,2017,10,16,Monday
6,9,4,13,2017,9,20,Wednseday
1,6,22,28,2018,1,4,Thursday
3,29,-12,17,2018,3,11,Sunday
2,10,12,22,2018,4,1,Sunday
2,14,15,29,2018,3,21,Wednseday
2,7,16,23,2018,1,22,Monday
2,8,14,22,2017,8,8,Tuesday
2,5,18,23,2018,5,13,Sunday
1,9,12,21,2018,2,19,Monday
5,12,10,22,2017,7,12,Wednseday
1,6,21,27,2018,1,2,Tuesday
4,5,11,16,2018,6,25,Monday
1,4,17,21,2017,5,11,Thursday
5,10,12,22,2018,1,31,Wednseday
0,2,6,8,2018,7,19,Thursday
36,48,-6,42,2017,12,21,Thursday
2,25,13,38,2017,2,12,Sunday
3,4,15,19,2017,12,8,Friday
1,11,21,32,2017,10,12,Thursday
3,4,13,17,2017,10,21,Saturday
3,34,-7,27,2018,3,7,Wednseday
8,14,9,23,2018,5,7,Monday
0,7,17,24,2017,4,10,Monday
3,13,17,30,2018,2,14,Wednseday
4,16,-2,14,2017,11,24,Friday
3,28,5,33,2017,11,25,Saturday
2,14,15,29,2018,2,14,Wednseday
1,2,20,22,2018,6,20,Wednseday
0,5,9,14,2018,7,27,Friday
4,6,19,25,2018,4,12,Thursday
1,7,6,13,2018,8,21,Tuesday
3,33,0,33,2017,11,24,Friday
5,8,12,20,2017,11,23,Thursday
5,10,11,21,2018,1,19,Friday
2,9,23,32,2018,4,21,Saturday
0,2,1,3,2018,7,31,Tuesday
4,48,-20,28,2018,3,23,Friday
4,19,6,25,2017,2,12,Sunday
3,16,8,24,2017,8,7,Monday
5,15,3,18,2017,11,19,Sunday
2,8,15,23,2018,4,1,Sunday
3,11,5,16,2018,8,4,Saturday
0,9,21,30,2018,2,7,Wednseday
3,10,15,25,2018,2,24,Saturday
1,9,28,37,2017,10,8,Sunday
2,24,-8,16,2018,5,16,Wednseday
4,11,6,17,2018,8,3,Friday
18,54,-30,24,2017,11,24,Friday
1,4,4,8,2018,5,17,Thursday
2,11,14,25,2018,3,17,Saturday
3,4,13,17,2018,4,7,Saturday
0,9,9,18,2018,1,4,Thursday
1,17,11,28,2017,11,28,Tuesday
0,3,7,10,2018,4,20,Friday
1,21,11,32,2017,9,28,Thursday
7,23,10,33,2017,12,13,Wednseday
1,4,14,18,2018,7,26,Thursday
4,18,6,24,2017,7,14,Friday
1,9,20,29,2018,7,3,Tuesday
4,31,-5,26,2018,1,19,Friday
5,9,7,16,2018,7,21,Saturday
2,7,11,18,2018,5,14,Monday
3,7,10,17,2018,4,2,Monday
0,6,22,28,2018,6,7,Thursday
23,35,-7,28,2017,7,24,Monday
1,7,13,20,2018,2,14,Wednseday
1,9,15,24,2018,5,8,Tuesday
2,14,8,22,2018,3,6,Tuesday
1,18,11,29,2017,6,22,Thursday
0,7,3,10,2018,8,13,Monday
1,26,3,29,2017,5,22,Monday
7,14,27,41,2017,3,30,Thursday
0,9,23,32,2018,7,30,Monday
1,15,5,20,2018,4,3,Tuesday
3,10,7,17,2018,8,14,Tuesday
19,34,-7,27,2017,6,7,Wednseday
4,36,-5,31,2018,1,21,Sunday
3,10,21,31,2017,10,7,Saturday
2,7,12,19,2018,7,5,Thursday
1,11,16,27,2017,6,8,Thursday
2,3,12,15,2017,5,22,Monday
2,10,9,19,2018,7,21,Saturday
1,3,16,19,2018,1,17,Wednseday
3,9,8,17,2017,11,27,Monday
3,11,15,26,2018,1,12,Friday
2,16,15,31,2017,4,4,Tuesday
2,15,25,40,2017,12,13,Wednseday
1,2,15,17,2017,11,20,Monday
0,6,15,21,2017,3,1,Wednseday
2,19,4,23,2018,1,10,Wednseday
4,14,15,29,2017,10,12,Thursday
4,5,12,17,2018,1,19,Friday
1,7,12,19,2018,8,10,Friday
5,7,18,25,2018,7,5,Thursday
1,6,15,21,2018,8,16,Thursday
0,5,21,26,2017,12,14,Thursday
0,3,12,15,2018,1,23,Tuesday
3,5,9,14,2018,2,12,Monday
1,6,17,23,2018,1,17,Wednseday
2,3,20,23,2018,8,22,Wednseday
2,23,15,38,2018,3,4,Sunday
7,28,-2,26,2018,2,9,Friday
1,4,9,13,2018,3,22,Thursday
4,9,11,20,2017,11,4,Saturday
3,8,13,21,2017,5,29,Monday
3,10,18,28,2018,1,12,Friday
3,18,4,22,2018,1,29,Monday
1,14,12,26,2018,1,3,Wednseday
2,12,12,24,2017,8,5,Saturday
1,5,17,22,2018,2,18,Sunday
5,13,8,21,2018,4,5,Thursday
8,9,7,16,2018,2,6,Tuesday
0,21,3,24,2018,6,11,Monday
1,3,13,16,2017,12,4,Monday
2,34,7,41,2017,10,25,Wednseday
1,7,13,20,2017,11,23,Thursday
3,14,0,14,2017,11,28,Tuesday
3,8,15,23,2017,2,26,Sunday
6,16,14,30,2018,3,31,Saturday
4,13,24,37,2018,1,13,Saturday
14,16,8,24,2017,3,27,Monday
4,31,3,34,2018,2,23,Friday
2,8,29,37,2018,1,1,Monday
3,4,7,11,2018,5,14,Monday
1,7,18,25,2017,12,10,Sunday
2,3,1,4,2018,7,29,Sunday
3,4,11,15,2018,1,15,Monday
0,8,14,22,2017,11,20,Monday
1,8,10,18,2018,8,9,Thursday
4,9,12,21,2018,4,26,Thursday
4,6,7,13,2017,8,24,Thursday
10,20,32,52,2018,6,1,Friday
2,10,21,31,2017,8,21,Monday
1,8,14,22,2017,11,26,Sunday
3,10,1,11,2018,8,19,Sunday
1,8,7,15,2018,8,8,Wednseday
1,2,12,14,2017,11,27,Monday
5,13,20,33,2017,11,25,Saturday
1,2,11,13,2017,10,25,Wednseday
1,19,10,29,2017,8,16,Wednseday
5,29,-1,28,2017,11,24,Friday
0,2,9,11,2017,11,6,Monday
2,12,18,30,2017,12,10,Sunday
1,34,-7,27,2017,9,19,Tuesday
4,19,15,34,2017,7,20,Thursday
1,12,10,22,2018,3,11,Sunday
1,22,1,23,2018,4,17,Tuesday
3,19,2,21,2018,3,30,Friday
1,9,12,21,2017,11,15,Wednseday
1,3,6,9,2018,6,11,Monday
2,27,0,27,2018,4,24,Tuesday
0,10,25,35,2018,1,25,Thursday
4,10,7,17,2017,3,6,Monday
1,29,-2,27,2018,3,20,Tuesday
3,11,13,24,2017,8,11,Friday
4,19,2,21,2017,4,20,Thursday
1,8,20,28,2017,5,1,Monday
1,10,15,25,2018,2,5,Monday
1,7,17,24,2017,5,1,Monday
1,5,15,20,2018,5,10,Thursday
2,10,17,27,2017,5,23,Tuesday
1,28,3,31,2017,12,26,Tuesday
8,27,-1,26,2017,10,11,Wednseday
8,33,6,39,2018,1,7,Sunday
2,6,6,12,2018,8,8,Wednseday
2,5,18,23,2017,11,8,Wednseday
2,6,3,9,2018,7,25,Wednseday
1,3,12,15,2018,1,23,Tuesday
5,18,21,39,2018,1,12,Friday
3,13,11,24,2017,10,3,Tuesday
1,10,8,18,2017,5,22,Monday
0,4,16,20,2017,7,6,Thursday
2,6,3,9,2018,5,8,Tuesday
3,7,4,11,2018,8,18,Saturday
3,16,18,34,2017,9,30,Saturday
7,13,11,24,2018,3,20,Tuesday
1,14,3,17,2018,4,9,Monday
2,8,12,20,2018,3,27,Tuesday
4,4,10,14,2017,6,15,Thursday
0,6,13,19,2017,8,30,Wednseday
0,16,6,22,2018,4,11,Wednseday
7,13,13,26,2017,12,29,Friday
4,37,3,40,2018,2,15,Thursday
2,7,12,19,2017,10,18,Wednseday
1,3,22,25,2018,5,27,Sunday
7,9,12,21,2017,6,19,Monday
1,9,19,28,2018,1,18,Thursday
3,13,13,26,2018,7,20,Friday
0,9,6,15,2018,8,13,Monday
2,26,4,30,2017,12,3,Sunday
1,10,16,26,2017,12,20,Wednseday
2,9,13,22,2018,3,25,Sunday
11,23,-3,20,2017,11,25,Saturday
5,10,20,30,2017,2,11,Saturday
2,15,15,30,2018,3,24,Saturday
2,8,9,17,2017,10,9,Monday
2,9,35,44,2018,7,1,Sunday
6,8,14,22,2017,5,18,Thursday
4,8,20,28,2018,1,5,Friday
5,7,7,14,2017,11,2,Thursday
1,8,12,20,2018,3,7,Wednseday
1,2,12,14,2018,5,15,Tuesday
3,10,8,18,2018,7,23,Monday
3,6,19,25,2018,4,7,Saturday
2,10,13,23,2018,4,23,Monday
5,6,13,19,2018,4,19,Thursday
5,13,13,26,2017,10,8,Sunday
0,6,23,29,2018,1,4,Thursday
2,11,16,27,2018,1,27,Saturday
3,12,13,25,2017,11,26,Sunday
0,3,9,12,2018,5,11,Friday
3,22,7,29,2017,11,14,Tuesday
1,6,23,29,2018,2,15,Thursday
2,26,0,26,2017,12,2,Saturday
3,18,9,27,2017,10,7,Saturday
1,7,21,28,2017,12,21,Thursday
3,16,8,24,2017,6,26,Monday
6,17,6,23,2018,4,7,Saturday
4,15,18,33,2018,4,15,Sunday
1,8,16,24,2017,10,30,Monday
1,6,7,13,2018,8,14,Tuesday
2,9,28,37,2018,7,14,Saturday
1,7,13,20,2017,7,25,Tuesday
2,3,7,10,2018,8,11,Saturday
8,20,1,21,2017,5,2,Tuesday
2,9,15,24,2017,6,4,Sunday
1,2,6,8,2018,8,7,Tuesday
2,6,17,23,2017,10,31,Tuesday
1,14,14,28,2018,1,2,Tuesday
2,3,7,10,2018,7,21,Saturday
1,2,18,20,2018,5,23,Wednseday
3,9,13,22,2017,9,26,Tuesday
0,19,13,32,2017,10,6,Friday
2,15,23,38,2017,9,24,Sunday
2,7,20,27,2017,2,9,Thursday
5,6,6,12,2018,3,16,Friday
33,34,14,48,2018,6,1,Friday
1,8,15,23,2018,7,3,Tuesday
4,7,14,21,2017,12,22,Friday
0,9,10,19,2017,8,31,Thursday
11,12,4,16,2018,8,18,Saturday
4,7,21,28,2017,3,9,Thursday
14,15,2,17,2018,8,13,Monday
4,6,2,8,2018,7,19,Thursday
3,7,8,15,2018,5,7,Monday
24,32,1,33,2018,4,13,Friday
3,8,17,25,2018,4,29,Sunday
3,13,6,19,2018,4,20,Friday
3,11,0,11,2018,7,20,Friday
4,10,16,26,2017,5,5,Friday
4,7,6,13,2018,8,9,Thursday
10,60,-37,23,2017,11,25,Saturday
2,7,20,27,2017,6,3,Saturday
1,7,9,16,2018,7,16,Monday
3,7,16,23,2018,4,11,Wednseday
1,4,8,12,2018,3,15,Thursday
4,24,2,26,2017,11,24,Friday
1,6,16,22,2017,7,25,Tuesday
2,4,21,25,2018,6,3,Sunday
1,7,19,26,2017,4,12,Wednseday
1,6,29,35,2017,2,1,Wednseday
1,7,16,23,2017,7,19,Wednseday
1,10,10,20,2018,2,20,Tuesday
0,13,9,22,2017,5,18,Thursday
6,17,10,27,2017,3,10,Friday
1,19,3,22,2018,8,1,Wednseday
1,12,15,27,2018,8,9,Thursday
5,9,15,24,2018,4,29,Sunday
1,2,22,24,2018,6,4,Monday
2,4,14,18,2018,2,26,Monday
5,12,29,41,2018,3,1,Thursday
2,10,15,25,2018,1,20,Saturday
3,8,20,28,2017,7,25,Tuesday
3,12,19,31,2018,4,15,Sunday
7,13,14,27,2018,7,27,Friday
1,7,8,15,2018,8,20,Monday
3,12,7,19,2018,3,24,Saturday
1,5,17,22,2018,8,12,Sunday
5,33,-2,31,2017,4,22,Saturday
4,8,19,27,2017,11,2,Thursday
6,13,8,21,2018,3,1,Thursday
0,8,19,27,2017,12,27,Wednseday
1,24,-7,17,2017,4,24,Monday
2,4,11,15,2018,4,9,Monday
5,14,5,19,2017,3,22,Wednseday
1,23,9,32,2018,3,11,Sunday
7,19,12,31,2018,7,6,Friday
2,9,38,47,2018,6,2,Saturday
4,9,15,24,2017,7,1,Saturday
13,19,7,26,2018,7,14,Saturday
1,19,5,24,2018,1,7,Sunday
1,3,8,11,2017,5,29,Monday
1,6,7,13,2018,3,27,Tuesday
2,5,18,23,2017,6,14,Wednseday
4,19,18,37,2017,12,3,Sunday
2,6,21,27,2017,9,30,Saturday
2,12,21,33,2017,6,25,Sunday
4,11,17,28,2018,4,19,Thursday
2,6,17,23,2017,12,6,Wednseday
12,26,7,33,2017,6,14,Wednseday
2,36,-11,25,2017,12,11,Monday
1,2,7,9,2018,6,11,Monday
4,5,20,25,2018,1,4,Thursday
5,26,1,27,2017,11,2,Thursday
20,33,-8,25,2017,11,25,Saturday
11,18,22,40,2018,1,28,Sunday
3,10,10,20,2017,9,1,Friday
1,18,21,39,2017,3,26,Sunday
1,14,11,25,2017,12,4,Monday
2,9,23,32,2018,6,3,Sunday
2,6,11,17,2018,6,12,Tuesday
1,24,7,31,2018,2,16,Friday
2,9,14,23,2017,6,14,Wednseday
4,9,25,34,2018,2,1,Thursday
15,19,-5,14,2018,8,1,Wednseday
1,29,-2,27,2017,11,30,Thursday
6,8,11,19,2018,8,9,Thursday
3,12,14,26,2018,7,14,Saturday
1,23,6,29,2017,11,28,Tuesday
5,14,27,41,2018,8,9,Thursday
1,16,11,27,2018,3,27,Tuesday
3,8,4,12,2018,7,29,Sunday
5,10,11,21,2017,10,20,Friday
0,6,3,9,2018,8,1,Wednseday
3,15,15,30,2017,11,7,Tuesday
1,28,-1,27,2017,12,1,Friday
1,5,8,13,2018,4,4,Wednseday
1,11,10,21,2017,5,11,Thursday
2,9,11,20,2017,5,10,Wednseday
7,29,-2,27,2018,2,7,Wednseday
2,3,17,20,2017,12,26,Tuesday
12,17,9,26,2017,11,26,Sunday
5,15,4,19,2018,4,20,Friday
5,26,-4,22,2018,2,21,Wednseday
1,8,17,25,2017,8,17,Thursday
1,7,30,37,2018,5,14,Monday
3,11,29,40,2018,5,26,Saturday
2,8,33,41,2018,7,31,Tuesday
4,11,18,29,2018,1,11,Thursday
7,20,-7,13,2017,5,24,Wednseday
1,21,13,34,2017,11,29,Wednseday
3,5,19,24,2018,4,8,Sunday
9,22,8,30,2018,1,6,Saturday
1,5,13,18,2017,8,28,Monday
5,9,9,18,2018,6,2,Saturday
12,17,27,44,2018,1,17,Wednseday
3,13,15,28,2018,2,13,Tuesday
8,10,8,18,2017,9,3,Sunday
1,13,9,22,2017,2,28,Tuesday
3,14,14,28,2018,4,10,Tuesday
2,9,11,20,2017,8,15,Tuesday
2,8,13,21,2017,3,6,Monday
9,19,14,33,2017,12,27,Wednseday
4,17,7,24,2018,1,28,Sunday
1,3,14,17,2017,12,11,Monday
8,14,13,27,2017,11,14,Tuesday
2,4,14,18,2018,7,28,Saturday
4,7,8,15,2018,1,15,Monday
4,13,20,33,2018,6,15,Friday
2,39,8,47,2018,7,15,Sunday
4,31,10,41,2017,2,17,Friday
5,26,-5,21,2018,4,4,Wednseday
1,7,11,18,2017,11,13,Monday
2,8,10,18,2017,10,23,Monday
1,7,12,19,2018,8,2,Thursday
0,7,10,17,2018,3,27,Tuesday
4,15,7,22,2017,10,23,Monday
1,4,0,4,2018,8,19,Sunday
2,6,6,12,2018,6,9,Saturday
2,19,12,31,2017,11,26,Sunday
2,9,15,24,2018,5,13,Sunday
4,9,15,24,2018,2,10,Saturday
5,9,14,23,2018,4,28,Saturday
2,7,11,18,2017,5,15,Monday
3,4,11,15,2018,3,18,Sunday
2,12,9,21,2018,8,8,Wednseday
2,46,-27,19,2017,11,26,Sunday
0,1,10,11,2017,5,22,Monday
1,2,14,16,2018,2,6,Tuesday
5,34,-8,26,2017,11,1,Wednseday
3,10,16,26,2018,7,27,Friday
2,6,12,18,2018,8,18,Saturday
4,12,19,31,2018,1,20,Saturday
7,29,-1,28,2018,3,27,Tuesday
3,16,10,26,2018,3,25,Sunday
4,8,21,29,2017,8,3,Thursday
1,4,19,23,2018,8,19,Sunday
2,9,24,33,2018,6,9,Saturday
4,5,14,19,2018,1,13,Saturday
1,3,18,21,2017,8,21,Monday
10,11,2,13,2017,9,2,Saturday
4,9,15,24,2017,7,24,Monday
1,8,17,25,2018,7,2,Monday
4,12,18,30,2017,7,2,Sunday
1,6,11,17,2018,6,12,Tuesday
6,7,0,7,2018,8,8,Wednseday
1,8,19,27,2017,12,20,Wednseday
3,11,12,23,2018,2,25,Sunday
1,9,22,31,2017,12,18,Monday
1,16,0,16,2017,11,26,Sunday
1,22,6,28,2018,6,21,Thursday
5,11,9,20,2017,8,17,Thursday
3,3,20,23,2017,9,23,Saturday
2,9,16,25,2017,5,27,Saturday
3,10,12,22,2017,10,22,Sunday
3,13,36,49,2018,6,15,Friday
1,5,0,5,2018,8,22,Wednseday
1,6,11,17,2018,8,7,Tuesday
1,12,10,22,2017,8,2,Wednseday
5,11,17,28,2018,1,4,Thursday
1,7,17,24,2017,10,10,Tuesday
2,7,10,17,2017,12,12,Tuesday
0,2,1,3,2018,8,13,Monday
2,9,27,36,2017,4,10,Monday
1,8,13,21,2018,3,19,Monday
3,11,20,31,2018,6,22,Friday
4,6,8,14,2017,11,24,Friday
3,38,-17,21,2018,2,19,Monday
1,4,14,18,2017,11,30,Thursday
1,7,20,27,2017,6,27,Tuesday
4,18,3,21,2018,3,12,Monday
12,19,5,24,2017,11,24,Friday
4,17,11,28,2018,1,1,Monday
1,8,25,33,2018,6,27,Wednseday
9,14,11,25,2017,2,20,Monday
2,39,-5,34,2017,7,29,Saturday
1,7,10,17,2017,9,19,Tuesday
1,6,7,13,2017,6,27,Tuesday
7,20,21,41,2017,4,27,Thursday
1,4,14,18,2018,6,7,Thursday
1,4,25,29,2018,7,2,Monday
4,16,3,19,2017,9,16,Saturday
3,10,23,33,2018,4,14,Saturday
3,9,22,31,2018,1,9,Tuesday
2,7,21,28,2018,3,26,Monday
3,13,7,20,2018,7,28,Saturday
2,3,3,6,2018,8,25,Saturday
2,9,15,24,2017,10,14,Saturday
4,15,7,22,2017,4,20,Thursday
3,28,-6,22,2018,2,13,Tuesday
3,6,6,12,2018,7,28,Saturday
0,7,24,31,2017,2,10,Friday
1,5,16,21,2018,8,1,Wednseday
2,8,18,26,2018,1,10,Wednseday
1,5,9,14,2018,2,22,Thursday
1,20,-1,19,2017,11,26,Sunday
4,5,12,17,2017,5,19,Friday
4,9,15,24,2018,7,28,Saturday
6,21,24,45,2018,2,2,Friday
1,11,14,25,2017,10,12,Thursday
11,14,7,21,2018,7,19,Thursday
0,24,-2,22,2018,2,27,Tuesday
3,11,13,24,2017,8,12,Saturday
9,17,14,31,2017,8,22,Tuesday
4,36,-10,26,2018,3,2,Friday
7,8,7,15,2018,7,5,Thursday
1,10,10,20,2018,3,23,Friday
2,13,4,17,2018,7,21,Saturday
2,7,7,14,2018,2,20,Tuesday
5,5,7,12,2018,3,31,Saturday
2,10,12,22,2018,4,30,Monday
1,8,14,22,2018,2,21,Wednseday
1,30,-14,16,2018,4,2,Monday
1,13,10,23,2018,1,17,Wednseday
1,17,6,23,2018,2,28,Wednseday
2,5,0,5,2018,8,15,Wednseday
1,8,22,30,2017,8,23,Wednseday
1,5,10,15,2018,4,5,Thursday
14,17,4,21,2018,4,18,Wednseday
1,3,18,21,2018,7,24,Tuesday
3,9,17,26,2018,1,21,Sunday
1,9,23,32,2017,12,18,Monday
1,5,32,37,2018,6,6,Wednseday
1,5,7,12,2017,10,18,Wednseday
2,8,14,22,2018,4,3,Tuesday
4,12,12,24,2018,3,23,Friday
1,6,13,19,2018,8,2,Thursday
3,4,13,17,2018,4,13,Friday
2,8,23,31,2017,3,6,Monday
2,21,0,21,2017,9,18,Monday
0,5,14,19,2017,3,15,Wednseday
2,3,7,10,2017,10,17,Tuesday
3,14,5,19,2017,3,25,Saturday
2,24,0,24,2018,2,25,Sunday
5,59,-32,27,2018,7,20,Friday
3,11,3,14,2018,8,17,Friday
1,9,12,21,2017,10,10,Tuesday
2,4,13,17,2017,12,3,Sunday
1,2,11,13,2018,2,28,Wednseday
3,21,12,33,2018,1,6,Saturday
2,4,11,15,2018,2,25,Sunday
2,7,13,20,2018,8,14,Tuesday
1,7,21,28,2018,6,26,Tuesday
3,6,6,12,2018,8,24,Friday
2,16,8,24,2018,2,25,Sunday
3,7,19,26,2017,11,24,Friday
5,19,6,25,2018,2,22,Thursday
10,27,5,32,2017,2,26,Sunday
5,8,25,33,2018,6,17,Sunday
3,14,7,21,2018,3,13,Tuesday
3,7,20,27,2018,4,27,Friday
6,17,12,29,2018,1,9,Tuesday
0,1,2,3,2018,7,30,Monday
6,36,-3,33,2018,2,2,Friday
2,7,21,28,2018,5,1,Tuesday
3,10,24,34,2017,9,30,Saturday
3,9,11,20,2017,10,28,Saturday
0,5,15,20,2018,4,25,Wednseday
5,10,9,19,2017,3,23,Thursday
1,12,18,30,2017,1,23,Monday
1,6,14,20,2017,6,29,Thursday
1,10,6,16,2017,9,19,Tuesday
3,12,13,25,2017,6,10,Saturday
2,9,12,21,2017,3,27,Monday
1,2,12,14,2018,6,28,Thursday
11,24,-2,22,2018,1,30,Tuesday
0,2,14,16,2017,12,5,Tuesday
1,6,10,16,2018,7,25,Wednseday
1,24,-3,21,2017,4,25,Tuesday
2,21,6,27,2017,11,14,Tuesday
1,5,18,23,2017,5,21,Sunday
2,5,18,23,2018,4,22,Sunday
4,12,12,24,2017,7,7,Friday
1,30,-9,21,2018,3,6,Tuesday
2,5,8,13,2017,7,12,Wednseday
3,6,14,20,2018,7,20,Friday
10,16,20,36,2017,12,10,Sunday
1,7,16,23,2018,3,21,Wednseday
4,20,19,39,2017,4,15,Saturday
5,8,17,25,2017,6,15,Thursday
4,5,13,18,2018,6,7,Thursday
4,6,15,21,2017,7,21,Friday
2,16,13,29,2018,6,18,Monday
0,9,12,21,2017,11,7,Tuesday
1,16,9,25,2017,12,18,Monday
5,27,4,31,2017,11,25,Saturday
1,8,27,35,2017,1,26,Thursday
4,5,12,17,2017,9,22,Friday
4,21,-1,20,2018,3,8,Thursday
7,8,10,18,2017,9,28,Thursday
3,39,-12,27,2018,1,12,Friday
5,25,14,39,2017,11,2,Thursday
4,13,18,31,2017,11,10,Friday
2,11,12,23,2018,7,9,Monday
1,21,21,42,2018,1,18,Thursday
2,10,14,24,2017,4,10,Monday
1,7,14,21,2018,6,13,Wednseday
3,8,30,38,2017,7,23,Sunday
1,13,42,55,2018,3,20,Tuesday
7,13,12,25,2017,6,9,Friday
4,18,6,24,2017,11,25,Saturday
1,7,14,21,2018,6,14,Thursday
6,20,13,33,2017,11,25,Saturday
2,36,-6,30,2018,1,30,Tuesday
3,23,7,30,2017,7,1,Saturday
0,42,-22,20,2018,2,28,Wednseday
1,5,8,13,2018,8,8,Wednseday
4,10,15,25,2018,2,10,Saturday
2,9,10,19,2018,4,14,Saturday
4,14,13,27,2017,8,17,Thursday
3,4,6,10,2018,7,21,Saturday
5,13,14,27,2018,2,9,Friday
1,13,21,34,2017,12,26,Tuesday
0,7,19,26,2017,4,28,Friday
1,18,13,31,2017,10,16,Monday
1,4,22,26,2018,5,31,Thursday
5,6,2,8,2018,7,18,Wednseday
7,54,-30,24,2017,11,24,Friday
2,8,16,24,2017,12,26,Tuesday
2,15,12,27,2018,7,10,Tuesday
5,14,10,24,2017,8,4,Friday
1,14,9,23,2017,6,7,Wednseday
1,6,16,22,2018,3,21,Wednseday
8,17,11,28,2017,12,18,Monday
5,10,3,13,2017,11,17,Friday
1,2,2,4,2018,8,27,Monday
3,4,6,10,2018,7,24,Tuesday
2,3,12,15,2018,8,19,Sunday
7,8,9,17,2018,1,19,Friday
1,8,17,25,2017,4,9,Sunday
4,12,15,27,2017,11,2,Thursday
5,7,22,29,2017,4,6,Thursday
1,9,24,33,2017,12,13,Wednseday
3,8,21,29,2018,4,22,Sunday
3,14,8,22,2017,7,25,Tuesday
2,15,12,27,2017,11,15,Wednseday
6,15,13,28,2018,1,23,Tuesday
3,6,28,34,2018,3,30,Friday
1,26,-6,20,2018,3,1,Thursday
5,7,6,13,2017,11,16,Thursday
0,6,17,23,2018,4,17,Tuesday
3,8,16,24,2017,10,20,Friday
1,8,20,28,2018,6,7,Thursday
1,14,15,29,2017,6,5,Monday
1,2,11,13,2018,3,20,Tuesday
4,19,23,42,2017,10,5,Thursday
16,39,-12,27,2018,2,24,Saturday
3,6,13,19,2017,11,17,Friday
1,7,16,23,2017,3,8,Wednseday
2,8,13,21,2018,2,19,Monday
1,3,14,17,2018,3,26,Monday
0,3,11,14,2018,5,4,Friday
4,19,13,32,2018,2,11,Sunday
2,3,10,13,2017,10,21,Saturday
1,2,9,11,2018,3,18,Sunday
1,2,18,20,2017,12,26,Tuesday
6,8,10,18,2018,5,10,Thursday
5,13,14,27,2018,4,19,Thursday
2,12,17,29,2018,4,22,Sunday
7,28,1,29,2018,2,19,Monday
4,18,18,36,2018,1,21,Sunday
2,14,6,20,2018,2,27,Tuesday
2,5,16,21,2017,6,14,Wednseday
0,5,4,9,2018,8,8,Wednseday
4,7,11,18,2018,4,12,Thursday
1,5,6,11,2018,8,2,Thursday
1,8,19,27,2018,1,18,Thursday
1,5,4,9,2018,8,5,Sunday
3,13,27,40,2017,9,22,Friday
3,31,0,31,2017,12,8,Friday
2,11,12,23,2018,8,18,Saturday
3,4,11,15,2017,7,23,Sunday
1,4,13,17,2018,7,9,Monday
7,26,4,30,2017,12,13,Wednseday
1,14,9,23,2018,2,14,Wednseday
2,4,10,14,2017,9,4,Monday
3,17,9,26,2017,7,15,Saturday
1,5,24,29,2017,2,9,Thursday
5,11,15,26,2017,11,25,Saturday
3,7,12,19,2017,12,8,Friday
5,30,7,37,2017,12,10,Sunday
3,22,2,24,2018,2,20,Tuesday
6,14,6,20,2017,4,19,Wednseday
2,24,-5,19,2018,5,20,Sunday
2,5,18,23,2018,5,5,Saturday
7,18,11,29,2017,5,29,Monday
3,4,13,17,2018,4,7,Saturday
1,7,1,8,2018,5,17,Thursday
0,9,4,13,2017,5,16,Tuesday
3,4,14,18,2018,1,5,Friday
3,6,19,25,2017,2,26,Sunday
1,6,15,21,2017,5,17,Wednseday
2,5,14,19,2017,10,25,Wednseday
1,2,11,13,2018,7,5,Thursday
2,3,11,14,2018,6,11,Monday
3,13,15,28,2018,8,17,Friday
1,4,10,14,2018,5,3,Thursday
17,27,30,57,2016,10,4,Tuesday
1,8,13,21,2017,11,27,Monday
3,15,7,22,2018,4,1,Sunday
2,27,18,45,2018,3,13,Tuesday
5,13,10,23,2017,11,4,Saturday
1,2,11,13,2018,5,1,Tuesday
1,6,20,26,2017,4,6,Thursday
3,22,15,37,2017,7,23,Sunday
11,18,5,23,2018,8,6,Monday
1,7,20,27,2017,11,30,Thursday
5,10,13,23,2017,12,4,Monday
4,7,18,25,2017,6,3,Saturday
1,5,9,14,2018,5,16,Wednseday
1,7,19,26,2017,12,13,Wednseday
1,16,11,27,2018,3,6,Tuesday
1,8,15,23,2017,5,29,Monday
2,2,14,16,2018,1,3,Wednseday
1,15,7,22,2018,2,8,Thursday
3,18,15,33,2018,2,2,Friday
3,9,11,20,2018,2,24,Saturday
5,17,20,37,2017,3,11,Saturday
3,7,26,33,2018,6,1,Friday
2,7,14,21,2017,11,1,Wednseday
8,9,6,15,2018,4,30,Monday
6,14,7,21,2017,8,29,Tuesday
2,10,21,31,2018,2,12,Monday
3,19,14,33,2017,8,12,Saturday
5,10,14,24,2018,2,10,Saturday
4,9,20,29,2018,4,29,Sunday
1,7,25,32,2018,3,26,Monday
1,9,13,22,2017,6,4,Sunday
6,8,8,16,2018,4,3,Tuesday
3,20,7,27,2018,3,20,Tuesday
4,5,6,11,2018,4,1,Sunday
3,7,13,20,2017,11,24,Friday
2,6,15,21,2017,3,28,Tuesday
6,11,8,19,2018,8,16,Thursday
1,2,3,5,2018,8,1,Wednseday
4,5,13,18,2018,4,12,Thursday
2,4,10,14,2018,2,12,Monday
2,6,10,16,2018,8,11,Saturday
3,4,8,12,2018,3,16,Friday
4,10,23,33,2017,2,11,Saturday
3,14,19,33,2017,7,19,Wednseday
2,23,12,35,2018,4,4,Wednseday
3,26,-6,20,2017,11,3,Friday
3,6,24,30,2017,8,5,Saturday
0,8,18,26,2017,12,15,Friday
1,7,14,21,2018,1,15,Monday
3,6,27,33,2017,12,2,Saturday
6,13,15,28,2018,1,4,Thursday
4,10,15,25,2017,12,1,Friday
6,19,9,28,2018,2,1,Thursday
3,8,11,19,2018,4,29,Sunday
4,45,-11,34,2017,12,8,Friday
1,15,13,28,2018,4,9,Monday
3,10,8,18,2018,8,3,Friday
4,5,9,14,2017,7,13,Thursday
1,9,18,27,2018,1,9,Tuesday
2,6,21,27,2017,10,14,Saturday
2,4,8,12,2017,9,13,Wednseday
10,16,7,23,2018,7,8,Sunday
3,10,11,21,2018,1,12,Friday
1,14,20,34,2017,3,21,Tuesday
5,8,16,24,2018,5,11,Friday
2,34,1,35,2018,2,1,Thursday
1,4,8,12,2018,5,3,Thursday
1,9,21,30,2018,5,7,Monday
4,11,14,25,2018,4,23,Monday
3,4,13,17,2017,6,10,Saturday
2,9,10,19,2018,7,22,Sunday
2,3,13,16,2018,1,2,Tuesday
1,7,23,30,2017,8,15,Tuesday
2,10,13,23,2017,10,29,Sunday
3,10,23,33,2018,6,1,Friday
5,35,-10,25,2018,3,9,Friday
4,17,10,27,2017,9,29,Friday
4,10,16,26,2018,4,15,Sunday
1,6,16,22,2017,8,9,Wednseday
1,10,14,24,2018,4,22,Sunday
0,1,12,13,2017,10,19,Thursday
1,12,22,34,2018,1,12,Friday
0,6,3,9,2018,8,15,Wednseday
1,17,12,29,2017,12,17,Sunday
2,11,20,31,2017,3,18,Saturday
1,12,15,27,2018,1,11,Thursday
1,2,1,3,2018,8,27,Monday
3,7,18,25,2017,5,20,Saturday
7,8,8,16,2017,9,5,Tuesday
4,13,14,27,2018,6,1,Friday
2,5,3,8,2018,8,8,Wednseday
3,8,15,23,2017,8,21,Monday
2,11,12,23,2018,1,8,Monday
7,11,13,24,2018,3,13,Tuesday
1,8,13,21,2018,8,16,Thursday
1,7,12,19,2018,3,22,Thursday
5,22,7,29,2018,3,28,Wednseday
4,5,10,15,2018,2,15,Thursday
4,5,10,15,2017,9,21,Thursday
5,9,14,23,2018,4,28,Saturday
7,12,14,26,2017,3,22,Wednseday
3,25,10,35,2018,2,6,Tuesday
1,5,14,19,2017,3,15,Wednseday
3,7,17,24,2017,6,3,Saturday
4,14,17,31,2018,3,2,Friday
3,8,13,21,2017,9,6,Wednseday
4,27,1,28,2018,2,20,Tuesday
15,21,38,59,2018,6,18,Monday
1,9,27,36,2017,5,17,Wednseday
4,20,13,33,2018,1,20,Saturday
4,14,9,23,2017,11,27,Monday
7,22,6,28,2018,7,9,Monday
5,10,2,12,2017,7,2,Sunday
3,6,32,38,2018,5,5,Saturday
4,24,14,38,2017,4,1,Saturday
3,11,16,27,2018,4,6,Friday
4,11,25,36,2018,6,14,Thursday
16,19,20,39,2017,2,4,Saturday
5,11,13,24,2017,11,26,Sunday
1,28,13,41,2018,4,25,Wednseday
4,9,13,22,2017,11,9,Thursday
1,34,-7,27,2018,2,13,Tuesday
1,9,20,29,2018,2,5,Monday
4,7,1,8,2018,8,14,Tuesday
10,28,0,28,2017,7,25,Tuesday
1,27,1,28,2018,2,6,Tuesday
2,9,33,42,2017,1,24,Tuesday
3,10,7,17,2018,4,23,Monday
3,3,10,13,2018,4,7,Saturday
1,9,16,25,2018,7,2,Monday
1,17,-1,16,2018,5,21,Monday
2,11,16,27,2018,6,16,Saturday
1,2,13,15,2018,6,18,Monday
5,9,10,19,2017,11,22,Wednseday
3,23,2,25,2018,6,3,Sunday
0,3,20,23,2018,4,17,Tuesday
3,8,14,22,2017,7,4,Tuesday
8,14,8,22,2018,4,11,Wednseday
1,34,-4,30,2017,4,25,Tuesday
1,3,5,8,2018,5,22,Tuesday
2,6,22,28,2018,1,3,Wednseday
1,6,2,8,2018,8,8,Wednseday
5,13,17,30,2017,2,8,Wednseday
9,17,19,36,2017,12,24,Sunday
1,11,35,46,2018,5,31,Thursday
3,7,14,21,2018,4,30,Monday
15,20,6,26,2017,12,28,Thursday
6,18,14,32,2018,2,10,Saturday
10,16,7,23,2017,11,27,Monday
4,16,26,42,2018,6,4,Monday
6,26,1,27,2018,7,7,Saturday
3,6,12,18,2018,5,12,Saturday
1,4,5,9,2017,5,15,Monday
1,9,31,40,2018,4,11,Wednseday
5,14,13,27,2018,4,12,Thursday
1,13,13,26,2018,4,29,Sunday
10,20,3,23,2017,9,11,Monday
1,7,16,23,2017,11,29,Wednseday
4,15,5,20,2018,5,15,Tuesday
4,7,58,65,2016,10,10,Monday
5,10,9,19,2018,2,25,Sunday
1,11,3,14,2018,8,16,Thursday
2,5,20,25,2018,6,16,Saturday
3,21,2,23,2018,5,16,Wednseday
2,2,12,14,2018,3,21,Wednseday
4,9,5,14,2018,7,16,Monday
1,7,19,26,2017,3,15,Wednseday
3,6,25,31,2018,6,22,Friday
3,7,15,22,2017,9,26,Tuesday
1,2,11,13,2017,7,4,Tuesday
1,30,0,30,2017,11,27,Monday
1,7,25,32,2018,6,18,Monday
5,19,20,39,2017,2,16,Thursday
1,10,15,25,2018,6,10,Sunday
16,36,14,50,2018,6,18,Monday
1,4,18,22,2017,9,27,Wednseday
1,6,23,29,2017,11,30,Thursday
2,12,17,29,2017,11,5,Sunday
14,23,11,34,2017,11,29,Wednseday
2,4,14,18,2018,4,28,Saturday
13,15,5,20,2017,10,19,Thursday
1,2,13,15,2018,8,13,Monday
3,8,12,20,2017,3,28,Tuesday
1,19,20,39,2017,1,19,Thursday
1,6,4,10,2018,8,7,Tuesday
2,3,12,15,2017,6,4,Sunday
1,8,16,24,2017,12,11,Monday
1,8,23,31,2018,5,13,Sunday
2,13,14,27,2017,8,29,Tuesday
1,11,23,34,2018,4,26,Thursday
2,8,26,34,2018,6,20,Wednseday
0,8,13,21,2017,9,1,Friday
2,2,13,15,2017,11,29,Wednseday
4,12,0,12,2018,8,16,Thursday
1,4,14,18,2018,4,22,Sunday
3,4,21,25,2018,6,1,Friday
2,18,8,26,2018,2,15,Thursday
8,18,11,29,2017,1,19,Thursday
3,13,13,26,2018,8,3,Friday
7,24,41,65,2018,6,4,Monday
2,7,10,17,2018,4,23,Monday
5,16,18,34,2018,7,4,Wednseday
4,12,8,20,2018,2,22,Thursday
1,12,6,18,2017,9,18,Monday
3,16,14,30,2017,11,13,Monday
1,15,9,24,2018,4,9,Monday
1,4,11,15,2018,2,27,Tuesday
4,6,16,22,2017,4,13,Thursday
1,5,17,22,2017,5,18,Thursday
1,3,13,16,2018,4,10,Tuesday
3,8,9,17,2017,3,6,Monday
1,6,8,14,2018,5,16,Wednseday
5,14,12,26,2018,1,31,Wednseday
2,14,10,24,2018,8,13,Monday
1,12,13,25,2017,3,9,Thursday
5,34,-2,32,2017,12,8,Friday
2,10,14,24,2017,9,19,Tuesday
1,7,22,29,2018,7,3,Tuesday
7,33,-6,27,2017,11,24,Friday
1,16,9,25,2017,7,2,Sunday
3,5,13,18,2018,4,21,Saturday
2,13,12,25,2018,4,2,Monday
1,14,21,35,2017,5,8,Monday
4,16,33,49,2018,5,28,Monday
2,3,12,15,2017,9,26,Tuesday
5,17,16,33,2017,11,12,Sunday
5,14,13,27,2017,8,18,Friday
2,10,21,31,2017,6,11,Sunday
1,9,12,21,2017,4,24,Monday
1,3,26,29,2018,1,22,Monday
4,11,22,33,2017,8,3,Thursday
1,11,17,28,2018,3,22,Thursday
5,19,3,22,2017,7,5,Wednseday
3,7,14,21,2018,4,13,Friday
0,22,8,30,2017,7,18,Tuesday
3,4,6,10,2018,5,19,Saturday
3,10,9,19,2017,9,9,Saturday
3,9,9,18,2018,7,14,Saturday
2,22,12,34,2017,12,13,Wednseday
3,9,22,31,2017,9,24,Sunday
3,32,11,43,2018,1,8,Monday
1,39,-7,32,2017,7,24,Monday
1,2,8,10,2018,3,19,Monday
1,4,8,12,2017,9,14,Thursday
2,6,6,12,2018,5,2,Wednseday
2,3,3,6,2018,8,18,Saturday
5,6,24,30,2017,12,6,Wednseday
3,14,10,24,2018,3,24,Saturday
5,9,12,21,2017,11,22,Wednseday
5,42,-21,21,2018,3,5,Monday
1,15,3,18,2018,3,25,Sunday
6,13,10,23,2017,11,28,Tuesday
2,12,17,29,2017,2,8,Wednseday
3,17,10,27,2018,2,21,Wednseday
2,15,12,27,2018,3,21,Wednseday
4,9,15,24,2017,9,23,Saturday
3,5,7,12,2018,3,16,Friday
0,10,14,24,2017,5,12,Friday
7,54,-23,31,2018,2,23,Friday
20,28,29,57,2016,10,10,Monday
9,10,4,14,2018,8,6,Monday
3,7,18,25,2017,9,1,Friday
7,16,24,40,2018,5,2,Wednseday
1,3,7,10,2017,5,14,Sunday
4,19,8,27,2018,4,20,Friday
4,10,15,25,2018,3,31,Saturday
1,4,8,12,2018,8,5,Sunday
3,6,7,13,2017,9,5,Tuesday
3,18,8,26,2017,7,8,Saturday
1,24,-2,22,2018,2,27,Tuesday
3,11,6,17,2017,8,28,Monday
1,11,11,22,2017,7,27,Thursday
0,8,15,23,2017,8,22,Tuesday
4,9,21,30,2017,10,7,Saturday
3,10,12,22,2018,7,10,Tuesday
1,7,10,17,2018,6,11,Monday
2,6,16,22,2017,6,11,Sunday
0,7,15,22,2017,10,19,Thursday
3,14,5,19,2017,11,26,Sunday
0,10,35,45,2017,11,27,Monday
2,4,11,15,2018,1,17,Wednseday
7,8,6,14,2018,2,20,Tuesday
6,13,42,55,2016,10,4,Tuesday
2,3,19,22,2017,11,5,Sunday
10,15,2,17,2018,8,7,Tuesday
0,7,37,44,2018,6,6,Wednseday
4,7,14,21,2018,1,19,Friday
0,9,25,34,2018,5,30,Wednseday
3,8,10,18,2017,11,25,Saturday
6,8,14,22,2017,5,3,Wednseday
2,3,13,16,2017,12,5,Tuesday
12,22,0,22,2018,3,28,Wednseday
1,10,20,30,2018,6,20,Wednseday
18,19,-6,13,2017,6,16,Friday
14,20,1,21,2018,7,17,Tuesday
3,17,19,36,2018,2,4,Sunday
3,14,21,35,2017,6,13,Tuesday
0,6,13,19,2017,10,25,Wednseday
13,22,10,32,2017,11,24,Friday
3,4,13,17,2017,7,16,Sunday
4,20,5,25,2018,2,17,Saturday
7,20,4,24,2017,11,24,Friday
1,9,12,21,2017,11,15,Wednseday
3,6,17,23,2018,7,28,Saturday
6,11,11,22,2017,8,31,Thursday
17,32,-5,27,2017,12,12,Tuesday
1,18,8,26,2018,4,15,Sunday
4,9,11,20,2017,8,10,Thursday
10,17,6,23,2017,2,25,Saturday
5,10,11,21,2017,3,10,Friday
0,13,20,33,2017,6,1,Thursday
3,5,12,17,2018,2,16,Friday
3,24,8,32,2017,12,23,Saturday
1,11,15,26,2018,1,25,Thursday
3,4,8,12,2018,8,25,Saturday
6,17,14,31,2017,11,11,Saturday
1,7,27,34,2018,6,26,Tuesday
6,31,3,34,2018,2,10,Saturday
4,6,20,26,2018,1,25,Thursday
1,6,11,17,2017,3,21,Tuesday
2,10,12,22,2017,9,17,Sunday
1,7,26,33,2018,7,5,Thursday
2,3,15,18,2017,12,2,Saturday
11,18,40,58,2017,1,30,Monday
1,2,11,13,2017,10,25,Wednseday
3,7,13,20,2017,8,11,Friday
3,8,23,31,2018,5,14,Monday
1,8,12,20,2017,5,11,Thursday
1,4,9,13,2018,3,1,Thursday
1,7,16,23,2017,8,23,Wednseday
6,8,5,13,2017,8,15,Tuesday
4,21,12,33,2017,2,10,Friday
1,7,21,28,2018,7,4,Wednseday
6,11,8,19,2017,10,19,Thursday
1,5,11,16,2018,1,3,Wednseday
2,9,13,22,2017,8,30,Wednseday
4,10,10,20,2018,7,20,Friday
1,4,14,18,2017,8,27,Sunday
1,12,8,20,2017,10,12,Thursday
3,21,25,46,2018,6,1,Friday
3,44,-11,33,2017,12,3,Sunday
6,7,8,15,2017,8,15,Tuesday
3,4,9,13,2017,7,1,Saturday
7,15,10,25,2018,4,27,Friday
2,12,12,24,2017,6,4,Sunday
2,8,12,20,2017,9,12,Tuesday
8,30,-9,21,2018,7,23,Monday
3,12,11,23,2018,3,11,Sunday
1,8,16,24,2017,5,9,Tuesday
2,5,22,27,2018,6,6,Wednseday
1,13,21,34,2017,12,20,Wednseday
2,4,17,21,2017,11,6,Monday
0,9,20,29,2018,1,2,Tuesday
7,16,20,36,2017,12,11,Monday
1,4,13,17,2018,5,13,Sunday
1,7,15,22,2017,6,26,Monday
4,10,8,18,2018,7,16,Monday
5,19,5,24,2017,11,24,Friday
1,10,14,24,2017,11,21,Tuesday
5,19,2,21,2017,10,20,Friday
4,14,1,15,2018,2,22,Thursday
1,17,9,26,2017,12,17,Sunday
7,13,10,23,2018,1,24,Wednseday
21,35,-14,21,2017,11,24,Friday
3,10,22,32,2018,2,23,Friday
1,8,21,29,2018,8,2,Thursday
1,6,13,19,2018,8,8,Wednseday
3,5,36,41,2018,4,21,Saturday
3,7,24,31,2018,6,22,Friday
2,4,12,16,2018,1,8,Monday
2,16,13,29,2018,2,4,Sunday
5,10,16,26,2017,11,24,Friday
3,16,8,24,2017,10,10,Tuesday
2,12,8,20,2018,7,18,Wednseday
1,13,9,22,2017,10,10,Tuesday
1,2,6,8,2018,8,13,Monday
1,10,21,31,2018,3,12,Monday
7,10,5,15,2018,7,16,Monday
3,9,20,29,2017,2,22,Wednseday
1,4,20,24,2018,7,29,Sunday
1,9,16,25,2018,7,2,Monday
7,14,15,29,2017,9,27,Wednseday
1,11,10,21,2018,5,11,Friday
2,18,8,26,2017,6,17,Saturday
1,8,7,15,2018,8,16,Thursday
1,6,21,27,2017,1,31,Tuesday
5,6,14,20,2018,7,19,Thursday
7,9,12,21,2017,8,21,Monday
1,13,15,28,2018,4,12,Thursday
3,11,14,25,2018,1,5,Friday
2,27,0,27,2018,3,10,Saturday
1,4,10,14,2018,8,13,Monday
1,18,10,28,2017,12,20,Wednseday
1,10,18,28,2017,9,26,Tuesday
5,13,14,27,2017,5,24,Wednseday
3,12,19,31,2018,3,5,Monday
7,10,19,29,2018,7,2,Monday
3,18,9,27,2017,10,20,Friday
8,15,7,22,2017,3,13,Monday
2,13,17,30,2017,8,15,Tuesday
1,3,13,16,2018,2,5,Monday
1,17,-1,16,2017,9,19,Tuesday
1,19,11,30,2017,12,10,Sunday
1,8,22,30,2018,1,9,Tuesday
2,12,8,20,2018,3,21,Wednseday
10,11,7,18,2018,6,1,Friday
11,18,4,22,2018,8,9,Thursday
10,24,2,26,2017,10,27,Friday
13,19,21,40,2017,12,20,Wednseday
2,10,11,21,2017,11,22,Wednseday
4,20,11,31,2017,11,25,Saturday
3,5,8,13,2017,11,18,Saturday
1,2,14,16,2017,12,6,Wednseday
2,10,19,29,2018,4,22,Sunday
1,7,12,19,2018,8,23,Thursday
2,8,12,20,2017,9,13,Wednseday
3,12,0,12,2018,8,3,Friday
5,6,8,14,2017,11,24,Friday
7,20,0,20,2017,10,27,Friday
2,13,9,22,2017,11,28,Tuesday
1,7,8,15,2018,8,8,Wednseday
2,10,16,26,2018,1,13,Saturday
7,8,12,20,2018,6,14,Thursday
1,6,14,20,2017,8,31,Thursday
2,10,27,37,2018,6,13,Wednseday
0,1,11,12,2018,5,16,Wednseday
1,7,2,9,2018,8,21,Tuesday
5,8,5,13,2018,8,1,Wednseday
1,13,7,20,2018,5,22,Tuesday
3,11,19,30,2017,6,25,Sunday
2,9,26,35,2017,2,22,Wednseday
1,8,18,26,2017,11,8,Wednseday
1,2,9,11,2017,8,7,Monday
1,14,25,39,2017,8,17,Thursday
15,22,34,56,2018,1,23,Tuesday
6,14,9,23,2017,7,25,Tuesday
3,9,22,31,2017,2,4,Saturday
2,50,-28,22,2018,4,2,Monday
2,4,12,16,2017,10,3,Tuesday
1,15,11,26,2018,3,8,Thursday
9,20,3,23,2017,5,13,Saturday
1,5,24,29,2018,6,20,Wednseday
1,2,12,14,2018,5,9,Wednseday
4,12,7,19,2017,3,9,Thursday
1,11,14,25,2018,4,12,Thursday
2,11,10,21,2017,6,5,Monday
5,13,12,25,2018,2,9,Friday
4,16,21,37,2017,9,9,Saturday
1,8,20,28,2018,4,25,Wednseday
3,9,17,26,2017,5,7,Sunday
2,11,19,30,2017,9,24,Sunday
3,4,42,46,2018,6,1,Friday
1,7,21,28,2018,7,4,Wednseday
3,7,13,20,2018,4,6,Friday
1,5,18,23,2018,1,28,Sunday
1,10,21,31,2018,5,7,Monday
3,10,13,23,2017,11,4,Saturday
3,4,9,13,2017,5,20,Saturday
1,3,16,19,2018,1,10,Wednseday
3,23,2,25,2018,7,22,Sunday
0,6,15,21,2017,3,10,Friday
1,9,14,23,2018,4,23,Monday
1,10,19,29,2017,6,6,Tuesday
2,17,12,29,2017,12,13,Wednseday
0,10,16,26,2018,4,27,Friday
1,13,1,14,2017,11,29,Wednseday
4,9,17,26,2018,1,21,Sunday
3,12,15,27,2017,6,2,Friday
5,11,13,24,2018,1,27,Saturday
9,10,4,14,2017,11,13,Monday
2,12,-3,9,2018,8,15,Wednseday
1,3,8,11,2018,5,7,Monday
4,7,17,24,2018,1,27,Saturday
3,7,4,11,2018,8,17,Friday
0,11,7,18,2017,10,26,Thursday
3,13,15,28,2018,3,20,Tuesday
1,3,7,10,2018,6,18,Monday
8,9,15,24,2018,5,27,Sunday
6,9,14,23,2018,5,1,Tuesday
1,7,27,34,2018,5,3,Thursday
1,14,19,33,2017,11,16,Thursday
1,53,-23,30,2018,2,26,Monday
1,3,3,6,2018,8,1,Wednseday
2,11,5,16,2018,3,5,Monday
1,5,8,13,2018,3,22,Thursday
1,19,14,33,2018,1,31,Wednseday
1,2,10,12,2017,10,29,Sunday
2,9,20,29,2018,6,24,Sunday
1,2,11,13,2017,10,25,Wednseday
1,10,17,27,2018,6,19,Tuesday
4,10,10,20,2017,10,27,Friday
2,8,6,14,2017,5,22,Monday
3,4,14,18,2018,6,15,Friday
6,32,-4,28,2018,3,1,Thursday
2,16,9,25,2017,10,14,Saturday
6,8,14,22,2018,4,12,Thursday
5,5,10,15,2018,1,18,Thursday
4,9,10,19,2018,3,29,Thursday
3,12,19,31,2017,9,1,Friday
1,2,14,16,2018,1,2,Tuesday
4,15,19,34,2018,2,13,Tuesday
2,3,3,6,2018,8,11,Saturday
5,10,10,20,2017,8,4,Friday
7,8,5,13,2017,7,4,Tuesday
10,31,20,51,2017,11,14,Tuesday
1,25,-3,22,2017,8,8,Tuesday
2,6,15,21,2017,7,26,Wednseday
1,10,17,27,2018,1,23,Tuesday
2,3,8,11,2018,6,10,Sunday
4,9,21,30,2018,7,1,Sunday
6,12,9,21,2017,3,3,Friday
2,11,20,31,2018,1,14,Sunday
2,7,14,21,2018,2,19,Monday
12,17,4,21,2018,1,19,Friday
1,2,10,12,2017,10,18,Wednseday
0,14,22,36,2018,5,28,Monday
2,9,19,28,2017,3,14,Tuesday
1,7,8,15,2017,10,16,Monday
3,5,11,16,2018,8,12,Sunday
7,42,-23,19,2017,11,22,Wednseday
9,12,19,31,2017,11,25,Saturday
2,8,13,21,2017,8,28,Monday
3,16,7,23,2017,6,25,Sunday
4,34,-15,19,2018,3,1,Thursday
1,2,11,13,2018,5,22,Tuesday
6,7,13,20,2017,12,15,Friday
2,7,31,38,2018,4,15,Sunday
4,22,1,23,2017,9,4,Monday
0,10,20,30,2018,1,15,Monday
3,10,17,27,2017,5,6,Saturday
3,6,10,16,2018,2,13,Tuesday
3,7,16,23,2017,10,1,Sunday
6,9,11,20,2017,8,2,Wednseday
1,4,19,23,2018,5,29,Tuesday
2,3,13,16,2018,2,13,Tuesday
4,31,-4,27,2018,2,16,Friday
1,33,-7,26,2017,4,26,Wednseday
3,9,7,16,2018,3,13,Tuesday
2,11,22,33,2018,6,9,Saturday
3,6,8,14,2018,1,26,Friday
1,6,15,21,2017,3,9,Thursday
8,16,9,25,2017,11,5,Sunday
1,43,-13,30,2017,12,25,Monday
4,8,6,14,2017,5,8,Monday
6,9,11,20,2017,2,28,Tuesday
1,5,21,26,2017,3,16,Thursday
1,11,17,28,2017,11,6,Monday
1,8,6,14,2017,10,31,Tuesday
0,7,15,22,2017,6,19,Monday
3,9,14,23,2017,3,12,Sunday
1,4,13,17,2018,5,7,Monday
1,4,14,18,2018,6,7,Thursday
10,25,22,47,2017,4,14,Friday
6,13,8,21,2017,3,2,Thursday
2,16,21,37,2017,2,18,Saturday
1,8,13,21,2017,3,20,Monday
1,2,18,20,2017,12,26,Tuesday
1,2,11,13,2017,8,22,Tuesday
0,7,17,24,2018,6,11,Monday
2,6,16,22,2018,7,25,Wednseday
1,33,0,33,2018,4,4,Wednseday
4,23,8,31,2018,1,6,Saturday
3,21,13,34,2017,4,21,Friday
0,6,16,22,2018,4,17,Tuesday
1,9,28,37,2018,6,27,Wednseday
1,29,1,30,2018,2,21,Wednseday
0,9,24,33,2018,1,17,Wednseday
4,31,-7,24,2018,3,16,Friday
2,12,15,27,2018,6,23,Saturday
3,21,0,21,2018,8,7,Tuesday
5,40,-5,35,2018,1,29,Monday
2,12,11,23,2017,7,9,Sunday
5,20,13,33,2018,1,13,Saturday
3,15,7,22,2017,6,19,Monday
2,15,14,29,2017,12,26,Tuesday
6,14,9,23,2017,4,18,Tuesday
1,16,7,23,2018,1,8,Monday
3,5,8,13,2018,3,23,Friday
1,30,5,35,2017,8,15,Tuesday
33,44,25,69,2018,1,6,Saturday
2,13,35,48,2018,5,26,Saturday
1,4,8,12,2018,3,15,Thursday
4,12,10,22,2017,11,6,Monday
5,21,1,22,2018,3,22,Thursday
0,5,19,24,2018,4,27,Friday
3,10,17,27,2018,3,10,Saturday
2,15,14,29,2018,7,24,Tuesday
4,6,12,18,2018,7,27,Friday
3,5,8,13,2018,6,8,Friday
3,8,16,24,2017,8,11,Friday
2,17,7,24,2018,2,24,Saturday
3,4,4,8,2018,8,20,Monday
2,9,15,24,2017,6,24,Saturday
10,16,7,23,2017,10,9,Monday
2,8,13,21,2017,4,4,Tuesday
8,32,12,44,2018,6,4,Monday
7,8,5,13,2017,5,17,Wednseday
1,7,13,20,2018,3,21,Wednseday
3,4,3,7,2018,8,3,Friday
3,11,11,22,2018,7,10,Tuesday
6,10,21,31,2018,6,26,Tuesday
7,19,12,31,2017,11,17,Friday
10,50,-20,30,2017,11,19,Sunday
2,12,8,20,2017,11,8,Wednseday
2,8,18,26,2018,8,22,Wednseday
2,17,12,29,2017,2,14,Tuesday
2,8,6,14,2018,8,15,Wednseday
5,13,18,31,2018,4,28,Saturday
2,10,12,22,2017,7,11,Tuesday
3,10,23,33,2017,9,29,Friday
5,12,19,31,2018,1,19,Friday
7,8,41,49,2018,5,28,Monday
7,24,10,34,2018,1,3,Wednseday
2,11,24,35,2018,1,15,Monday
0,5,19,24,2018,5,4,Friday
4,23,10,33,2018,5,17,Thursday
1,6,14,20,2017,11,7,Tuesday
6,18,9,27,2018,2,16,Friday
22,47,-18,29,2018,1,10,Wednseday
1,12,29,41,2018,7,12,Thursday
1,14,8,22,2017,5,1,Monday
6,19,12,31,2017,4,11,Tuesday
0,1,10,11,2017,7,31,Monday
1,6,11,17,2018,8,7,Tuesday
7,22,9,31,2018,1,15,Monday
2,3,3,6,2018,8,18,Saturday
8,13,16,29,2017,2,23,Thursday
1,6,14,20,2017,8,10,Thursday
2,6,8,14,2018,8,22,Wednseday
1,15,10,25,2017,11,27,Monday
25,32,-5,27,2018,3,2,Friday
2,17,7,24,2017,11,27,Monday
3,18,23,41,2018,6,2,Saturday
1,3,15,18,2017,9,3,Sunday
1,7,14,21,2018,7,16,Monday
3,9,18,27,2018,1,20,Saturday
1,14,14,28,2018,1,25,Thursday
4,15,13,28,2018,2,5,Monday
4,18,35,53,2018,1,13,Saturday
5,8,25,33,2017,5,18,Thursday
2,5,42,47,2017,1,29,Sunday
1,3,15,18,2018,2,1,Thursday
5,12,24,36,2018,6,21,Thursday
5,8,28,36,2018,6,21,Thursday
1,9,15,24,2018,7,2,Monday
4,13,15,28,2018,1,4,Thursday
1,6,4,10,2018,8,14,Tuesday
2,18,12,30,2018,4,15,Sunday
3,6,7,13,2018,3,30,Friday
1,12,21,33,2017,7,16,Sunday
2,3,14,17,2018,4,21,Saturday
1,2,24,26,2018,1,3,Wednseday
4,18,4,22,2017,10,26,Thursday
2,5,13,18,2018,2,1,Thursday
2,7,13,20,2017,8,5,Saturday
1,9,30,39,2017,6,25,Sunday
7,10,7,17,2018,7,23,Monday
2,3,10,13,2017,8,15,Tuesday
4,15,8,23,2017,11,26,Sunday
34,40,-14,26,2018,1,24,Wednseday
1,10,41,51,2018,5,29,Tuesday
2,12,8,20,2017,10,25,Wednseday
0,14,6,20,2018,3,27,Tuesday
6,7,19,26,2017,11,24,Friday
1,8,21,29,2018,4,9,Monday
1,8,21,29,2017,12,6,Wednseday
3,13,11,24,2017,11,24,Friday
2,11,18,29,2017,10,23,Monday
18,26,1,27,2017,10,5,Thursday
19,29,-6,23,2018,7,29,Sunday
6,13,20,33,2017,9,6,Wednseday
1,5,7,12,2018,8,15,Wednseday
1,31,-6,25,2017,11,27,Monday
1,2,6,8,2018,5,16,Wednseday
7,15,4,19,2017,10,11,Wednseday
1,23,6,29,2018,4,4,Wednseday
1,2,14,16,2017,12,6,Wednseday
5,18,3,21,2018,3,2,Friday
6,7,12,19,2018,6,27,Wednseday
5,18,16,34,2018,2,2,Friday
1,5,18,23,2018,7,29,Sunday
12,14,20,34,2017,2,9,Thursday
0,4,19,23,2018,6,11,Monday
13,28,8,36,2017,12,7,Thursday
4,9,15,24,2017,10,7,Saturday
6,16,15,31,2018,6,19,Tuesday
1,6,3,9,2018,8,21,Tuesday
3,24,8,32,2017,7,14,Friday
7,18,6,24,2017,9,8,Friday
2,15,18,33,2018,4,22,Sunday
6,11,13,24,2017,7,7,Friday
2,32,-4,28,2018,3,1,Thursday
1,2,7,9,2018,6,12,Tuesday
6,15,22,37,2018,5,29,Tuesday
2,24,5,29,2018,3,14,Wednseday
1,58,-35,23,2018,2,28,Wednseday
1,8,11,19,2018,8,2,Thursday
1,7,15,22,2017,7,26,Wednseday
2,12,14,26,2018,3,21,Wednseday
2,3,7,10,2018,5,19,Saturday
3,26,15,41,2018,1,19,Friday
1,9,22,31,2018,1,15,Monday
1,8,15,23,2018,4,17,Tuesday
3,22,5,27,2017,2,28,Tuesday
4,9,10,19,2018,7,26,Thursday
4,6,18,24,2017,9,22,Friday
1,4,19,23,2018,5,7,Monday
5,8,21,29,2018,5,3,Thursday
4,6,8,14,2018,3,30,Friday
3,6,10,16,2017,11,25,Saturday
3,6,7,13,2017,9,5,Tuesday
5,14,-1,13,2018,8,1,Wednseday
1,11,21,32,2017,4,6,Thursday
1,20,20,40,2018,3,14,Wednseday
4,14,14,28,2017,7,6,Thursday
1,9,21,30,2018,6,27,Wednseday
1,21,14,35,2017,11,23,Thursday
2,7,7,14,2018,8,14,Tuesday
2,3,8,11,2017,5,29,Monday
1,6,23,29,2017,10,5,Thursday
4,7,11,18,2018,3,19,Monday
1,18,3,21,2018,2,26,Monday
3,16,9,25,2017,12,4,Monday
4,19,6,25,2018,7,6,Friday
1,8,14,22,2017,7,3,Monday
3,11,18,29,2017,7,2,Sunday
0,3,8,11,2017,7,31,Monday
4,7,21,28,2017,5,5,Friday
0,2,7,9,2018,6,11,Monday
2,5,25,30,2018,5,19,Saturday
0,5,20,25,2018,3,22,Thursday
1,4,14,18,2018,6,7,Thursday
1,5,15,20,2018,2,15,Thursday
2,16,11,27,2017,9,19,Tuesday
6,11,9,20,2018,7,19,Thursday
1,6,12,18,2018,7,26,Thursday
1,7,11,18,2018,7,19,Thursday
5,11,21,32,2018,7,26,Thursday
4,5,9,14,2018,6,14,Thursday
2,21,-2,19,2018,3,8,Thursday
4,12,12,24,2018,2,2,Friday
3,14,7,21,2017,3,3,Friday
2,18,7,25,2017,5,29,Monday
0,2,12,14,2017,11,24,Friday
1,9,16,25,2017,4,9,Sunday
1,10,32,42,2017,1,23,Monday
1,13,21,34,2018,3,20,Tuesday
5,20,13,33,2017,12,14,Thursday
9,20,14,34,2017,11,14,Tuesday
1,7,10,17,2017,10,24,Tuesday
6,13,16,29,2018,1,4,Thursday
1,20,11,31,2017,6,13,Tuesday
4,21,-2,19,2018,5,18,Friday
1,4,23,27,2017,11,30,Thursday
3,12,12,24,2017,11,5,Sunday
5,13,32,45,2017,2,10,Friday
1,10,8,18,2018,2,19,Monday
1,10,14,24,2018,6,5,Tuesday
4,10,15,25,2017,9,4,Monday
4,25,9,34,2018,3,9,Friday
4,8,28,36,2018,4,12,Thursday
3,11,15,26,2018,5,4,Friday
3,11,19,30,2017,12,3,Sunday
0,4,10,14,2017,11,24,Friday
1,8,6,14,2018,8,8,Wednseday
18,35,-1,34,2017,4,7,Friday
4,12,17,29,2018,5,13,Sunday
1,7,20,27,2017,11,7,Tuesday
2,9,15,24,2017,12,26,Tuesday
8,23,-1,22,2017,4,19,Wednseday
3,13,11,24,2017,6,30,Friday
1,11,12,23,2018,1,16,Tuesday
5,9,18,27,2018,7,4,Wednseday
1,4,15,19,2018,8,12,Sunday
1,10,20,30,2017,5,23,Tuesday
5,6,21,27,2018,4,6,Friday
7,14,11,25,2018,7,23,Monday
4,32,3,35,2018,3,9,Friday
4,5,7,12,2017,7,2,Sunday
2,10,26,36,2018,7,1,Sunday
2,23,1,24,2017,7,22,Saturday
2,9,13,22,2017,7,4,Tuesday
3,19,5,24,2018,1,7,Sunday
8,17,5,22,2017,5,16,Tuesday
2,7,13,20,2018,2,17,Saturday
2,5,9,14,2017,6,14,Wednseday
2,23,-2,21,2017,11,27,Monday
4,10,5,15,2018,1,25,Thursday
1,4,11,15,2018,1,22,Monday
1,14,20,34,2017,12,5,Tuesday
8,14,15,29,2018,2,1,Thursday
1,11,22,33,2018,6,24,Sunday
2,5,10,15,2018,6,20,Wednseday
9,18,12,30,2018,8,11,Saturday
4,17,7,24,2017,11,17,Friday
1,2,6,8,2018,8,8,Wednseday
1,23,4,27,2017,5,30,Tuesday
4,12,6,18,2018,8,9,Thursday
11,13,6,19,2018,5,19,Saturday
3,16,15,31,2018,1,21,Sunday
1,7,22,29,2017,4,4,Tuesday
1,2,12,14,2017,7,10,Monday
3,12,13,25,2018,1,27,Saturday
1,29,1,30,2018,4,11,Wednseday
2,4,14,18,2018,4,30,Monday
2,17,16,33,2017,4,22,Saturday
7,16,15,31,2017,4,25,Tuesday
2,21,7,28,2017,9,19,Tuesday
6,12,14,26,2017,9,14,Thursday
3,6,5,11,2017,11,20,Monday
5,11,24,35,2018,6,15,Friday
1,17,0,17,2018,5,15,Tuesday
10,22,13,35,2017,5,9,Tuesday
6,23,1,24,2017,7,8,Saturday
4,22,12,34,2017,6,29,Thursday
1,3,23,26,2017,2,12,Sunday
2,4,27,31,2018,5,20,Sunday
4,13,21,34,2018,1,11,Thursday
3,7,25,32,2018,7,6,Friday
5,18,15,33,2017,11,24,Friday
13,21,1,22,2018,2,27,Tuesday
9,16,21,37,2017,9,2,Saturday
3,9,10,19,2017,11,19,Sunday
2,9,14,23,2017,9,16,Saturday
1,6,15,21,2017,6,13,Tuesday
15,16,-7,9,2018,7,23,Monday
5,18,-7,11,2018,8,9,Thursday
1,8,15,23,2017,3,8,Wednseday
20,29,-6,23,2018,1,10,Wednseday
1,5,14,19,2018,5,13,Sunday
15,24,12,36,2017,10,24,Tuesday
3,10,12,22,2018,1,14,Sunday
1,13,20,33,2017,6,8,Thursday
3,8,12,20,2017,11,24,Friday
2,6,4,10,2018,8,14,Tuesday
1,17,21,38,2018,4,17,Tuesday
3,18,3,21,2017,11,13,Monday
0,7,15,22,2017,8,10,Thursday
2,8,13,21,2018,8,22,Wednseday
1,11,11,22,2017,5,18,Thursday
2,13,10,23,2017,12,6,Wednseday
5,11,14,25,2018,6,22,Friday
2,24,3,27,2018,2,13,Tuesday
2,26,-4,22,2018,5,16,Wednseday
1,6,21,27,2018,5,1,Tuesday
2,4,13,17,2017,9,10,Sunday
1,7,20,27,2017,8,24,Thursday
2,10,30,40,2018,6,2,Saturday
3,8,15,23,2017,5,29,Monday
5,6,6,12,2018,3,2,Friday
2,22,-3,19,2018,4,1,Sunday
1,3,9,12,2018,6,17,Sunday
2,3,4,7,2018,7,31,Tuesday
3,5,1,6,2018,8,17,Friday
2,5,18,23,2017,7,16,Sunday
5,15,6,21,2017,11,29,Wednseday
8,34,-14,20,2018,3,1,Thursday
3,20,-4,16,2018,3,6,Tuesday
5,6,7,13,2017,10,12,Thursday
4,18,7,25,2018,2,16,Friday
2,16,11,27,2018,1,24,Wednseday
2,17,5,22,2017,7,18,Tuesday
1,8,21,29,2018,8,21,Tuesday
2,9,18,27,2018,7,3,Tuesday
0,8,11,19,2018,7,18,Wednseday
1,19,3,22,2018,3,22,Thursday
2,14,15,29,2017,2,22,Wednseday
1,7,15,22,2018,1,9,Tuesday
1,10,13,23,2017,11,8,Wednseday
3,6,14,20,2017,8,11,Friday
2,13,20,33,2018,1,17,Wednseday
1,9,11,20,2018,5,8,Tuesday
19,26,29,55,2016,10,5,Wednseday
0,7,21,28,2018,6,15,Friday
2,7,15,22,2018,6,12,Tuesday
5,16,5,21,2017,10,18,Wednseday
2,13,11,24,2018,7,28,Saturday
2,9,15,24,2017,6,24,Saturday
0,16,2,18,2018,5,21,Monday
1,17,11,28,2017,10,31,Tuesday
1,15,13,28,2018,1,8,Monday
4,10,13,23,2018,8,5,Sunday
2,25,8,33,2018,3,4,Sunday
1,20,16,36,2017,10,18,Wednseday
40,49,-24,25,2017,11,25,Saturday
13,32,1,33,2018,2,15,Thursday
0,8,10,18,2018,2,19,Monday
0,10,16,26,2018,8,10,Friday
21,42,-15,27,2017,9,26,Tuesday
1,12,18,30,2018,1,17,Wednseday
1,7,9,16,2018,4,9,Monday
2,8,17,25,2017,7,30,Sunday
2,4,22,26,2018,3,18,Sunday
3,14,14,28,2017,3,6,Monday
3,41,-16,25,2018,3,4,Sunday
0,3,16,19,2018,5,25,Friday
1,2,9,11,2018,3,26,Monday
1,7,11,18,2017,11,20,Monday
2,20,6,26,2018,1,3,Wednseday
4,6,19,25,2018,6,16,Saturday
7,12,25,37,2017,12,6,Wednseday
1,7,12,19,2018,3,22,Thursday
4,10,9,19,2017,11,30,Thursday
7,22,5,27,2018,4,17,Tuesday
3,30,-1,29,2018,1,8,Monday
0,5,30,35,2018,6,8,Friday
3,10,13,23,2017,11,25,Saturday
4,34,-5,29,2018,1,18,Thursday
1,18,6,24,2018,1,30,Tuesday
1,2,24,26,2017,7,26,Wednseday
1,7,14,21,2018,6,13,Wednseday
2,8,16,24,2017,7,11,Tuesday
6,13,20,33,2018,1,12,Friday
4,18,13,31,2017,11,10,Friday
8,24,7,31,2018,3,26,Monday
1,8,20,28,2018,1,5,Friday
8,21,23,44,2017,9,20,Wednseday
3,4,8,12,2018,4,15,Sunday
0,7,20,27,2017,8,1,Tuesday
11,20,12,32,2017,9,2,Saturday
1,2,14,16,2018,1,8,Monday
1,7,42,49,2017,2,2,Thursday
2,8,20,28,2017,10,17,Tuesday
3,12,21,33,2017,8,25,Friday
2,22,8,30,2018,1,24,Wednseday
3,12,14,26,2017,10,6,Friday
1,15,11,26,2017,3,8,Wednseday
3,11,16,27,2017,10,28,Saturday
2,7,17,24,2018,7,31,Tuesday
2,9,2,11,2018,3,11,Sunday
5,10,12,22,2018,8,12,Sunday
8,10,11,21,2017,11,28,Tuesday
3,11,10,21,2017,3,10,Friday
2,12,14,26,2018,1,10,Wednseday
1,13,12,25,2018,2,15,Thursday
2,9,7,16,2017,6,10,Saturday
16,24,5,29,2017,10,1,Sunday
1,18,15,33,2018,3,15,Thursday
3,13,8,21,2018,7,13,Friday
5,28,2,30,2018,1,24,Wednseday
3,4,6,10,2018,7,20,Friday
1,3,19,22,2018,7,4,Wednseday
2,7,20,27,2018,2,17,Saturday
7,9,4,13,2017,5,17,Wednseday
13,23,10,33,2017,10,21,Saturday
1,7,8,15,2018,8,9,Thursday
3,18,8,26,2018,5,18,Friday
5,26,7,33,2018,3,3,Saturday
1,13,20,33,2017,12,7,Thursday
15,29,17,46,2018,2,5,Monday
4,26,7,33,2018,5,12,Saturday
2,13,13,26,2017,7,12,Wednseday
6,12,2,14,2017,8,25,Friday
2,7,9,16,2018,7,18,Wednseday
0,18,3,21,2017,4,24,Monday
3,7,9,16,2018,1,2,Tuesday
1,3,14,17,2017,10,3,Tuesday
0,30,0,30,2017,11,14,Tuesday
3,8,3,11,2018,8,10,Friday
1,16,6,22,2018,3,21,Wednseday
0,6,27,33,2018,8,9,Thursday
3,21,8,29,2018,2,27,Tuesday
7,8,12,20,2017,12,20,Wednseday
10,15,6,21,2017,6,6,Tuesday
0,16,14,30,2018,1,17,Wednseday
1,23,7,30,2018,4,9,Monday
5,6,15,21,2018,1,5,Friday
3,12,15,27,2018,1,19,Friday
1,14,13,27,2018,2,7,Wednseday
6,15,20,35,2018,6,28,Thursday
3,10,14,24,2018,4,15,Sunday
4,8,9,17,2018,1,1,Monday
7,30,5,35,2018,1,16,Tuesday
2,14,16,30,2018,1,15,Monday
0,14,0,14,2018,5,22,Tuesday
2,5,12,17,2018,7,21,Saturday
4,13,13,26,2017,5,5,Friday
0,14,7,21,2017,9,13,Wednseday
6,18,11,29,2018,1,7,Sunday
5,9,36,45,2018,6,16,Saturday
5,14,8,22,2018,2,22,Thursday
1,2,3,5,2018,8,15,Wednseday
4,6,22,28,2018,6,21,Thursday
5,6,14,20,2017,12,15,Friday
1,10,8,18,2017,9,17,Sunday
6,9,21,30,2017,10,18,Wednseday
3,14,14,28,2017,5,12,Friday
1,2,12,14,2018,7,4,Wednseday
1,3,14,17,2018,7,3,Tuesday
8,9,5,14,2018,2,22,Thursday
3,10,22,32,2017,12,3,Sunday
2,6,10,16,2017,12,4,Monday
1,12,20,32,2018,4,27,Friday
4,24,7,31,2017,12,15,Friday
5,6,7,13,2017,7,5,Wednseday
1,4,14,18,2017,9,21,Thursday
1,3,1,4,2018,8,5,Sunday
1,14,8,22,2017,10,31,Tuesday
3,33,-10,23,2018,3,17,Saturday
1,8,26,34,2018,4,17,Tuesday
3,11,6,17,2017,10,23,Monday
3,14,18,32,2018,1,19,Friday
5,7,11,18,2017,11,24,Friday
0,8,28,36,2017,8,3,Thursday
5,5,11,16,2018,1,14,Sunday
7,17,11,28,2017,11,15,Wednseday
2,6,11,17,2017,8,29,Tuesday
4,20,2,22,2017,11,30,Thursday
3,26,8,34,2018,6,8,Friday
1,20,12,32,2017,9,24,Sunday
5,16,10,26,2018,1,10,Wednseday
4,11,11,22,2017,11,23,Thursday
3,4,13,17,2018,1,19,Friday
0,5,12,17,2017,10,23,Monday
1,2,7,9,2018,8,22,Wednseday
3,24,14,38,2018,2,12,Monday
2,5,0,5,2018,8,15,Wednseday
1,6,28,34,2018,6,27,Wednseday
1,8,5,13,2018,8,7,Tuesday
0,1,11,12,2018,6,13,Wednseday
1,11,30,41,2018,6,7,Thursday
1,2,12,14,2018,4,25,Wednseday
1,6,16,22,2017,10,19,Thursday
3,19,10,29,2018,2,21,Wednseday
1,5,3,8,2018,7,25,Wednseday
1,9,3,12,2018,3,8,Thursday
7,14,11,25,2017,11,9,Thursday
0,5,16,21,2018,6,13,Wednseday
0,11,9,20,2017,11,9,Thursday
0,17,7,24,2017,8,11,Friday
5,8,4,12,2018,8,8,Wednseday
0,5,22,27,2018,3,8,Thursday
6,11,28,39,2017,1,5,Thursday
3,6,18,24,2017,6,23,Friday
1,15,22,37,2018,5,27,Sunday
4,27,6,33,2017,11,24,Friday
9,11,8,19,2017,11,18,Saturday
2,9,12,21,2018,7,24,Tuesday
2,9,9,18,2018,5,12,Saturday
1,6,21,27,2018,6,20,Wednseday
1,6,9,15,2018,5,15,Tuesday
1,10,14,24,2018,3,26,Monday
11,17,19,36,2018,3,4,Sunday
1,6,16,22,2018,6,12,Tuesday
4,7,23,30,2018,3,17,Saturday
2,13,23,36,2018,7,22,Sunday
1,16,9,25,2017,10,9,Monday
2,3,6,9,2018,8,25,Saturday
0,6,47,53,2017,2,3,Friday
8,14,22,36,2018,4,11,Wednseday
4,14,57,71,2017,12,4,Monday
13,19,2,21,2017,5,4,Thursday
6,13,-8,5,2018,8,4,Saturday
1,10,10,20,2018,2,20,Tuesday
4,11,15,26,2018,3,15,Thursday
1,3,13,16,2017,12,6,Wednseday
3,9,8,17,2018,7,24,Tuesday
2,4,7,11,2018,6,18,Monday
1,12,15,27,2018,2,8,Thursday
9,24,8,32,2017,4,16,Sunday
1,12,10,22,2017,7,5,Wednseday
9,12,19,31,2017,11,25,Saturday
4,12,28,40,2018,6,1,Friday
1,33,0,33,2018,3,1,Thursday
2,13,7,20,2017,11,21,Tuesday
0,6,16,22,2017,3,8,Wednseday
3,10,19,29,2018,2,25,Sunday
4,11,28,39,2018,6,8,Friday
2,8,3,11,2018,8,6,Monday
1,9,13,22,2018,6,26,Tuesday
1,6,10,16,2018,5,9,Wednseday
5,15,12,27,2017,3,1,Wednseday
3,40,-9,31,2017,12,8,Friday
2,6,8,14,2018,6,19,Tuesday
5,12,20,32,2017,7,30,Sunday
2,6,12,18,2018,3,8,Thursday
13,16,29,45,2018,6,5,Tuesday
4,14,15,29,2017,12,4,Monday
6,11,5,16,2018,7,14,Saturday
2,11,26,37,2018,2,3,Saturday
0,3,11,14,2018,5,15,Tuesday
2,24,4,28,2017,4,18,Tuesday
3,4,9,13,2018,3,23,Friday
6,14,13,27,2017,7,18,Tuesday
3,12,12,24,2018,3,23,Friday
2,9,13,22,2018,4,2,Monday
4,21,13,34,2017,7,25,Tuesday
6,27,-1,26,2018,1,14,Sunday
3,9,18,27,2017,2,7,Tuesday
1,6,35,41,2018,6,6,Wednseday
3,8,11,19,2017,10,8,Sunday
3,10,14,24,2018,8,10,Friday
2,10,6,16,2018,1,21,Sunday
5,15,19,34,2018,1,31,Wednseday
2,9,15,24,2018,5,13,Sunday
7,12,8,20,2017,11,24,Friday
5,12,7,19,2017,10,26,Thursday
0,2,11,13,2018,7,18,Wednseday
3,6,7,13,2017,8,18,Friday
1,7,16,23,2017,11,7,Tuesday
1,13,14,27,2018,7,26,Thursday
1,3,14,17,2017,3,27,Monday
1,22,9,31,2018,3,13,Tuesday
1,11,15,26,2018,5,10,Thursday
1,6,17,23,2017,6,6,Tuesday
2,6,16,22,2017,4,5,Wednseday
4,16,8,24,2018,1,14,Sunday
2,7,24,31,2017,4,25,Tuesday
1,10,11,21,2017,4,24,Monday
15,17,-2,15,2018,2,18,Sunday
2,46,-17,29,2018,3,27,Tuesday
1,10,14,24,2018,4,23,Monday
55,71,-27,44,2017,1,25,Wednseday
11,27,29,56,2017,8,10,Thursday
5,25,-1,24,2018,3,16,Friday
1,2,6,8,2018,5,7,Monday
2,9,14,23,2017,10,25,Wednseday
7,35,-4,31,2018,5,7,Monday
6,10,7,17,2018,3,31,Saturday
4,10,10,20,2017,7,7,Friday
4,13,32,45,2017,4,7,Friday
2,8,13,21,2018,5,7,Monday
4,8,20,28,2017,11,23,Thursday
1,10,14,24,2018,2,20,Tuesday
15,16,20,36,2017,3,28,Tuesday
2,2,14,16,2018,1,31,Wednseday
1,11,7,18,2017,10,30,Monday
0,7,24,31,2018,4,9,Monday
3,13,18,31,2017,2,11,Saturday
1,21,-6,15,2018,2,15,Thursday
2,9,10,19,2017,3,1,Wednseday
6,14,15,29,2017,6,13,Tuesday
2,13,12,25,2017,11,20,Monday
6,9,6,15,2018,6,19,Tuesday
1,13,17,30,2017,5,10,Wednseday
3,10,10,20,2018,8,17,Friday
7,26,0,26,2018,1,19,Friday
3,4,13,17,2018,1,7,Sunday
2,13,17,30,2018,4,28,Saturday
0,1,12,13,2018,7,19,Thursday
2,5,18,23,2018,6,30,Saturday
3,10,15,25,2017,11,24,Friday
0,11,9,20,2017,7,6,Thursday
1,3,12,15,2018,6,19,Tuesday
9,10,5,15,2018,1,22,Monday
2,35,2,37,2018,1,15,Monday
1,22,14,36,2017,11,30,Thursday
4,18,0,18,2018,5,20,Sunday
5,12,2,14,2018,6,28,Thursday
4,16,9,25,2018,1,21,Sunday
0,5,16,21,2017,2,24,Friday
2,8,11,19,2017,5,21,Sunday
6,8,-1,7,2018,8,8,Wednseday
3,4,14,18,2018,6,15,Friday
7,27,7,34,2018,1,23,Tuesday
3,22,11,33,2017,10,20,Friday
4,9,16,25,2018,4,19,Thursday
1,2,11,13,2017,10,24,Tuesday
4,6,8,14,2018,1,26,Friday
1,9,19,28,2018,1,10,Wednseday
1,3,9,12,2017,6,18,Sunday
3,4,9,13,2018,6,22,Friday
4,11,22,33,2017,12,31,Sunday
0,4,16,20,2018,6,15,Friday
1,7,18,25,2018,4,9,Monday
5,29,-1,28,2017,12,14,Thursday
2,3,14,17,2018,1,2,Tuesday
5,6,11,17,2018,4,28,Saturday
1,10,18,28,2018,2,22,Thursday
2,14,28,42,2017,6,27,Tuesday
4,19,6,25,2017,3,12,Sunday
2,8,15,23,2018,6,18,Monday
2,8,5,13,2018,3,27,Tuesday
6,7,11,18,2018,6,28,Thursday
4,11,2,13,2017,9,7,Thursday
3,46,-8,38,2018,6,8,Friday
3,6,18,24,2018,6,29,Friday
2,11,11,22,2017,7,24,Monday
3,17,6,23,2018,1,15,Monday
3,10,14,24,2017,8,11,Friday
3,10,12,22,2017,5,22,Monday
4,8,0,8,2018,8,13,Monday
3,21,4,25,2018,5,19,Saturday
3,8,2,10,2017,11,21,Tuesday
17,44,-4,40,2017,4,8,Saturday
2,59,-37,22,2018,3,14,Wednseday
3,10,21,31,2018,7,20,Friday
4,6,1,7,2018,8,9,Thursday
5,14,12,26,2017,4,19,Wednseday
5,11,17,28,2018,3,1,Thursday
5,13,6,19,2017,9,13,Wednseday
1,8,10,18,2017,10,22,Sunday
10,15,2,17,2017,5,14,Sunday
1,3,14,17,2017,3,27,Monday
1,2,7,9,2018,7,9,Monday
1,28,-7,21,2018,2,22,Thursday
4,12,18,30,2017,8,27,Sunday
10,38,2,40,2017,10,21,Saturday
1,13,10,23,2018,4,10,Tuesday
3,32,-8,24,2018,1,16,Tuesday
3,3,7,10,2018,4,2,Monday
3,9,21,30,2017,12,3,Sunday
2,7,14,21,2018,7,31,Tuesday
1,16,15,31,2017,12,11,Monday
3,22,6,28,2018,2,27,Tuesday
3,14,24,38,2018,2,2,Friday
1,2,3,5,2018,8,22,Wednseday
2,6,6,12,2018,8,8,Wednseday
1,8,17,25,2017,11,2,Thursday
6,17,17,34,2018,1,31,Wednseday
1,10,16,26,2017,12,27,Wednseday
3,13,18,31,2017,6,23,Friday
3,9,18,27,2018,6,30,Saturday
3,24,5,29,2018,2,5,Monday
3,5,25,30,2018,6,30,Saturday
1,14,8,22,2017,9,13,Wednseday
2,4,26,30,2018,3,3,Saturday
6,9,7,16,2017,9,19,Tuesday
2,10,21,31,2018,4,15,Sunday
5,23,6,29,2018,3,11,Sunday
2,5,11,16,2018,7,25,Wednseday
1,8,16,24,2017,9,24,Sunday
2,6,34,40,2018,6,27,Wednseday
1,6,15,21,2017,9,13,Wednseday
3,27,-3,24,2017,7,4,Tuesday
4,10,38,48,2018,6,8,Friday
3,13,12,25,2017,8,18,Friday
2,15,16,31,2018,7,31,Tuesday
3,5,19,24,2017,12,15,Friday
4,11,14,25,2018,2,10,Saturday
1,4,7,11,2017,10,9,Monday
0,12,9,21,2018,4,9,Monday
0,23,1,24,2018,1,15,Monday
6,11,18,29,2018,1,9,Tuesday
1,2,8,10,2018,5,20,Sunday
13,29,10,39,2017,12,8,Friday
2,25,0,25,2017,4,15,Saturday
6,15,7,22,2017,4,18,Tuesday
3,5,14,19,2017,3,17,Friday
3,6,19,25,2017,12,2,Saturday
3,5,11,16,2018,2,5,Monday
1,9,25,34,2018,1,3,Wednseday
1,3,11,14,2018,5,1,Tuesday
2,12,27,39,2018,6,2,Saturday
1,14,9,23,2017,6,13,Tuesday
3,10,15,25,2018,4,13,Friday
1,6,21,27,2017,3,29,Wednseday
1,2,6,8,2018,7,10,Tuesday
2,14,27,41,2017,2,7,Tuesday
4,9,24,33,2018,2,22,Thursday
2,4,7,11,2017,8,7,Monday
4,10,10,20,2017,11,10,Friday
3,5,6,11,2018,6,9,Saturday
3,5,14,19,2018,4,14,Saturday
0,16,21,37,2017,4,12,Wednseday
3,4,9,13,2017,5,19,Friday
0,17,22,39,2017,5,5,Friday
4,23,4,27,2017,9,21,Thursday
1,7,17,24,2017,12,4,Monday
1,11,18,29,2018,8,16,Thursday
3,10,8,18,2018,7,20,Friday
2,11,12,23,2017,10,14,Saturday
13,20,35,55,2017,4,26,Wednseday
3,23,2,25,2018,3,12,Monday
10,14,12,26,2018,1,5,Friday
2,10,8,18,2018,3,25,Sunday
2,12,8,20,2017,5,17,Wednseday
2,8,28,36,2018,3,19,Monday
0,6,18,24,2017,5,19,Friday
1,8,12,20,2018,3,8,Thursday
3,14,20,34,2018,1,2,Tuesday
2,6,18,24,2017,8,12,Saturday
2,15,11,26,2017,12,13,Wednseday
1,6,7,13,2018,8,2,Thursday
2,5,17,22,2017,10,22,Sunday
0,16,4,20,2018,4,3,Tuesday
4,23,12,35,2017,8,24,Thursday
2,7,18,25,2017,5,27,Saturday
1,2,8,10,2018,4,2,Monday
4,11,1,12,2018,8,3,Friday
1,6,16,22,2018,7,3,Tuesday
4,11,14,25,2017,11,25,Saturday
5,7,7,14,2017,10,12,Thursday
15,27,-7,20,2017,11,23,Thursday
5,6,7,13,2017,5,25,Thursday
1,11,24,35,2018,1,29,Monday
4,12,27,39,2017,1,26,Thursday
3,25,6,31,2017,12,2,Saturday
12,13,19,32,2018,5,12,Saturday
2,7,17,24,2018,6,26,Tuesday
0,17,9,26,2017,9,8,Friday
3,6,19,25,2018,6,22,Friday
2,14,10,24,2017,3,27,Monday
4,10,22,32,2017,8,18,Friday
5,11,14,25,2017,9,1,Friday
13,19,20,39,2018,5,19,Saturday
5,7,13,20,2017,12,28,Thursday
7,19,3,22,2018,5,2,Wednseday
2,23,3,26,2018,2,25,Sunday
7,13,8,21,2017,11,22,Wednseday
5,7,9,16,2018,5,2,Wednseday
0,1,14,15,2017,9,25,Monday
2,7,12,19,2017,10,18,Wednseday
1,4,11,15,2018,1,25,Thursday
2,14,8,22,2017,11,27,Monday
2,9,25,34,2017,5,30,Tuesday
2,4,14,18,2017,3,20,Monday
2,8,16,24,2017,5,29,Monday
2,5,20,25,2018,3,22,Thursday
2,9,8,17,2018,7,22,Sunday
1,16,10,26,2017,11,22,Wednseday
2,7,1,8,2018,2,14,Wednseday
0,7,16,23,2018,7,24,Tuesday
6,9,44,53,2016,10,6,Thursday
6,12,10,22,2017,7,27,Thursday
2,8,8,16,2018,8,7,Tuesday
2,8,8,16,2017,11,22,Wednseday
1,2,10,12,2018,5,23,Wednseday
2,9,13,22,2018,5,1,Tuesday
4,7,18,25,2017,11,24,Friday
0,4,20,24,2018,4,16,Monday
2,9,14,23,2018,1,15,Monday
2,18,10,28,2018,3,5,Monday
4,26,-3,23,2018,2,11,Sunday
3,8,12,20,2018,8,10,Friday
4,8,19,27,2017,3,23,Thursday
14,18,16,34,2017,4,28,Friday
1,26,8,34,2017,12,21,Thursday
3,12,12,24,2018,1,26,Friday
5,9,15,24,2017,7,22,Saturday
0,4,17,21,2018,2,16,Friday
2,33,-2,31,2017,12,2,Saturday
2,15,2,17,2018,4,24,Tuesday
3,11,8,19,2017,11,19,Sunday
2,9,4,13,2018,8,18,Saturday
6,20,1,21,2017,9,5,Tuesday
6,11,8,19,2017,3,9,Thursday
0,8,18,26,2018,7,25,Wednseday
5,24,15,39,2017,3,18,Saturday
1,11,20,31,2017,4,9,Sunday
3,20,8,28,2017,11,24,Friday
1,9,6,15,2018,8,21,Tuesday
1,4,11,15,2018,2,15,Thursday
6,15,21,36,2018,1,24,Wednseday
1,6,6,12,2018,8,9,Thursday
1,2,8,10,2018,4,2,Monday
1,10,14,24,2018,7,3,Tuesday
2,12,10,22,2017,5,10,Wednseday
1,7,16,23,2017,5,31,Wednseday
1,6,14,20,2017,10,24,Tuesday
0,16,15,31,2018,1,16,Tuesday
1,12,16,28,2017,10,19,Thursday
1,3,13,16,2018,4,10,Tuesday
3,11,15,26,2018,2,3,Saturday
0,6,19,25,2017,5,25,Thursday
4,24,10,34,2018,1,13,Saturday
5,11,14,25,2018,4,27,Friday
3,16,19,35,2017,12,4,Monday
5,15,11,26,2018,4,12,Thursday
3,14,18,32,2017,9,11,Monday
2,5,13,18,2018,7,29,Sunday
1,23,-1,22,2018,3,12,Monday
12,20,0,20,2017,11,11,Saturday
16,21,16,37,2018,6,12,Tuesday
2,4,15,19,2018,2,24,Saturday
2,12,15,27,2018,1,11,Thursday
2,22,0,22,2018,2,26,Monday
2,22,1,23,2017,12,5,Tuesday
1,5,19,24,2018,2,5,Monday
0,8,13,21,2017,11,29,Wednseday
6,8,6,14,2018,2,21,Wednseday
7,13,37,50,2018,6,6,Wednseday
1,3,1,4,2018,8,6,Monday
1,7,13,20,2018,8,7,Tuesday
3,3,12,15,2018,1,16,Tuesday
0,18,7,25,2018,2,16,Friday
2,5,19,24,2017,11,18,Saturday
0,6,15,21,2018,6,27,Wednseday
1,7,18,25,2018,4,5,Thursday
1,7,17,24,2017,12,5,Tuesday
3,13,11,24,2017,10,31,Tuesday
2,16,19,35,2017,12,25,Monday
4,6,7,13,2018,4,6,Friday
3,10,14,24,2017,4,10,Monday
1,4,17,21,2017,12,13,Wednseday
1,8,1,9,2018,8,21,Tuesday
4,5,17,22,2017,4,13,Thursday
4,13,10,23,2017,10,21,Saturday
0,14,13,27,2017,9,27,Wednseday
2,6,10,16,2017,9,12,Tuesday
0,1,13,14,2018,4,25,Wednseday
3,11,16,27,2018,5,5,Saturday
4,13,18,31,2018,2,3,Saturday
3,20,10,30,2017,10,24,Tuesday
1,7,6,13,2018,8,8,Wednseday
1,10,8,18,2017,3,12,Sunday
2,18,6,24,2017,7,24,Monday
3,9,14,23,2017,3,7,Tuesday
4,9,10,19,2018,2,22,Thursday
7,8,6,14,2017,11,9,Thursday
4,14,9,23,2017,10,30,Monday
4,10,11,21,2017,8,21,Monday
5,23,11,34,2018,4,7,Saturday
1,4,13,17,2018,7,30,Monday
2,10,24,34,2018,6,23,Saturday
5,34,-1,33,2018,3,16,Friday
2,3,6,9,2018,5,21,Monday
0,2,12,14,2017,6,6,Tuesday
1,5,17,22,2017,6,29,Thursday
3,11,8,19,2018,3,16,Friday
2,13,3,16,2018,8,15,Wednseday
6,18,14,32,2017,12,29,Friday
2,12,18,30,2018,4,15,Sunday
1,5,9,14,2018,7,25,Wednseday
8,15,11,26,2018,1,7,Sunday
3,7,11,18,2017,9,8,Friday
4,6,28,34,2018,3,8,Thursday
1,8,6,14,2018,7,16,Monday
3,6,19,25,2017,5,6,Saturday
8,14,8,22,2018,7,10,Tuesday
2,5,20,25,2018,8,4,Saturday
4,8,16,24,2018,6,29,Friday
1,4,5,9,2018,8,6,Monday
3,15,8,23,2018,2,26,Monday
3,11,18,29,2018,7,15,Sunday
1,7,15,22,2018,7,31,Tuesday
5,19,13,32,2018,2,3,Saturday
1,7,19,26,2017,7,12,Wednseday
2,15,1,16,2018,4,2,Monday
3,5,9,14,2018,1,26,Friday
5,9,16,25,2018,6,9,Saturday
1,13,14,27,2017,5,24,Wednseday
2,9,12,21,2017,9,18,Monday
1,3,14,17,2018,8,26,Sunday
3,6,26,32,2018,6,22,Friday
2,11,7,18,2018,7,9,Monday
2,10,14,24,2017,5,21,Sunday
2,11,15,26,2017,10,29,Sunday
3,10,10,20,2017,5,12,Friday
1,7,10,17,2018,7,17,Tuesday
5,7,5,12,2018,5,5,Saturday
5,10,9,19,2018,3,28,Wednseday
1,12,18,30,2017,10,25,Wednseday
1,24,0,24,2018,5,14,Monday
4,8,22,30,2018,1,7,Sunday
1,6,16,22,2018,6,21,Thursday
4,11,15,26,2017,4,28,Friday
1,6,9,15,2018,1,17,Wednseday
3,9,13,22,2017,11,13,Monday
3,8,15,23,2017,9,12,Tuesday
1,4,5,9,2018,8,6,Monday
1,4,19,23,2018,4,9,Monday
3,33,-10,23,2018,3,11,Sunday
5,11,24,35,2017,2,9,Thursday
4,19,15,34,2018,2,10,Saturday
3,5,1,6,2018,8,24,Friday
1,5,14,19,2018,5,16,Wednseday
1,6,6,12,2018,8,8,Wednseday
1,8,25,33,2017,2,1,Wednseday
1,11,21,32,2018,7,23,Monday
4,16,11,27,2018,4,28,Saturday
1,13,-7,6,2018,8,7,Tuesday
1,7,9,16,2017,9,11,Monday
3,7,18,25,2017,6,9,Friday
1,27,7,34,2018,4,19,Thursday
2,14,15,29,2018,4,11,Wednseday
1,7,18,25,2017,5,25,Thursday
3,12,2,14,2018,8,3,Friday
1,10,7,17,2018,7,17,Tuesday
2,13,15,28,2017,6,28,Wednseday
4,19,7,26,2017,10,15,Sunday
6,13,9,22,2017,8,2,Wednseday
2,6,22,28,2018,1,11,Thursday
0,3,26,29,2018,5,15,Tuesday
7,7,5,12,2018,3,15,Thursday
1,5,14,19,2018,3,15,Thursday
1,24,-5,19,2017,9,13,Wednseday
3,4,14,18,2018,2,2,Friday
5,8,12,20,2017,7,20,Thursday
1,9,13,22,2017,4,18,Tuesday
1,8,15,23,2017,7,2,Sunday
3,18,14,32,2018,2,4,Sunday
4,13,-1,12,2018,3,15,Thursday
3,46,-21,25,2018,1,14,Sunday
3,9,6,15,2018,5,2,Wednseday
1,7,13,20,2018,4,26,Thursday
0,8,13,21,2017,11,24,Friday
2,3,14,17,2018,2,12,Monday
1,14,3,17,2017,10,3,Tuesday
5,13,6,19,2017,12,30,Saturday
1,5,8,13,2018,3,21,Wednseday
4,11,16,27,2017,12,2,Saturday
5,11,23,34,2018,4,28,Saturday
3,8,5,13,2018,2,13,Tuesday
1,14,19,33,2017,5,17,Wednseday
5,11,9,20,2017,11,24,Friday
2,3,15,18,2017,12,18,Monday
4,10,13,23,2017,9,2,Saturday
0,3,21,24,2017,7,17,Monday
5,25,7,32,2017,7,20,Thursday
2,9,14,23,2018,8,5,Sunday
4,10,11,21,2018,8,6,Monday
3,23,7,30,2018,5,13,Sunday
4,5,21,26,2017,12,23,Saturday
5,14,15,29,2017,11,2,Thursday
2,6,16,22,2017,3,1,Wednseday
1,7,26,33,2018,4,19,Thursday
1,9,13,22,2017,7,12,Wednseday
1,10,14,24,2018,1,16,Tuesday
21,53,-21,32,2018,1,4,Thursday
2,16,5,21,2018,3,26,Monday
3,6,14,20,2018,8,24,Friday
5,10,14,24,2018,4,6,Friday
3,5,15,20,2018,3,17,Saturday
3,28,13,41,2017,1,20,Friday
4,47,-23,24,2018,3,31,Saturday
3,5,8,13,2018,5,11,Friday
3,4,20,24,2017,12,25,Monday
1,3,15,18,2017,6,26,Monday
1,9,13,22,2017,8,15,Tuesday
4,6,11,17,2017,11,19,Sunday
0,10,21,31,2018,2,5,Monday
1,2,11,13,2017,8,2,Wednseday
6,10,17,27,2018,6,8,Friday
1,6,20,26,2018,6,27,Wednseday
2,6,25,31,2018,3,3,Saturday
5,17,8,25,2017,12,2,Saturday
4,13,31,44,2017,7,15,Saturday
5,15,11,26,2017,11,17,Friday
21,36,-2,34,2018,2,27,Tuesday
1,37,-7,30,2018,1,22,Monday
6,21,2,23,2018,4,11,Wednseday
0,7,17,24,2017,10,17,Tuesday
1,6,22,28,2018,7,26,Thursday
2,3,12,15,2018,1,15,Monday
4,17,4,21,2017,11,10,Friday
2,10,13,23,2017,5,29,Monday
4,6,12,18,2017,9,30,Saturday
1,12,7,19,2018,3,28,Wednseday
2,16,16,32,2017,4,2,Sunday
3,17,12,29,2017,2,14,Tuesday
3,6,8,14,2018,1,26,Friday
3,9,2,11,2018,8,4,Saturday
3,13,13,26,2017,11,24,Friday
4,7,20,27,2017,2,16,Thursday
2,3,13,16,2018,5,5,Saturday
4,7,13,20,2018,6,30,Saturday
2,6,16,22,2018,4,3,Tuesday
3,7,12,19,2017,11,11,Saturday
4,22,7,29,2017,11,30,Thursday
2,6,21,27,2017,3,4,Saturday
2,10,14,24,2017,4,8,Saturday
1,6,7,13,2018,8,2,Thursday
2,9,8,17,2018,3,4,Sunday
1,3,25,28,2018,6,25,Monday
1,5,33,38,2018,6,3,Sunday
4,11,23,34,2017,7,29,Saturday
2,4,14,18,2017,4,23,Sunday
3,6,7,13,2017,11,1,Wednseday
3,9,18,27,2018,4,21,Saturday
0,1,15,16,2017,7,26,Wednseday
1,4,14,18,2018,2,1,Thursday
2,5,11,16,2017,12,6,Wednseday
2,8,29,37,2017,8,20,Sunday
3,11,13,24,2017,5,19,Friday
2,9,16,25,2018,5,10,Thursday
2,7,7,14,2018,7,23,Monday
3,4,-1,3,2018,8,6,Monday
1,2,8,10,2018,6,19,Tuesday
1,5,17,22,2017,10,5,Thursday
3,48,-16,32,2018,4,27,Friday
1,3,1,4,2018,8,5,Sunday
10,21,8,29,2017,11,27,Monday
3,11,20,31,2018,6,15,Friday
15,17,4,21,2017,10,31,Tuesday
19,37,-6,31,2018,2,2,Friday
1,9,20,29,2017,9,10,Sunday
5,7,12,19,2018,5,16,Wednseday
1,13,16,29,2018,4,4,Wednseday
1,4,32,36,2018,8,26,Sunday
3,11,12,23,2017,5,21,Sunday
1,9,12,21,2018,7,4,Wednseday
9,34,5,39,2017,12,2,Saturday
8,15,12,27,2018,2,9,Friday
5,8,7,15,2017,7,24,Monday
1,4,11,15,2017,8,17,Thursday
5,8,15,23,2017,6,14,Wednseday
1,11,5,16,2018,4,2,Monday
1,9,11,20,2018,2,21,Wednseday
3,17,18,35,2018,1,22,Monday
7,17,10,27,2017,9,12,Tuesday
5,8,46,54,2016,10,9,Sunday
2,3,15,18,2018,4,14,Saturday
0,2,35,37,2017,1,18,Wednseday
0,7,21,28,2017,3,22,Wednseday
1,3,14,17,2018,1,23,Tuesday
3,10,13,23,2017,5,6,Saturday
4,15,5,20,2018,2,23,Friday
13,17,5,22,2018,7,24,Tuesday
9,15,13,28,2018,7,30,Monday
8,16,12,28,2018,4,30,Monday
2,7,9,16,2017,9,12,Tuesday
6,8,10,18,2018,5,24,Thursday
0,16,19,35,2017,12,13,Wednseday
9,21,-5,16,2018,7,25,Wednseday
2,9,10,19,2017,10,15,Sunday
5,12,18,30,2017,2,8,Wednseday
4,131,-96,35,2017,2,3,Friday
5,7,8,15,2018,7,25,Wednseday
1,5,18,23,2017,10,4,Wednseday
3,13,13,26,2018,2,3,Saturday
3,6,19,25,2018,5,13,Sunday
2,11,15,26,2018,6,23,Saturday
5,12,15,27,2017,5,26,Friday
9,24,3,27,2017,9,2,Saturday
2,6,19,25,2018,6,30,Saturday
2,30,17,47,2018,2,14,Wednseday
1,6,23,29,2018,1,2,Tuesday
1,7,13,20,2018,5,3,Thursday
1,8,13,21,2017,3,2,Thursday
2,8,15,23,2018,3,11,Sunday
1,3,11,14,2018,7,24,Tuesday
4,17,21,38,2018,4,15,Sunday
1,7,22,29,2018,6,14,Thursday
1,18,10,28,2017,9,25,Monday
3,24,6,30,2018,1,30,Tuesday
4,9,14,23,2017,11,25,Saturday
4,9,18,27,2017,8,19,Saturday
5,7,13,20,2017,12,13,Wednseday
1,11,11,22,2018,5,23,Wednseday
10,28,8,36,2017,5,9,Tuesday
3,10,9,19,2017,4,23,Sunday
2,16,6,22,2018,1,29,Monday
3,4,10,14,2017,6,2,Friday
2,16,14,30,2017,5,21,Sunday
2,18,10,28,2017,11,30,Thursday
3,5,7,12,2018,3,10,Saturday
2,6,25,31,2017,12,2,Saturday
3,11,23,34,2018,1,13,Saturday
1,5,5,10,2018,8,19,Sunday
4,18,14,32,2017,11,2,Thursday
3,13,11,24,2017,11,10,Friday
2,18,11,29,2017,9,27,Wednseday
1,13,6,19,2018,3,22,Thursday
1,3,12,15,2018,1,16,Tuesday
0,18,3,21,2017,10,27,Friday
3,17,10,27,2017,5,6,Saturday
8,14,22,36,2017,7,26,Wednseday
1,4,18,22,2018,4,23,Monday
0,5,15,20,2017,8,10,Thursday
1,6,20,26,2017,12,13,Wednseday
6,11,8,19,2018,8,18,Saturday
3,8,23,31,2018,3,20,Tuesday
2,37,-13,24,2018,7,14,Saturday
0,9,9,18,2018,4,23,Monday
7,9,6,15,2018,1,15,Monday
3,4,15,19,2018,6,22,Friday
2,8,14,22,2017,8,28,Monday
1,11,22,33,2018,8,9,Thursday
2,3,7,10,2018,5,19,Saturday
2,8,16,24,2017,6,11,Sunday
1,2,12,14,2018,6,12,Tuesday
1,11,30,41,2018,1,19,Friday
2,6,16,22,2017,10,3,Tuesday
1,12,16,28,2018,4,4,Wednseday
0,21,13,34,2018,2,9,Friday
4,43,-23,20,2018,3,29,Thursday
2,3,12,15,2018,1,22,Monday
4,14,18,32,2017,10,2,Monday
2,13,24,37,2018,6,9,Saturday
5,14,12,26,2018,2,16,Friday
3,26,0,26,2018,4,13,Friday
7,10,10,20,2017,5,9,Tuesday
7,18,7,25,2017,10,23,Monday
1,7,14,21,2018,5,1,Tuesday
6,15,11,26,2017,4,21,Friday
1,2,3,5,2018,8,22,Wednseday
2,15,14,29,2017,11,21,Tuesday
3,12,13,25,2018,5,26,Saturday
2,10,7,17,2018,3,11,Sunday
1,13,17,30,2017,12,20,Wednseday
1,5,15,20,2017,3,15,Wednseday
6,9,7,16,2018,5,2,Wednseday
0,2,15,17,2017,12,4,Monday
3,18,7,25,2018,3,10,Saturday
4,9,25,34,2018,5,26,Saturday
2,7,12,19,2017,9,27,Wednseday
7,9,2,11,2017,9,4,Monday
2,11,26,37,2018,4,22,Sunday
2,14,38,52,2018,6,2,Saturday
2,9,14,23,2017,9,13,Wednseday
4,23,-1,22,2018,5,10,Thursday
1,8,12,20,2018,3,27,Tuesday
1,21,4,25,2018,1,15,Monday
1,2,15,17,2018,4,16,Monday
1,7,38,45,2018,6,12,Tuesday
2,3,3,6,2018,7,28,Saturday
3,19,8,27,2017,11,24,Friday
2,7,17,24,2018,5,12,Saturday
4,9,7,16,2017,10,2,Monday
2,13,6,19,2018,7,11,Wednseday
6,11,15,26,2017,12,28,Thursday
3,17,2,19,2018,3,23,Friday
2,3,15,18,2017,8,28,Monday
2,8,9,17,2017,10,30,Monday
1,8,18,26,2018,3,25,Sunday
1,14,11,25,2018,5,7,Monday
3,21,7,28,2017,7,18,Tuesday
1,7,17,24,2017,9,26,Tuesday
2,8,15,23,2018,3,18,Sunday
7,15,11,26,2017,7,20,Thursday
2,39,-3,36,2017,3,27,Monday
10,17,13,30,2017,3,14,Tuesday
1,7,24,31,2018,4,10,Tuesday
1,10,12,22,2017,8,7,Monday
7,16,12,28,2017,10,4,Wednseday
1,2,16,18,2018,4,22,Sunday
3,7,17,24,2018,5,4,Friday
1,7,11,18,2018,7,19,Thursday
2,9,11,20,2017,7,19,Wednseday
4,18,15,33,2018,1,18,Thursday
3,14,22,36,2017,12,19,Tuesday
1,8,19,27,2017,9,26,Tuesday
6,7,7,14,2018,2,9,Friday
2,15,10,25,2018,6,23,Saturday
1,8,23,31,2017,12,4,Monday
9,22,6,28,2018,2,20,Tuesday
2,9,21,30,2017,9,17,Sunday
2,25,-1,24,2018,2,18,Sunday
3,5,4,9,2018,8,5,Sunday
2,13,19,32,2018,4,7,Saturday
2,7,20,27,2018,5,1,Tuesday
4,19,16,35,2017,11,30,Thursday
5,12,11,23,2017,11,29,Wednseday
0,13,9,22,2018,3,14,Wednseday
1,10,13,23,2018,3,12,Monday
9,14,34,48,2018,6,20,Wednseday
3,7,10,17,2018,8,7,Tuesday
1,4,9,13,2018,4,26,Thursday
2,13,14,27,2018,6,16,Saturday
5,6,3,9,2018,8,11,Saturday
8,24,13,37,2018,7,2,Monday
5,16,6,22,2017,8,9,Wednseday
2,7,15,22,2018,4,25,Wednseday
1,6,7,13,2018,5,9,Wednseday
9,17,13,30,2017,7,11,Tuesday
1,7,21,28,2018,7,4,Wednseday
7,8,-4,4,2018,8,6,Monday
4,14,11,25,2018,4,19,Thursday
1,6,2,8,2018,8,22,Wednseday
6,13,17,30,2018,1,10,Wednseday
10,19,6,25,2017,6,16,Friday
3,12,6,18,2018,3,10,Saturday
0,5,16,21,2018,7,19,Thursday
3,28,-1,27,2017,12,8,Friday
3,30,-7,23,2017,9,9,Saturday
4,12,4,16,2018,2,5,Monday
3,18,13,31,2017,10,21,Saturday
6,20,9,29,2017,11,29,Wednseday
3,9,13,22,2018,5,13,Sunday
3,12,14,26,2017,6,23,Friday
1,3,15,18,2017,7,10,Monday
3,29,-7,22,2017,11,20,Monday
4,5,14,19,2018,1,4,Thursday
3,13,32,45,2017,4,29,Saturday
1,15,5,20,2017,10,19,Thursday
1,3,19,22,2018,5,8,Tuesday
5,15,4,19,2018,5,17,Thursday
24,34,-4,30,2018,3,7,Wednseday
1,8,14,22,2017,4,19,Wednseday
0,3,20,23,2018,4,24,Tuesday
3,18,9,27,2018,3,30,Friday
2,10,13,23,2017,3,27,Monday
2,3,15,18,2017,9,25,Monday
0,8,14,22,2017,8,15,Tuesday
4,13,22,35,2017,1,26,Thursday
3,8,12,20,2018,6,30,Saturday
6,16,10,26,2017,5,17,Wednseday
1,2,9,11,2018,6,17,Sunday
1,8,8,16,2018,8,1,Wednseday
0,4,5,9,2018,8,27,Monday
0,8,15,23,2018,2,21,Wednseday
2,16,13,29,2018,5,8,Tuesday
2,3,12,15,2018,2,25,Sunday
2,17,7,24,2018,3,17,Saturday
2,11,42,53,2018,8,12,Sunday
8,13,11,24,2017,12,26,Tuesday
1,11,10,21,2017,6,8,Thursday
1,8,14,22,2018,6,19,Tuesday
4,22,4,26,2018,3,2,Friday
5,20,13,33,2018,6,22,Friday
1,8,24,32,2017,7,20,Thursday
3,4,10,14,2018,2,12,Monday
15,30,-9,21,2018,3,28,Wednseday
5,11,13,24,2017,5,19,Friday
4,10,13,23,2017,4,22,Saturday
4,15,13,28,2018,4,6,Friday
4,10,11,21,2018,8,3,Friday
3,26,6,32,2017,10,28,Saturday
3,21,3,24,2017,9,5,Tuesday
3,8,27,35,2018,6,19,Tuesday
1,22,15,37,2017,2,8,Wednseday
3,37,-11,26,2018,3,3,Saturday
1,8,21,29,2018,4,26,Thursday
5,25,11,36,2017,12,14,Thursday
4,9,20,29,2018,2,12,Monday
6,10,2,12,2017,11,23,Thursday
1,14,9,23,2017,10,17,Tuesday
3,7,5,12,2018,4,4,Wednseday
6,7,5,12,2018,3,15,Thursday
4,17,-1,16,2017,11,21,Tuesday
6,8,19,27,2018,3,8,Thursday
3,6,15,21,2017,3,10,Friday
7,17,19,36,2018,5,22,Tuesday
2,9,14,23,2017,8,22,Tuesday
1,15,17,32,2017,5,28,Sunday
3,4,6,10,2017,5,12,Friday
2,10,8,18,2018,3,18,Sunday
1,5,3,8,2018,8,6,Monday
1,10,14,24,2018,5,13,Sunday
6,9,21,30,2018,4,18,Wednseday
3,6,12,18,2018,4,27,Friday
2,8,20,28,2017,10,17,Tuesday
0,38,-13,25,2018,2,19,Monday
9,47,-7,40,2017,5,3,Wednseday
1,11,21,32,2017,9,21,Thursday
1,7,11,18,2018,7,19,Thursday
4,8,14,22,2017,8,3,Thursday
2,3,3,6,2018,8,7,Tuesday
2,3,17,20,2017,11,14,Tuesday
1,18,5,23,2018,5,15,Tuesday
5,6,1,7,2018,8,16,Thursday
4,15,0,15,2018,2,11,Sunday
2,11,28,39,2018,6,2,Saturday
1,4,9,13,2017,11,22,Wednseday
6,26,5,31,2017,12,8,Friday
1,4,10,14,2017,7,27,Thursday
3,15,10,25,2017,10,1,Sunday
2,6,16,22,2018,1,31,Wednseday
7,9,3,12,2018,3,9,Friday
3,18,14,32,2017,12,1,Friday
1,27,0,27,2018,4,3,Tuesday
1,28,-5,23,2017,11,20,Monday
1,7,11,18,2018,8,16,Thursday
14,30,0,30,2017,11,20,Monday
1,7,15,22,2017,5,18,Thursday
0,10,8,18,2018,8,17,Friday
5,9,14,23,2018,1,10,Wednseday
2,43,-15,28,2017,11,6,Monday
3,11,14,25,2017,9,25,Monday
2,14,6,20,2018,2,27,Tuesday
3,6,16,22,2017,8,1,Tuesday
1,7,-2,5,2018,8,1,Wednseday
6,9,22,31,2018,8,21,Tuesday
0,6,35,41,2017,1,17,Tuesday
2,8,23,31,2017,12,19,Tuesday
15,21,7,28,2017,12,26,Tuesday
3,6,6,12,2018,8,24,Friday
1,10,12,22,2017,4,25,Tuesday
3,4,8,12,2018,7,7,Saturday
1,8,23,31,2018,5,28,Monday
1,3,11,14,2018,7,24,Tuesday
1,26,-7,19,2018,3,7,Wednseday
2,25,5,30,2018,4,24,Tuesday
2,4,6,10,2018,7,22,Sunday
0,5,17,22,2017,6,28,Wednseday
1,13,6,19,2018,3,15,Thursday
6,9,9,18,2017,10,7,Saturday
10,21,-4,17,2018,5,18,Friday
1,4,11,15,2018,1,18,Thursday
0,1,13,14,2018,2,19,Monday
3,19,14,33,2017,2,10,Friday
4,11,7,18,2018,8,16,Thursday
1,4,19,23,2017,3,6,Monday
2,8,23,31,2018,3,19,Monday
3,17,14,31,2017,12,18,Monday
4,10,10,20,2017,12,29,Friday
19,27,-7,20,2018,7,12,Thursday
2,10,27,37,2017,12,9,Saturday
2,5,23,28,2017,11,20,Monday
5,22,7,29,2018,5,10,Thursday
4,11,6,17,2018,4,23,Monday
1,2,36,38,2018,6,3,Sunday
1,4,14,18,2018,8,26,Sunday
3,16,14,30,2017,6,11,Sunday
6,13,10,23,2018,5,1,Tuesday
4,62,-35,27,2018,1,12,Friday
1,5,17,22,2017,8,2,Wednseday
1,21,14,35,2018,6,14,Thursday
11,13,21,34,2018,4,21,Saturday
8,14,16,30,2018,1,8,Monday
2,12,4,16,2018,5,23,Wednseday
3,13,-5,8,2018,5,22,Tuesday
1,15,13,28,2017,12,21,Thursday
3,6,13,19,2017,12,8,Friday
1,17,6,23,2017,6,13,Tuesday
2,14,13,27,2018,1,6,Saturday
1,14,15,29,2017,10,12,Thursday
4,7,12,19,2017,10,19,Thursday
4,12,5,17,2018,5,6,Sunday
5,26,9,35,2018,2,9,Friday
4,19,5,24,2018,3,23,Friday
3,21,6,27,2018,8,3,Friday
3,14,10,24,2017,5,19,Friday
9,34,-8,26,2018,5,12,Saturday
6,10,15,25,2018,7,20,Friday
4,17,7,24,2018,3,2,Friday
4,15,9,24,2017,5,28,Sunday
3,8,16,24,2017,10,10,Tuesday
1,9,11,20,2017,8,3,Thursday
3,11,17,28,2017,3,27,Monday
2,6,15,21,2018,5,8,Tuesday
3,8,3,11,2017,5,29,Monday
3,8,19,27,2017,6,16,Friday
6,7,8,15,2018,4,18,Wednseday
1,31,2,33,2018,3,18,Sunday
1,12,13,25,2017,11,9,Thursday
1,9,21,30,2018,7,2,Monday
2,11,13,24,2018,7,16,Monday
2,4,6,10,2017,11,21,Tuesday
0,6,15,21,2018,5,16,Wednseday
5,33,4,37,2017,12,23,Saturday
4,22,4,26,2018,3,9,Friday
1,7,42,49,2018,8,16,Thursday
9,24,12,36,2017,11,7,Tuesday
4,5,8,13,2017,11,18,Saturday
2,3,6,9,2018,8,14,Tuesday
4,5,8,13,2018,3,8,Thursday
3,5,14,19,2018,5,19,Saturday
1,7,21,28,2018,6,20,Wednseday
7,21,6,27,2017,11,17,Friday
1,12,10,22,2018,4,18,Wednseday
8,14,8,22,2017,6,19,Monday
3,4,2,6,2018,8,24,Friday
6,13,22,35,2017,2,17,Friday
1,7,17,24,2017,8,7,Monday
0,17,6,23,2017,11,27,Monday
0,7,13,20,2017,10,19,Thursday
1,11,17,28,2018,5,7,Monday
3,18,0,18,2018,5,19,Saturday
1,11,16,27,2017,5,25,Thursday
1,6,17,23,2017,9,26,Tuesday
1,5,13,18,2017,10,22,Sunday
1,17,3,20,2018,5,22,Tuesday
1,8,8,16,2018,3,13,Tuesday
3,10,14,24,2018,4,23,Monday
1,22,3,25,2017,11,9,Thursday
1,2,12,14,2017,6,6,Tuesday
2,9,17,26,2017,8,20,Sunday
1,4,17,21,2018,7,30,Monday
1,2,9,11,2017,10,30,Monday
1,7,16,23,2017,10,31,Tuesday
5,11,2,13,2017,8,31,Thursday
4,11,9,20,2017,11,24,Friday
3,166,-143,23,2017,11,25,Saturday
1,4,17,21,2018,7,2,Monday
1,11,15,26,2017,10,15,Sunday
3,8,12,20,2018,4,4,Wednseday
3,6,12,18,2018,8,11,Saturday
8,14,15,29,2017,4,19,Wednseday
3,5,20,25,2017,12,1,Friday
1,4,15,19,2017,10,26,Thursday
2,3,21,24,2018,3,24,Saturday
1,8,18,26,2017,7,26,Wednseday
0,1,13,14,2018,6,28,Thursday
6,14,14,28,2018,2,22,Thursday
6,14,23,37,2017,5,13,Saturday
6,13,15,28,2018,2,14,Wednseday
4,13,6,19,2018,7,19,Thursday
5,11,10,21,2017,5,5,Friday
0,4,7,11,2018,7,30,Monday
1,2,6,8,2018,5,2,Wednseday
4,15,10,25,2017,4,30,Sunday
1,12,25,37,2018,5,27,Sunday
3,5,14,19,2017,3,18,Saturday
1,7,18,25,2018,6,21,Thursday
8,15,2,17,2017,10,30,Monday
7,28,8,36,2017,9,18,Monday
3,8,23,31,2018,6,29,Friday
2,22,2,24,2018,4,17,Tuesday
2,4,21,25,2018,5,26,Saturday
2,8,9,17,2017,9,18,Monday
2,6,16,22,2017,11,19,Sunday
2,6,15,21,2017,5,3,Wednseday
6,12,14,26,2017,12,7,Thursday
2,10,9,19,2018,3,3,Saturday
15,17,5,22,2017,6,26,Monday
1,4,14,18,2018,1,18,Thursday
2,11,12,23,2018,4,16,Monday
1,3,14,17,2018,6,25,Monday
7,61,-27,34,2018,7,18,Wednseday
5,15,11,26,2017,11,2,Thursday
12,18,19,37,2018,7,8,Sunday
7,10,5,15,2018,1,16,Tuesday
0,7,11,18,2017,6,19,Monday
5,9,28,37,2017,2,12,Sunday
1,14,13,27,2018,4,26,Thursday
2,30,-7,23,2017,3,14,Tuesday
15,38,-10,28,2017,11,28,Tuesday
3,6,11,17,2017,5,19,Friday
5,7,27,34,2018,5,3,Thursday
0,2,11,13,2018,6,21,Thursday
2,8,1,9,2018,8,22,Wednseday
4,20,19,39,2018,4,7,Saturday
1,2,3,5,2018,8,8,Wednseday
1,18,16,34,2017,9,21,Thursday
5,12,34,46,2018,6,2,Saturday
4,26,-1,25,2017,11,24,Friday
1,2,11,13,2018,7,3,Tuesday
2,11,27,38,2018,2,26,Monday
3,6,13,19,2018,5,18,Friday
1,5,18,23,2017,9,20,Wednseday
5,16,10,26,2017,4,12,Wednseday
3,16,9,25,2018,2,11,Sunday
8,28,6,34,2018,1,18,Thursday
9,18,-5,13,2017,8,5,Saturday
0,13,12,25,2018,8,10,Friday
3,7,21,28,2018,4,9,Monday
3,18,29,47,2018,5,4,Friday
6,43,-8,35,2018,1,4,Thursday
2,19,-1,18,2018,3,25,Sunday
2,13,15,28,2017,11,29,Wednseday
1,17,6,23,2018,3,12,Monday
3,7,7,14,2017,11,13,Monday
6,17,1,18,2018,3,4,Sunday
1,15,15,30,2017,12,19,Tuesday
0,6,18,24,2018,1,23,Tuesday
5,13,29,42,2018,5,30,Wednseday
1,7,16,23,2017,6,12,Monday
1,5,17,22,2017,9,10,Sunday
1,16,11,27,2018,2,21,Wednseday
6,12,14,26,2017,12,14,Thursday
1,13,16,29,2017,7,5,Wednseday
8,20,3,23,2018,1,16,Tuesday
1,3,19,22,2017,4,10,Monday
3,4,12,16,2018,5,14,Monday
4,10,14,24,2018,8,10,Friday
4,12,13,25,2017,5,4,Thursday
1,4,19,23,2018,2,27,Tuesday
3,18,9,27,2018,1,13,Saturday
2,11,16,27,2018,4,21,Saturday
2,17,17,34,2017,10,3,Tuesday
6,168,-134,34,2018,2,2,Friday
5,14,9,23,2017,11,22,Wednseday
8,9,7,16,2017,6,4,Sunday
2,15,26,41,2017,2,1,Wednseday
7,24,10,34,2018,2,13,Tuesday
1,3,19,22,2018,6,11,Monday
4,15,14,29,2018,2,1,Thursday
3,7,22,29,2017,2,14,Tuesday
2,10,-5,5,2018,8,1,Wednseday
4,10,3,13,2018,8,3,Friday
0,10,14,24,2017,8,7,Monday
5,12,9,21,2018,3,8,Thursday
1,10,13,23,2017,8,27,Sunday
2,7,14,21,2018,6,27,Wednseday
1,7,11,18,2017,6,26,Monday
3,8,12,20,2018,5,25,Friday
0,5,13,18,2018,7,5,Thursday
1,9,-1,8,2018,2,14,Wednseday
1,6,9,15,2018,8,15,Wednseday
4,10,14,24,2017,7,14,Friday
6,45,-21,24,2018,3,2,Friday
1,11,13,24,2017,8,28,Monday
6,11,11,22,2017,9,28,Thursday
2,7,13,20,2018,5,2,Wednseday
2,8,11,19,2017,5,14,Sunday
0,19,9,28,2017,12,20,Wednseday
3,5,1,6,2018,8,17,Friday
1,4,5,9,2018,8,12,Sunday
1,12,10,22,2018,5,3,Thursday
2,4,12,16,2017,12,4,Monday
2,13,10,23,2017,5,31,Wednseday
4,10,39,49,2017,2,13,Monday
4,5,7,12,2018,5,17,Thursday
1,9,25,34,2018,6,12,Tuesday
6,21,6,27,2018,3,21,Wednseday
1,9,14,23,2017,9,25,Monday
4,75,-53,22,2018,3,4,Sunday
2,14,16,30,2018,2,13,Tuesday
6,15,11,26,2017,11,26,Sunday
1,19,9,28,2018,2,15,Thursday
2,16,9,25,2017,12,18,Monday
1,36,-7,29,2018,2,5,Monday
1,2,16,18,2018,3,22,Thursday
3,12,11,23,2017,10,16,Monday
2,37,-9,28,2018,1,24,Wednseday
0,9,12,21,2018,1,15,Monday
4,10,16,26,2018,1,26,Friday
2,7,16,23,2017,8,30,Wednseday
31,43,0,43,2018,1,29,Monday
2,23,2,25,2018,3,1,Thursday
3,23,-4,19,2017,10,15,Sunday
5,31,5,36,2018,2,25,Sunday
2,8,14,22,2018,3,26,Monday
5,8,4,12,2018,2,14,Wednseday
3,4,8,12,2018,8,10,Friday
1,8,14,22,2017,5,8,Monday
9,15,16,31,2018,6,11,Monday
5,14,8,22,2018,1,31,Wednseday
1,10,27,37,2018,6,4,Monday
1,5,21,26,2018,6,24,Sunday
1,5,10,15,2018,6,13,Wednseday
2,12,17,29,2018,4,12,Thursday
5,13,9,22,2017,6,22,Thursday
6,18,11,29,2017,7,27,Thursday
2,8,11,19,2017,11,26,Sunday
3,10,18,28,2017,7,3,Monday
20,29,-12,17,2017,8,29,Tuesday
2,9,14,23,2017,7,18,Tuesday
2,7,17,24,2018,1,29,Monday
2,10,1,11,2018,7,28,Saturday
2,3,5,8,2018,8,20,Monday
1,8,10,18,2018,6,10,Sunday
4,13,19,32,2017,6,17,Saturday
3,10,21,31,2017,12,2,Saturday
4,16,16,32,2018,1,8,Monday
4,13,13,26,2017,10,13,Friday
4,32,-5,27,2018,1,26,Friday
1,8,15,23,2018,5,9,Wednseday
5,9,8,17,2018,8,4,Saturday
4,5,6,11,2018,6,7,Thursday
1,41,-7,34,2017,4,5,Wednseday
2,9,14,23,2017,10,1,Sunday
1,9,14,23,2018,7,2,Monday
1,14,10,24,2017,7,24,Monday
8,23,12,35,2017,5,18,Thursday
0,13,17,30,2017,12,27,Wednseday
1,5,33,38,2017,12,4,Monday
1,6,20,26,2017,12,21,Thursday
0,6,16,22,2017,7,12,Wednseday
2,6,17,23,2017,3,4,Saturday
1,2,5,7,2018,8,28,Tuesday
1,7,10,17,2018,5,7,Monday
1,6,15,21,2018,7,17,Tuesday
1,5,21,26,2017,5,28,Sunday
3,6,7,13,2017,7,15,Saturday
2,18,14,32,2017,11,26,Sunday
2,19,13,32,2017,12,17,Sunday
5,6,9,15,2017,7,20,Thursday
1,6,24,30,2018,2,27,Tuesday
5,28,1,29,2018,1,10,Wednseday
1,5,15,20,2017,12,13,Wednseday
3,11,16,27,2017,3,31,Friday
2,5,15,20,2017,7,29,Saturday
3,4,10,14,2017,9,1,Friday
2,8,13,21,2018,2,20,Tuesday
1,3,7,10,2018,8,21,Tuesday
1,11,9,20,2018,2,22,Thursday
5,17,15,32,2017,11,26,Sunday
1,24,4,28,2018,2,14,Wednseday
4,18,-2,16,2018,5,14,Monday
4,6,12,18,2017,8,31,Thursday
1,8,25,33,2018,6,14,Thursday
2,11,30,41,2018,6,2,Saturday
2,20,9,29,2018,7,4,Wednseday
2,8,10,18,2017,12,18,Monday
4,13,11,24,2017,7,8,Saturday
1,25,-7,18,2018,1,29,Monday
21,26,-8,18,2018,3,2,Friday
2,3,5,8,2018,5,14,Monday
6,20,24,44,2018,4,10,Tuesday
2,7,22,29,2018,1,3,Wednseday
2,18,8,26,2018,2,3,Saturday
2,5,12,17,2018,3,11,Sunday
1,3,11,14,2017,11,15,Wednseday
7,34,-5,29,2018,4,12,Thursday
1,7,20,27,2017,5,30,Tuesday
3,8,16,24,2017,5,28,Sunday
3,8,17,25,2017,8,28,Monday
4,20,7,27,2018,3,23,Friday
7,10,10,20,2017,11,10,Friday
2,7,8,15,2018,7,17,Tuesday
1,11,13,24,2018,4,16,Monday
4,7,12,19,2018,7,6,Friday
3,10,7,17,2018,4,2,Monday
2,19,9,28,2018,2,7,Wednseday
1,2,20,22,2018,1,16,Tuesday
2,13,22,35,2018,2,13,Tuesday
1,22,2,24,2017,11,26,Sunday
18,19,16,35,2018,2,2,Friday
1,2,1,3,2018,8,27,Monday
3,24,23,47,2018,3,10,Saturday
1,9,14,23,2018,7,31,Tuesday
1,5,17,22,2017,9,17,Sunday
7,32,17,49,2018,4,10,Tuesday
1,14,8,22,2017,8,31,Thursday
1,7,10,17,2017,10,9,Monday
5,15,20,35,2018,5,4,Friday
1,15,7,22,2017,10,19,Thursday
2,13,17,30,2018,4,24,Tuesday
3,18,1,19,2018,7,14,Saturday
17,38,-14,24,2017,11,28,Tuesday
1,36,-11,25,2018,3,15,Thursday
6,10,12,22,2017,8,2,Wednseday
4,6,13,19,2017,10,20,Friday
1,13,20,33,2018,2,14,Wednseday
3,15,15,30,2018,7,31,Tuesday
4,17,9,26,2018,2,3,Saturday
21,30,3,33,2017,12,20,Wednseday
4,18,4,22,2017,5,18,Thursday
5,11,14,25,2018,4,22,Sunday
0,25,6,31,2017,3,3,Friday
1,2,25,27,2018,6,6,Wednseday
4,11,12,23,2017,7,30,Sunday
1,5,14,19,2017,10,26,Thursday
0,6,9,15,2018,8,1,Wednseday
2,9,14,23,2018,1,29,Monday
2,7,16,23,2017,5,31,Wednseday
1,25,-3,22,2018,3,5,Monday
6,14,21,35,2018,6,20,Wednseday
5,13,19,32,2017,12,31,Sunday
2,5,13,18,2018,6,25,Monday
3,6,14,20,2017,12,15,Friday
2,8,9,17,2018,2,6,Tuesday
1,4,18,22,2017,10,3,Tuesday
4,8,18,26,2017,11,23,Thursday
3,16,8,24,2018,3,30,Friday
2,9,38,47,2018,1,7,Sunday
5,10,7,17,2018,8,3,Friday
3,17,13,30,2017,11,14,Tuesday
0,6,21,27,2018,6,27,Wednseday
0,1,12,13,2017,10,25,Wednseday
1,11,10,21,2017,3,9,Thursday
5,9,11,20,2017,8,17,Thursday
2,33,5,38,2018,1,29,Monday
5,20,11,31,2017,2,10,Friday
1,4,13,17,2018,6,18,Monday
2,6,18,24,2017,12,12,Tuesday
6,9,7,16,2018,1,3,Wednseday
2,17,12,29,2017,11,27,Monday
4,11,16,27,2017,11,2,Thursday
2,3,10,13,2017,7,19,Wednseday
2,21,7,28,2017,7,26,Wednseday
2,15,9,24,2018,7,21,Saturday
2,6,18,24,2017,8,5,Saturday
9,10,6,16,2018,2,10,Saturday
4,16,8,24,2017,11,25,Saturday
1,11,14,25,2018,2,15,Thursday
25,36,-14,22,2018,2,26,Monday
1,11,7,18,2018,8,9,Thursday
4,10,11,21,2018,1,15,Monday
1,9,16,25,2018,6,24,Sunday
2,16,13,29,2017,11,6,Monday
1,8,11,19,2018,4,29,Sunday
1,14,28,42,2018,6,6,Wednseday
5,27,7,34,2018,2,21,Wednseday
7,24,2,26,2018,5,9,Wednseday
1,13,8,21,2017,3,17,Friday
0,1,5,6,2018,8,29,Wednseday
3,23,6,29,2017,12,11,Monday
1,15,28,43,2018,5,29,Tuesday
4,16,24,40,2017,7,9,Sunday
6,7,18,25,2017,6,22,Thursday
11,16,35,51,2016,10,4,Tuesday
2,9,11,20,2018,2,20,Tuesday
1,2,14,16,2018,1,3,Wednseday
1,14,9,23,2017,5,2,Tuesday
3,7,16,23,2018,7,2,Monday
1,3,10,13,2017,10,10,Tuesday
5,7,18,25,2018,6,28,Thursday
5,12,16,28,2017,11,17,Friday
1,11,18,29,2018,2,4,Sunday
0,3,13,16,2018,8,21,Tuesday
4,18,14,32,2017,11,2,Thursday
1,16,3,19,2017,11,26,Sunday
1,3,22,25,2018,7,2,Monday
2,9,19,28,2017,12,27,Wednseday
1,2,22,24,2018,5,27,Sunday
1,7,22,29,2017,2,6,Monday
1,3,15,18,2017,5,15,Monday
3,4,13,17,2017,10,14,Saturday
1,8,8,16,2018,5,14,Monday
1,8,22,30,2018,7,30,Monday
1,4,19,23,2018,5,28,Monday
3,5,10,15,2018,1,15,Monday
5,11,3,14,2017,6,29,Thursday
5,14,45,59,2017,12,22,Friday
1,4,12,16,2018,5,14,Monday
1,6,14,20,2018,5,16,Wednseday
2,5,17,22,2017,11,26,Sunday
5,9,3,12,2018,7,26,Thursday
1,8,12,20,2017,7,13,Thursday
3,23,9,32,2017,12,1,Friday
6,12,24,36,2017,12,27,Wednseday
1,11,18,29,2018,6,17,Sunday
3,10,14,24,2017,12,11,Monday
1,12,19,31,2018,6,24,Sunday
8,18,8,26,2017,6,29,Thursday
1,2,12,14,2017,6,7,Wednseday
6,27,1,28,2017,9,8,Friday
1,8,17,25,2018,1,11,Thursday
2,14,14,28,2017,5,8,Monday
4,15,21,36,2018,4,5,Thursday
2,3,21,24,2018,2,5,Monday
4,13,12,25,2018,4,20,Friday
0,3,17,20,2018,6,29,Friday
1,6,13,19,2017,3,23,Thursday
2,15,28,43,2018,6,10,Sunday
4,13,22,35,2017,3,24,Friday
2,19,8,27,2018,2,14,Wednseday
2,4,2,6,2018,8,18,Saturday
0,6,23,29,2018,1,2,Tuesday
2,4,17,21,2017,6,6,Tuesday
5,9,15,24,2018,8,19,Sunday
5,7,6,13,2017,6,22,Thursday
1,2,8,10,2018,4,3,Tuesday
2,8,17,25,2018,4,16,Monday
6,12,0,12,2018,8,8,Wednseday
1,3,2,5,2018,8,15,Wednseday
10,16,1,17,2017,4,24,Monday
1,7,6,13,2017,7,20,Thursday
10,26,4,30,2018,7,2,Monday
2,11,17,28,2017,3,29,Wednseday
3,5,8,13,2018,3,23,Friday
6,10,18,28,2018,5,1,Tuesday
1,9,13,22,2018,7,26,Thursday
2,6,14,20,2017,8,29,Tuesday
1,3,11,14,2018,4,10,Tuesday
5,12,38,50,2018,8,16,Thursday
3,11,26,37,2017,5,8,Monday
1,5,9,14,2017,9,18,Monday
3,22,7,29,2018,2,5,Monday
3,10,18,28,2017,9,15,Friday
1,5,10,15,2018,1,11,Thursday
2,12,26,38,2017,10,28,Saturday
1,8,13,21,2018,7,2,Monday
1,3,1,4,2018,8,20,Monday
4,7,18,25,2018,4,12,Thursday
2,7,16,23,2018,1,22,Monday
1,29,-8,21,2017,11,27,Monday
2,6,10,16,2018,8,8,Wednseday
5,6,14,20,2017,5,17,Wednseday
5,11,7,18,2018,7,28,Saturday
3,8,7,15,2018,7,3,Tuesday
5,20,13,33,2017,5,19,Friday
1,9,12,21,2017,9,18,Monday
4,16,10,26,2018,2,10,Saturday
7,8,-3,5,2018,8,9,Thursday
1,8,14,22,2018,5,7,Monday
1,8,18,26,2018,5,13,Sunday
4,12,13,25,2017,12,2,Saturday
1,13,10,23,2017,5,24,Wednseday
5,10,27,37,2017,12,6,Wednseday
3,4,9,13,2017,5,27,Saturday
2,4,8,12,2018,4,5,Thursday
3,60,-36,24,2017,11,26,Sunday
1,9,12,21,2017,9,19,Tuesday
1,7,13,20,2018,7,19,Thursday
1,9,14,23,2018,1,15,Monday
5,13,12,25,2018,3,29,Thursday
8,14,19,33,2018,2,2,Friday
2,7,8,15,2018,8,13,Monday
1,5,18,23,2018,2,25,Sunday
1,6,7,13,2018,8,23,Thursday
2,3,14,17,2018,2,18,Sunday
1,11,34,45,2018,5,27,Sunday
39,45,-20,25,2017,11,26,Sunday
1,18,15,33,2018,6,14,Thursday
5,11,15,26,2017,11,23,Thursday
2,19,9,28,2018,2,7,Wednseday
2,15,15,30,2018,2,6,Tuesday
8,33,-4,29,2018,4,29,Sunday
1,2,12,14,2017,11,29,Wednseday
2,8,21,29,2017,5,28,Sunday
1,13,20,33,2018,1,24,Wednseday
2,16,13,29,2018,3,11,Sunday
1,61,-33,28,2018,6,27,Wednseday
23,25,-14,11,2017,10,30,Monday
1,2,12,14,2017,11,8,Wednseday
1,15,12,27,2017,10,3,Tuesday
1,2,12,14,2018,6,28,Thursday
10,17,14,31,2018,2,4,Sunday
2,8,20,28,2017,12,18,Monday
3,16,9,25,2017,5,29,Monday
0,6,7,13,2017,5,17,Wednseday
2,8,9,17,2017,11,20,Monday
1,2,14,16,2018,5,23,Wednseday
1,2,14,16,2018,2,6,Tuesday
5,13,8,21,2018,8,2,Thursday
4,18,9,27,2017,11,2,Thursday
8,11,29,40,2017,2,5,Sunday
1,4,7,11,2017,10,30,Monday
1,7,16,23,2018,5,7,Monday
1,8,9,17,2017,10,1,Sunday
3,35,-2,33,2017,11,24,Friday
3,11,8,19,2018,4,29,Sunday
4,18,1,19,2017,12,8,Friday
1,18,8,26,2017,11,23,Thursday
5,12,14,26,2017,12,28,Thursday
2,11,1,12,2018,3,10,Saturday
2,4,21,25,2018,6,3,Sunday
1,2,5,7,2018,8,13,Monday
0,13,19,32,2017,7,27,Thursday
2,10,7,17,2018,5,8,Tuesday
4,17,2,19,2017,10,20,Friday
2,6,13,19,2018,3,31,Saturday
2,18,3,21,2017,11,21,Tuesday
4,13,7,20,2017,11,25,Saturday
1,6,2,8,2018,5,9,Wednseday
1,14,16,30,2018,6,12,Tuesday
3,13,8,21,2018,8,3,Friday
1,9,19,28,2018,8,13,Monday
10,18,-1,17,2017,4,25,Tuesday
6,19,4,23,2018,1,14,Sunday
1,6,13,19,2017,3,16,Thursday
0,1,10,11,2018,3,26,Monday
4,9,16,25,2018,1,4,Thursday
5,11,15,26,2018,1,12,Friday
0,10,16,26,2018,1,19,Friday
7,12,15,27,2017,3,22,Wednseday
1,9,41,50,2018,6,4,Monday
6,14,7,21,2018,3,2,Friday
2,3,14,17,2018,6,26,Tuesday
3,10,14,24,2017,10,31,Tuesday
3,7,13,20,2017,7,15,Saturday
2,9,14,23,2018,7,11,Wednseday
2,25,-1,24,2018,3,4,Sunday
32,37,17,54,2018,6,2,Saturday
1,7,29,36,2018,6,6,Wednseday
4,10,7,17,2018,3,16,Friday
1,4,18,22,2017,10,16,Monday
3,8,14,22,2018,8,20,Monday
2,14,9,23,2017,4,26,Wednseday
2,3,3,6,2018,7,31,Tuesday
10,11,3,14,2018,8,3,Friday
1,8,12,20,2017,7,20,Thursday
4,21,18,39,2017,2,10,Friday
4,10,16,26,2017,12,8,Friday
5,9,14,23,2017,11,11,Saturday
5,23,11,34,2017,4,12,Wednseday
4,20,18,38,2017,12,15,Friday
11,19,14,33,2017,1,26,Thursday
1,10,12,22,2017,9,3,Sunday
6,10,26,36,2017,12,5,Tuesday
3,25,6,31,2017,12,15,Friday
4,12,13,25,2017,4,28,Friday
26,29,14,43,2018,4,12,Thursday
3,11,13,24,2017,11,17,Friday
2,6,33,39,2018,6,16,Saturday
1,11,16,27,2018,3,6,Tuesday
7,34,-3,31,2017,12,8,Friday
5,6,7,13,2018,7,6,Friday
4,12,13,25,2017,12,1,Friday
27,32,9,41,2017,7,14,Friday
7,18,7,25,2017,11,13,Monday
2,6,8,14,2018,5,16,Wednseday
4,29,4,33,2017,11,23,Thursday
3,11,13,24,2017,6,23,Friday
4,9,16,25,2018,1,20,Saturday
5,13,20,33,2017,12,6,Wednseday
4,5,12,17,2018,1,19,Friday
3,10,23,33,2018,6,1,Friday
0,17,9,26,2017,9,15,Friday
1,6,15,21,2017,3,8,Wednseday
6,20,6,26,2018,1,7,Sunday
8,15,8,23,2017,10,1,Sunday
1,18,20,38,2018,5,28,Monday
1,32,-5,27,2018,2,8,Thursday
1,5,14,19,2017,10,29,Sunday
2,7,31,38,2018,6,4,Monday
9,11,17,28,2018,2,28,Wednseday
1,12,10,22,2017,7,20,Thursday
1,2,10,12,2018,3,7,Wednseday
3,7,13,20,2017,7,14,Friday
1,13,14,27,2017,6,13,Tuesday
8,27,-8,19,2018,3,21,Wednseday
4,12,13,25,2018,5,5,Saturday
8,21,3,24,2018,2,12,Monday
1,8,13,21,2018,7,17,Tuesday
6,12,15,27,2018,4,13,Friday
1,4,15,19,2017,9,10,Sunday
2,13,14,27,2017,5,3,Wednseday
3,7,10,17,2018,5,11,Friday
0,11,18,29,2018,1,18,Thursday
3,9,16,25,2017,8,26,Saturday
2,13,24,37,2017,2,8,Wednseday
0,4,8,12,2018,3,16,Friday
1,6,23,29,2018,6,27,Wednseday
1,6,12,18,2018,7,19,Thursday
14,34,-13,21,2017,11,23,Thursday
3,14,10,24,2017,11,28,Tuesday
3,6,17,23,2018,1,23,Tuesday
4,8,6,14,2018,3,29,Thursday
1,9,13,22,2017,3,12,Sunday
3,10,13,23,2018,3,31,Saturday
4,10,17,27,2017,6,9,Friday
0,5,19,24,2017,10,6,Friday
4,21,11,32,2017,7,10,Monday
2,13,20,33,2017,9,2,Saturday
1,5,13,18,2018,6,10,Sunday
11,17,7,24,2018,7,30,Monday
3,11,13,24,2017,6,5,Monday
1,7,14,21,2017,11,6,Monday
5,20,10,30,2017,11,22,Wednseday
3,9,14,23,2018,1,13,Saturday
1,6,30,36,2018,6,5,Tuesday
2,7,14,21,2018,5,7,Monday
2,15,14,29,2017,11,20,Monday
1,13,8,21,2017,9,19,Tuesday
2,14,10,24,2018,6,26,Tuesday
3,18,27,45,2017,8,19,Saturday
6,13,15,28,2018,4,12,Thursday
2,6,15,21,2017,5,2,Tuesday
3,7,21,28,2018,1,22,Monday
1,8,0,8,2018,7,23,Monday
19,20,14,34,2018,1,19,Friday
1,2,15,17,2017,12,11,Monday
0,9,23,32,2017,5,4,Thursday
2,13,13,26,2018,2,3,Saturday
1,6,28,34,2018,6,27,Wednseday
1,8,27,35,2018,8,21,Tuesday
1,10,13,23,2017,6,7,Wednseday
2,19,10,29,2017,9,27,Wednseday
1,4,13,17,2017,11,20,Monday
2,3,14,17,2018,1,28,Sunday
3,12,11,23,2017,9,10,Sunday
3,14,7,21,2018,7,13,Friday
4,20,12,32,2017,6,23,Friday
2,6,14,20,2017,12,13,Wednseday
4,6,12,18,2017,9,21,Thursday
1,8,12,20,2018,6,21,Thursday
19,29,3,32,2018,1,4,Thursday
1,4,18,22,2017,5,29,Monday
6,8,13,21,2018,2,15,Thursday
0,8,33,41,2018,6,6,Wednseday
1,23,29,52,2017,10,1,Sunday
2,7,29,36,2018,6,6,Wednseday
3,7,3,10,2018,8,20,Monday
6,15,19,34,2017,8,10,Thursday
6,13,15,28,2017,11,1,Wednseday
7,8,5,13,2018,3,20,Tuesday
2,7,17,24,2018,6,26,Tuesday
6,12,14,26,2017,4,7,Friday
9,29,5,34,2018,3,6,Tuesday
2,7,10,17,2017,3,6,Monday
2,9,14,23,2017,9,12,Tuesday
1,18,20,38,2018,1,1,Monday
2,3,11,14,2017,8,8,Tuesday
1,4,8,12,2018,3,1,Thursday
0,39,4,43,2018,3,1,Thursday
1,10,11,21,2018,1,12,Friday
9,12,26,38,2018,6,9,Saturday
2,13,-1,12,2018,8,1,Wednseday
0,6,15,21,2017,5,17,Wednseday
3,13,12,25,2017,10,27,Friday
4,20,4,24,2017,11,25,Saturday
2,8,16,24,2017,10,2,Monday
0,1,14,15,2018,7,4,Wednseday
7,10,27,37,2018,5,23,Wednseday
1,6,14,20,2017,9,13,Wednseday
2,5,14,19,2018,4,4,Wednseday
6,30,3,33,2018,3,17,Saturday
0,3,14,17,2017,7,21,Friday
4,12,7,19,2018,3,24,Saturday
1,15,-6,9,2018,8,8,Wednseday
2,6,28,34,2017,12,16,Saturday
1,21,5,26,2018,4,19,Thursday
2,12,16,28,2018,1,24,Wednseday
2,4,14,18,2018,2,1,Thursday
3,6,11,17,2018,4,1,Sunday
2,29,-2,27,2018,1,24,Wednseday
4,27,6,33,2018,4,7,Saturday
3,16,5,21,2017,9,18,Monday
2,48,-8,40,2018,5,3,Thursday
5,9,7,16,2018,8,18,Saturday
5,12,14,26,2017,8,9,Wednseday
4,16,15,31,2017,12,2,Saturday
1,27,-5,22,2018,3,13,Tuesday
4,13,8,21,2018,1,19,Friday
2,14,8,22,2018,2,12,Monday
2,11,22,33,2018,1,27,Saturday
4,16,11,27,2018,1,4,Thursday
1,9,13,22,2017,8,7,Monday
2,10,26,36,2017,8,21,Monday
2,8,6,14,2018,5,14,Monday
7,14,21,35,2017,4,26,Wednseday
2,3,10,13,2017,5,16,Tuesday
0,5,7,12,2018,3,15,Thursday
2,3,8,11,2018,5,7,Monday
4,9,16,25,2018,4,28,Saturday
4,18,8,26,2017,5,7,Sunday
2,9,10,19,2017,10,15,Sunday
4,22,5,27,2018,3,16,Friday
0,10,9,19,2018,3,23,Friday
25,31,30,61,2018,6,9,Saturday
0,2,18,20,2018,7,24,Tuesday
4,27,15,42,2017,11,24,Friday
2,7,25,32,2018,4,30,Monday
4,5,9,14,2017,9,7,Thursday
1,2,19,21,2017,12,27,Wednseday
1,28,-6,22,2017,11,22,Wednseday
1,24,-1,23,2018,1,30,Tuesday
1,5,17,22,2018,7,1,Sunday
1,7,21,28,2017,11,15,Wednseday
3,4,49,53,2017,10,20,Friday
2,7,10,17,2018,6,18,Monday
1,12,17,29,2017,7,12,Wednseday
2,21,3,24,2017,9,12,Tuesday
1,11,21,32,2017,6,15,Thursday
3,10,11,21,2018,2,13,Tuesday
3,29,-2,27,2018,6,8,Friday
2,10,19,29,2017,12,24,Sunday
2,9,8,17,2018,3,6,Tuesday
1,5,25,30,2017,5,3,Wednseday
7,31,6,37,2018,1,9,Tuesday
2,2,10,12,2018,3,15,Thursday
1,3,11,14,2017,8,29,Tuesday
2,9,9,18,2017,4,24,Monday
6,14,6,20,2017,7,13,Thursday
3,7,17,24,2017,10,14,Saturday
1,13,32,45,2018,1,9,Tuesday
3,16,23,39,2018,1,8,Monday
2,5,1,6,2018,8,15,Wednseday
1,18,1,19,2018,3,25,Sunday
0,12,14,26,2017,11,23,Thursday
1,14,13,27,2017,12,21,Thursday
3,6,14,20,2017,7,14,Friday
0,6,14,20,2018,7,26,Thursday
5,6,14,20,2018,4,21,Saturday
2,9,15,24,2018,2,20,Tuesday
1,22,2,24,2018,3,12,Monday
2,6,16,22,2017,7,4,Tuesday
3,11,13,24,2017,9,16,Saturday
2,18,19,37,2017,4,23,Sunday
4,11,17,28,2018,1,8,Monday
2,11,18,29,2017,3,1,Wednseday
4,31,3,34,2018,1,6,Saturday
3,10,15,25,2017,6,2,Friday
4,7,22,29,2018,6,25,Monday
6,14,11,25,2018,8,10,Friday
1,14,13,27,2018,3,21,Wednseday
0,10,21,31,2018,6,26,Tuesday
2,16,7,23,2018,1,31,Wednseday
2,3,11,14,2018,2,21,Wednseday
0,38,-9,29,2018,3,7,Wednseday
8,15,7,22,2018,3,20,Tuesday
1,2,16,18,2018,4,23,Monday
0,6,14,20,2017,10,25,Wednseday
5,18,18,36,2017,6,8,Thursday
5,6,16,22,2018,5,2,Wednseday
0,25,0,25,2017,12,11,Monday
5,7,16,23,2018,5,2,Wednseday
15,25,4,29,2017,8,15,Tuesday
3,6,30,36,2018,8,21,Tuesday
1,2,15,17,2017,12,3,Sunday
1,7,12,19,2017,11,23,Thursday
8,16,-6,10,2018,4,10,Tuesday
3,31,9,40,2017,5,12,Friday
1,10,18,28,2018,1,17,Wednseday
2,21,16,37,2018,3,20,Tuesday
1,5,13,18,2017,12,11,Monday
3,7,18,25,2018,5,12,Saturday
2,9,21,30,2018,1,17,Wednseday
1,4,4,8,2018,8,2,Thursday
1,8,20,28,2018,7,2,Monday
2,6,14,20,2017,8,2,Wednseday
3,9,22,31,2017,5,23,Tuesday
4,10,18,28,2017,12,29,Friday
2,4,11,15,2017,11,12,Sunday
4,18,21,39,2017,6,15,Thursday
4,10,18,28,2017,3,13,Monday
1,11,22,33,2018,1,19,Friday
2,10,19,29,2018,1,24,Wednseday
22,29,-1,28,2017,4,18,Tuesday
6,26,-1,25,2017,11,25,Saturday
5,14,7,21,2017,9,15,Friday
3,15,8,23,2017,6,13,Tuesday
1,21,12,33,2017,10,26,Thursday
1,24,-7,17,2018,3,19,Monday
1,28,15,43,2018,2,27,Tuesday
2,6,17,23,2018,6,23,Saturday
39,49,14,63,2016,10,10,Monday
2,7,10,17,2018,3,26,Monday
7,13,15,28,2017,12,27,Wednseday
4,15,5,20,2017,11,24,Friday
5,23,6,29,2017,12,6,Wednseday
18,31,1,32,2018,4,14,Saturday
2,25,10,35,2018,1,29,Monday
1,17,8,25,2017,11,3,Friday
7,17,1,18,2017,10,30,Monday
4,9,16,25,2018,5,7,Monday
4,19,-6,13,2017,6,30,Friday
2,10,13,23,2018,3,11,Sunday
4,12,12,24,2017,6,23,Friday
3,10,8,18,2018,3,25,Sunday
3,21,8,29,2018,4,8,Sunday
4,9,10,19,2018,3,24,Saturday
1,8,13,21,2017,11,22,Wednseday
7,9,19,28,2017,8,15,Tuesday
1,11,7,18,2018,8,16,Thursday
0,6,19,25,2017,11,10,Friday
2,9,22,31,2017,9,30,Saturday
3,4,15,19,2017,11,4,Saturday
16,24,14,38,2017,10,23,Monday
7,36,10,46,2018,3,5,Monday
2,6,20,26,2018,7,21,Saturday
3,10,27,37,2017,12,4,Monday
2,36,-2,34,2018,3,14,Wednseday
2,34,-9,25,2017,12,11,Monday
1,7,8,15,2018,8,13,Monday
1,7,12,19,2018,5,16,Wednseday
1,15,3,18,2018,8,6,Monday
2,5,23,28,2017,11,8,Wednseday
4,7,2,9,2018,5,14,Monday
4,12,9,21,2018,1,19,Friday
2,19,20,39,2018,4,14,Saturday
3,26,1,27,2017,11,24,Friday
15,24,-1,23,2018,2,11,Sunday
6,13,14,27,2018,4,26,Thursday
1,7,12,19,2018,4,19,Thursday
5,6,11,17,2018,2,16,Friday
3,13,11,24,2018,5,11,Friday
3,11,7,18,2017,10,16,Monday
4,6,23,29,2018,1,4,Thursday
3,12,12,24,2017,7,14,Friday
0,4,19,23,2017,10,30,Monday
8,15,22,37,2017,6,12,Monday
1,22,7,29,2017,12,13,Wednseday
5,18,13,31,2017,11,18,Saturday
0,6,15,21,2017,10,31,Tuesday
4,9,18,27,2017,6,3,Saturday
1,2,10,12,2017,10,22,Sunday
1,4,20,24,2018,7,1,Sunday
13,27,-3,24,2017,10,7,Saturday
1,6,14,20,2017,7,20,Thursday
2,6,13,19,2017,9,2,Saturday
4,10,1,11,2017,7,10,Monday
2,6,9,15,2018,4,5,Thursday
1,8,15,23,2017,9,3,Sunday
2,8,10,18,2018,3,18,Sunday
1,9,2,11,2018,7,30,Monday
1,16,12,28,2018,1,23,Tuesday
0,14,46,60,2017,6,9,Friday
3,15,4,19,2017,11,26,Sunday
1,10,3,13,2017,10,10,Tuesday
3,10,12,22,2017,10,16,Monday
4,53,-14,39,2018,4,13,Friday
13,36,-3,33,2018,2,8,Thursday
0,12,14,26,2017,11,24,Friday
1,9,16,25,2018,3,19,Monday
4,26,12,38,2018,2,3,Saturday
5,8,4,12,2018,3,1,Thursday
4,10,6,16,2017,8,19,Saturday
2,9,17,26,2018,1,7,Sunday
0,22,12,34,2017,7,4,Tuesday
4,7,15,22,2017,8,17,Thursday
2,14,18,32,2017,12,9,Saturday
1,9,6,15,2018,1,24,Wednseday
2,9,14,23,2018,1,13,Saturday
1,6,25,31,2017,12,5,Tuesday
4,7,12,19,2017,10,7,Saturday
5,11,9,20,2017,9,15,Friday
1,4,12,16,2018,1,29,Monday
20,21,34,55,2018,1,30,Tuesday
1,4,11,15,2018,2,15,Thursday
5,8,47,55,2018,5,24,Thursday
3,10,17,27,2017,10,21,Saturday
1,9,12,21,2018,7,24,Tuesday
3,6,31,37,2017,8,19,Saturday
2,35,10,45,2017,8,15,Tuesday
5,7,19,26,2018,5,30,Wednseday
4,11,26,37,2017,6,3,Saturday
4,19,12,31,2017,12,15,Friday
3,9,15,24,2017,12,12,Tuesday
4,8,6,14,2017,11,24,Friday
4,14,11,25,2017,8,25,Friday
1,8,19,27,2017,6,8,Thursday
3,23,9,32,2018,2,4,Sunday
4,11,21,32,2017,9,30,Saturday
1,3,7,10,2018,3,13,Tuesday
2,7,24,31,2017,8,22,Tuesday
7,14,14,28,2018,3,19,Monday
2,4,13,17,2017,12,11,Monday
2,8,12,20,2017,6,27,Tuesday
14,19,7,26,2017,9,14,Thursday
5,10,17,27,2017,5,5,Friday
2,13,4,17,2017,3,14,Tuesday
1,3,15,18,2018,2,1,Thursday
4,10,20,30,2018,6,23,Saturday
0,12,7,19,2018,3,15,Thursday
8,16,8,24,2017,9,4,Monday
1,2,8,10,2018,4,9,Monday
0,0,11,11,2017,6,19,Monday
2,10,8,18,2018,8,19,Sunday
8,11,24,35,2017,11,2,Thursday
4,12,13,25,2018,3,23,Friday
1,16,26,42,2018,1,11,Thursday
9,12,8,20,2017,5,11,Thursday
11,14,5,19,2017,3,3,Friday
5,7,20,27,2017,2,24,Friday
3,11,30,41,2018,6,2,Saturday
1,16,13,29,2017,12,5,Tuesday
1,22,5,27,2017,10,26,Thursday
4,8,9,17,2017,12,11,Monday
1,6,14,20,2018,5,8,Tuesday
7,12,14,26,2018,2,7,Wednseday
5,17,8,25,2017,2,24,Friday
1,8,19,27,2017,2,2,Thursday
2,7,17,24,2017,8,21,Monday
4,7,15,22,2017,12,11,Monday
4,10,23,33,2017,12,8,Friday
3,4,7,11,2017,7,24,Monday
1,12,17,29,2018,1,4,Thursday
4,11,15,26,2017,10,13,Friday
0,7,11,18,2018,3,19,Monday
3,8,6,14,2017,11,13,Monday
3,11,15,26,2018,1,19,Friday
1,2,11,13,2017,7,19,Wednseday
2,12,11,23,2017,7,12,Wednseday
1,13,15,28,2017,10,24,Tuesday
0,1,15,16,2018,4,17,Tuesday
0,5,29,34,2018,3,14,Wednseday
1,11,15,26,2017,2,23,Thursday
7,23,1,24,2018,1,22,Monday
4,19,-1,18,2017,7,9,Sunday
1,3,14,17,2018,7,8,Sunday
2,13,17,30,2018,3,7,Wednseday
2,12,14,26,2018,8,1,Wednseday
2,10,21,31,2017,4,25,Tuesday
0,12,9,21,2017,5,12,Friday
2,38,-13,25,2018,2,24,Saturday
8,20,12,32,2017,12,21,Thursday
0,4,14,18,2017,10,13,Friday
4,13,20,33,2017,5,5,Friday
3,6,21,27,2017,10,13,Friday
1,2,7,9,2018,5,16,Wednseday
2,19,14,33,2017,9,6,Wednseday
3,14,24,38,2017,6,30,Friday
3,13,17,30,2018,8,4,Saturday
5,10,14,24,2018,2,10,Saturday
6,11,14,25,2018,6,22,Friday
2,18,18,36,2017,11,28,Tuesday
3,8,16,24,2017,9,26,Tuesday
7,17,16,33,2018,1,19,Friday
11,32,1,33,2017,9,24,Sunday
3,5,14,19,2017,12,8,Friday
2,10,14,24,2017,8,27,Sunday
1,9,6,15,2018,8,14,Tuesday
3,5,0,5,2018,8,3,Friday
9,15,22,37,2018,6,4,Monday
5,9,0,9,2018,8,5,Sunday
0,3,10,13,2017,7,28,Friday
8,14,3,17,2018,3,19,Monday
3,17,17,34,2018,5,18,Friday
1,4,27,31,2018,6,4,Monday
3,108,-81,27,2018,4,10,Tuesday
3,10,15,25,2018,5,12,Saturday
0,8,22,30,2018,6,13,Wednseday
5,10,11,21,2017,2,24,Friday
3,13,11,24,2017,10,13,Friday
4,18,10,28,2017,6,22,Thursday
4,16,14,30,2017,7,30,Sunday
1,15,22,37,2017,10,1,Sunday
2,6,20,26,2018,5,12,Saturday
0,4,14,18,2017,9,14,Thursday
1,4,21,25,2017,9,25,Monday
1,5,15,20,2018,4,18,Wednseday
28,30,0,30,2018,7,18,Wednseday
2,13,10,23,2017,7,23,Sunday
1,2,10,12,2018,4,4,Wednseday
1,2,9,11,2017,6,26,Monday
1,14,22,36,2017,12,21,Thursday
1,16,21,37,2018,5,28,Monday
4,6,7,13,2018,8,3,Friday
6,12,9,21,2017,7,21,Friday
1,9,15,24,2018,5,14,Monday
0,3,14,17,2017,10,23,Monday
1,4,17,21,2018,7,2,Monday
2,4,5,9,2018,7,22,Sunday
8,19,18,37,2018,7,4,Wednseday
5,15,12,27,2017,11,24,Friday
2,20,10,30,2018,1,17,Wednseday
1,8,14,22,2017,6,29,Thursday
3,9,25,34,2017,7,29,Saturday
2,20,5,25,2017,5,27,Saturday
1,16,-6,10,2018,8,6,Monday
2,10,19,29,2017,7,16,Sunday
1,6,21,27,2017,10,3,Tuesday
7,18,14,32,2017,9,21,Thursday
2,10,6,16,2018,7,29,Sunday
1,3,12,15,2018,5,14,Monday
2,16,14,30,2017,7,17,Monday
0,5,15,20,2018,7,6,Friday
5,23,0,23,2017,11,12,Sunday
2,12,10,22,2017,9,6,Wednseday
3,9,16,25,2018,4,16,Monday
1,36,10,46,2017,1,16,Monday
1,8,23,31,2018,6,19,Tuesday
1,6,8,14,2018,8,8,Wednseday
2,10,21,31,2017,12,10,Sunday
6,12,15,27,2018,7,4,Wednseday
10,17,6,23,2017,4,30,Sunday
1,6,10,16,2018,3,13,Tuesday
9,11,1,12,2017,7,9,Sunday
2,25,0,25,2018,2,26,Monday
0,1,19,20,2017,8,3,Thursday
1,8,23,31,2018,5,29,Tuesday
1,2,12,14,2017,5,30,Tuesday
2,10,15,25,2018,1,7,Sunday
2,3,15,18,2018,4,15,Sunday
5,10,12,22,2017,2,26,Sunday
2,5,14,19,2017,8,26,Saturday
0,13,29,42,2018,5,30,Wednseday
1,9,16,25,2018,4,12,Thursday
10,18,42,60,2018,7,14,Saturday
7,12,16,28,2018,8,8,Wednseday
1,24,6,30,2017,9,11,Monday
0,7,13,20,2017,11,24,Friday
2,5,18,23,2018,2,18,Sunday
2,5,22,27,2017,12,6,Wednseday
1,23,6,29,2017,3,13,Monday
2,14,0,14,2018,8,6,Monday
6,7,7,14,2018,4,5,Thursday
4,13,11,24,2017,5,5,Friday
3,14,3,17,2018,3,26,Monday
0,5,14,19,2018,8,23,Thursday
0,3,6,9,2018,8,13,Monday
3,10,14,24,2017,6,24,Saturday
1,7,14,21,2018,3,15,Thursday
8,9,8,17,2018,7,22,Sunday
4,10,35,45,2018,5,28,Monday
0,14,8,22,2017,8,28,Monday
7,13,8,21,2017,5,19,Friday
1,7,18,25,2018,1,22,Monday
10,26,1,27,2018,1,19,Friday
0,7,11,18,2018,5,14,Monday
2,6,13,19,2017,10,21,Saturday
3,10,0,10,2018,7,23,Monday
2,6,14,20,2017,8,26,Saturday
2,5,11,16,2017,12,6,Wednseday
13,17,0,17,2017,11,25,Saturday
1,6,15,21,2018,2,20,Tuesday
2,20,7,27,2017,12,7,Thursday
1,25,6,31,2018,4,24,Tuesday
1,4,11,15,2018,7,9,Monday
2,8,18,26,2018,1,7,Sunday
17,21,14,35,2018,3,21,Wednseday
3,15,37,52,2018,5,29,Tuesday
2,6,7,13,2017,7,26,Wednseday
5,21,9,30,2017,11,1,Wednseday
1,8,10,18,2018,5,14,Monday
1,3,13,16,2018,1,29,Monday
8,17,6,23,2017,11,27,Monday
1,6,16,22,2018,4,3,Tuesday
2,7,19,26,2018,5,30,Wednseday
0,7,19,26,2017,10,27,Friday
2,13,20,33,2018,6,13,Wednseday
1,7,21,28,2017,12,12,Tuesday
1,15,15,30,2018,1,15,Monday
3,11,14,25,2018,2,16,Friday
2,5,22,27,2018,6,6,Wednseday
4,8,31,39,2017,7,27,Thursday
1,7,15,22,2018,7,23,Monday
1,24,-1,23,2017,11,27,Monday
3,10,33,43,2018,5,29,Tuesday
3,20,15,35,2018,2,7,Wednseday
1,13,19,32,2018,1,25,Thursday
7,14,12,26,2018,5,4,Friday
5,13,15,28,2018,4,18,Wednseday
5,22,8,30,2017,7,19,Wednseday
1,17,5,22,2017,3,19,Sunday
0,11,13,24,2017,9,25,Monday
1,13,15,28,2017,12,21,Thursday
3,26,22,48,2018,5,25,Friday
4,17,14,31,2017,11,4,Saturday
1,5,6,11,2018,8,12,Sunday
3,6,11,17,2018,4,6,Friday
4,28,-3,25,2017,11,24,Friday
1,6,15,21,2018,3,7,Wednseday
5,10,13,23,2018,2,19,Monday
1,7,26,33,2017,12,27,Wednseday
4,11,25,36,2017,6,8,Thursday
8,26,2,28,2017,12,14,Thursday
1,8,25,33,2018,4,25,Wednseday
0,14,7,21,2018,2,23,Friday
6,12,17,29,2018,1,17,Wednseday
0,31,-7,24,2017,10,17,Tuesday
4,14,11,25,2017,11,24,Friday
2,9,22,31,2017,8,20,Sunday
6,14,14,28,2017,4,13,Thursday
3,11,15,26,2017,11,24,Friday
1,6,16,22,2017,7,26,Wednseday
2,3,13,16,2018,1,16,Tuesday
3,8,14,22,2017,8,28,Monday
3,4,8,12,2017,10,13,Friday
2,7,13,20,2017,11,14,Tuesday
6,41,-8,33,2018,3,10,Saturday
1,16,7,23,2017,4,25,Tuesday
0,13,15,28,2017,8,9,Wednseday
21,22,29,51,2016,10,4,Tuesday
2,60,-30,30,2017,2,12,Sunday
2,14,10,24,2017,9,4,Monday
0,8,14,22,2018,4,25,Wednseday
2,8,16,24,2018,2,12,Monday
5,9,17,26,2018,6,9,Saturday
4,11,12,23,2017,6,12,Monday
2,17,30,47,2018,5,27,Sunday
3,7,14,21,2017,2,27,Monday
21,29,-2,27,2017,6,15,Thursday
17,24,19,43,2018,1,21,Sunday
4,22,21,43,2018,4,8,Sunday
2,10,11,21,2017,3,20,Monday
1,16,8,24,2017,12,26,Tuesday
4,9,14,23,2017,6,5,Monday
1,8,5,13,2018,8,22,Wednseday
7,10,15,25,2017,8,7,Monday
3,14,14,28,2017,9,25,Monday
3,11,15,26,2017,7,28,Friday
2,15,14,29,2017,12,6,Wednseday
1,7,8,15,2018,5,17,Thursday
4,14,15,29,2018,1,22,Monday
7,15,14,29,2018,4,12,Thursday
5,14,19,33,2017,8,17,Thursday
2,9,14,23,2017,5,21,Sunday
5,11,14,25,2017,3,23,Thursday
1,8,9,17,2018,7,23,Monday
2,7,14,21,2017,11,28,Tuesday
1,10,10,20,2017,11,28,Tuesday
2,12,36,48,2018,6,2,Saturday
1,9,8,17,2018,8,7,Tuesday
3,10,16,26,2018,3,16,Friday
8,28,-10,18,2018,5,10,Thursday
3,5,15,20,2018,6,30,Saturday
12,26,11,37,2017,10,4,Wednseday
5,22,8,30,2018,7,1,Sunday
4,10,9,19,2017,11,12,Sunday
1,15,16,31,2017,12,5,Tuesday
1,7,6,13,2017,10,10,Tuesday
14,15,13,28,2018,3,13,Tuesday
1,9,15,24,2017,9,26,Tuesday
3,6,11,17,2018,8,24,Friday
1,2,6,8,2018,5,2,Wednseday
5,10,14,24,2017,3,3,Friday
2,27,11,38,2018,2,3,Saturday
1,4,16,20,2017,5,23,Tuesday
0,11,5,16,2018,8,13,Monday
0,5,14,19,2018,1,17,Wednseday
4,53,-26,27,2018,2,24,Saturday
4,5,8,13,2018,6,22,Friday
1,2,4,6,2018,8,16,Thursday
3,7,20,27,2017,7,28,Friday
3,24,7,31,2017,12,10,Sunday
1,13,15,28,2018,2,27,Tuesday
2,14,23,37,2018,1,8,Monday
1,6,15,21,2018,1,16,Tuesday
2,4,10,14,2017,11,13,Monday
0,3,17,20,2017,8,9,Wednseday
5,13,18,31,2017,12,15,Friday
1,9,15,24,2017,4,10,Monday
2,14,10,24,2018,2,13,Tuesday
0,16,10,26,2017,7,12,Wednseday
1,24,13,37,2018,5,13,Sunday
2,13,18,31,2017,10,3,Tuesday
3,27,8,35,2018,3,9,Friday
0,4,16,20,2017,12,14,Thursday
7,13,9,22,2017,6,27,Tuesday
4,11,15,26,2017,9,8,Friday
0,7,14,21,2017,10,16,Monday
2,7,16,23,2018,5,1,Tuesday
2,34,-4,30,2017,6,24,Saturday
3,18,11,29,2018,1,22,Monday
2,4,25,29,2017,4,3,Monday
11,18,7,25,2018,4,26,Thursday
2,9,13,22,2017,7,31,Monday
3,4,1,5,2018,8,17,Friday
4,12,8,20,2017,10,12,Thursday
3,23,3,26,2018,1,6,Saturday
1,15,20,35,2018,1,17,Wednseday
1,7,14,21,2018,2,20,Tuesday
7,16,-4,12,2018,3,2,Friday
2,6,8,14,2018,7,17,Tuesday
2,15,9,24,2017,11,26,Sunday
2,11,13,24,2018,4,22,Sunday
2,5,14,19,2018,5,19,Saturday
1,7,31,38,2017,4,11,Tuesday
0,1,12,13,2018,4,5,Thursday
3,16,8,24,2017,10,2,Monday
3,12,7,19,2017,10,20,Friday
2,10,15,25,2018,6,18,Monday
1,15,8,23,2018,5,21,Monday
3,8,14,22,2017,2,26,Sunday
1,15,22,37,2018,5,29,Tuesday
2,10,12,22,2017,3,6,Monday
7,14,0,14,2018,4,23,Monday
18,33,-8,25,2017,9,10,Sunday
1,11,11,22,2017,8,14,Monday
7,10,11,21,2018,8,13,Monday
2,7,16,23,2017,4,22,Saturday
7,18,22,40,2017,4,6,Thursday
1,3,5,8,2017,10,31,Tuesday
0,9,14,23,2017,10,9,Monday
3,9,12,21,2017,9,12,Tuesday
3,8,3,11,2017,5,15,Monday
3,18,8,26,2017,12,3,Sunday
3,13,7,20,2017,5,12,Friday
1,18,-1,17,2017,4,24,Monday
1,5,0,5,2018,7,29,Sunday
1,12,33,45,2018,5,27,Sunday
3,6,16,22,2018,1,30,Tuesday
6,13,0,13,2017,6,16,Friday
4,5,8,13,2018,6,21,Thursday
5,27,5,32,2018,2,22,Thursday
1,16,7,23,2018,3,26,Monday
0,7,24,31,2018,6,12,Tuesday
1,5,11,16,2018,7,15,Sunday
1,8,12,20,2018,2,22,Thursday
4,9,7,16,2018,3,12,Monday
1,3,16,19,2018,8,26,Sunday
2,26,7,33,2018,4,4,Wednseday
4,10,31,41,2017,1,27,Friday
1,11,11,22,2017,11,21,Tuesday
1,13,19,32,2017,8,17,Thursday
3,9,10,19,2017,5,14,Sunday
1,5,17,22,2018,4,25,Wednseday
1,8,7,15,2018,5,8,Tuesday
14,22,8,30,2018,1,10,Wednseday
0,6,24,30,2018,1,16,Tuesday
3,11,12,23,2018,5,7,Monday
1,13,20,33,2017,2,9,Thursday
3,12,27,39,2018,6,30,Saturday
2,5,9,14,2017,8,14,Monday
17,31,-13,18,2017,12,2,Saturday
0,6,2,8,2018,8,8,Wednseday
3,4,6,10,2018,7,27,Friday
1,5,18,23,2017,10,3,Tuesday
1,3,15,18,2017,12,10,Sunday
1,7,21,28,2018,4,16,Monday
5,13,14,27,2017,5,3,Wednseday
4,26,-5,21,2017,10,26,Thursday
1,6,11,17,2017,10,24,Tuesday
2,9,9,18,2017,12,18,Monday
2,7,21,28,2018,1,17,Wednseday
1,4,6,10,2018,8,20,Monday
4,17,1,18,2018,5,19,Saturday
4,24,4,28,2017,12,5,Tuesday
8,10,14,24,2017,7,24,Monday
21,27,19,46,2018,7,19,Thursday
3,7,13,20,2017,8,8,Tuesday
1,7,1,8,2018,8,2,Thursday
2,9,17,26,2017,8,5,Saturday
6,25,-5,20,2018,5,18,Friday
3,10,31,41,2018,4,27,Friday
1,9,15,24,2017,8,28,Monday
2,6,17,23,2017,12,5,Tuesday
2,8,24,32,2018,6,11,Monday
1,7,18,25,2017,11,16,Thursday
4,15,0,15,2017,6,4,Sunday
1,7,19,26,2018,5,2,Wednseday
1,6,24,30,2018,4,4,Wednseday
4,11,10,21,2018,7,26,Thursday
5,29,-11,18,2018,4,2,Monday
3,10,18,28,2018,4,13,Friday
1,5,14,19,2017,12,7,Thursday
4,11,24,35,2018,1,15,Monday
5,15,7,22,2017,4,19,Wednseday
6,10,10,20,2017,11,17,Friday
1,3,14,17,2017,11,20,Monday
1,26,-2,24,2018,3,2,Friday
5,6,12,18,2018,7,7,Saturday
0,6,20,26,2017,4,6,Thursday
3,14,18,32,2018,2,12,Monday
4,5,7,12,2017,8,13,Sunday
2,11,12,23,2017,10,14,Saturday
1,14,8,22,2018,4,23,Monday
5,11,21,32,2018,6,22,Friday
3,11,19,30,2017,4,8,Saturday
3,10,22,32,2018,7,21,Saturday
1,7,20,27,2017,10,3,Tuesday
1,2,14,16,2018,4,10,Tuesday
4,20,5,25,2018,3,23,Friday
1,11,11,22,2017,6,5,Monday
0,6,14,20,2017,11,10,Friday
1,8,16,24,2018,4,1,Sunday
2,9,14,23,2018,4,30,Monday
9,23,34,57,2018,3,15,Thursday
2,14,7,21,2018,7,30,Monday
3,4,13,17,2017,12,3,Sunday
2,7,22,29,2018,1,25,Thursday
2,11,12,23,2018,7,16,Monday
3,10,6,16,2018,8,14,Tuesday
1,15,10,25,2018,5,7,Monday
2,4,14,18,2017,12,2,Saturday
1,24,3,27,2018,4,24,Tuesday
3,14,15,29,2018,6,12,Tuesday
11,14,37,51,2016,10,10,Monday
2,9,18,27,2018,3,17,Saturday
9,19,14,33,2018,3,31,Saturday
2,15,7,22,2017,4,18,Tuesday
2,6,14,20,2018,4,7,Saturday
2,18,10,28,2018,2,5,Monday
2,17,9,26,2017,9,24,Sunday
2,10,24,34,2017,9,23,Saturday
5,17,16,33,2018,7,28,Saturday
1,14,21,35,2018,6,28,Thursday
4,8,13,21,2018,5,3,Thursday
2,17,38,55,2017,12,12,Tuesday
9,20,10,30,2017,11,5,Sunday
2,9,14,23,2018,7,23,Monday
1,8,20,28,2018,4,9,Monday
1,4,7,11,2018,5,13,Sunday
3,23,11,34,2017,12,16,Saturday
2,16,13,29,2017,12,4,Monday
13,26,0,26,2017,11,24,Friday
2,9,14,23,2017,10,11,Wednseday
7,18,9,27,2017,9,20,Wednseday
1,17,0,17,2018,1,7,Sunday
2,4,12,16,2017,8,5,Saturday
2,15,20,35,2017,8,9,Wednseday
5,7,5,12,2017,10,13,Friday
1,5,14,19,2017,3,16,Thursday
2,36,-16,20,2018,2,15,Thursday
1,5,3,8,2018,7,19,Thursday
4,6,14,20,2018,6,22,Friday
5,6,7,13,2018,3,21,Wednseday
5,12,10,22,2018,7,29,Sunday
2,9,15,24,2018,1,28,Sunday
1,9,13,22,2017,8,9,Wednseday
7,9,10,19,2018,2,28,Wednseday
2,14,8,22,2017,7,12,Wednseday
8,28,0,28,2018,3,16,Friday
3,7,28,35,2018,1,2,Tuesday
6,11,11,22,2018,1,2,Tuesday
1,13,5,18,2018,5,3,Thursday
1,6,21,27,2017,9,27,Wednseday
4,7,12,19,2017,10,12,Thursday
3,10,20,30,2017,8,1,Tuesday
1,8,15,23,2017,7,17,Monday
2,16,23,39,2017,8,5,Saturday
0,15,6,21,2018,3,20,Tuesday
1,14,8,22,2018,2,14,Wednseday
1,13,12,25,2018,4,26,Thursday
2,15,25,40,2017,10,4,Wednseday
4,15,11,26,2018,2,4,Sunday
2,26,2,28,2017,9,6,Wednseday
0,9,12,21,2017,9,13,Wednseday
6,17,21,38,2017,12,29,Friday
4,7,13,20,2017,11,24,Friday
2,10,8,18,2018,3,18,Sunday
3,5,6,11,2018,8,3,Friday
2,14,4,18,2018,8,6,Monday
4,7,11,18,2017,7,31,Monday
2,12,10,22,2018,7,11,Wednseday
2,8,21,29,2018,2,6,Tuesday
7,14,1,15,2017,5,17,Wednseday
11,20,2,22,2018,5,3,Thursday
12,28,0,28,2018,2,21,Wednseday
7,16,1,17,2017,10,10,Tuesday
8,16,0,16,2017,5,9,Tuesday
2,8,11,19,2018,3,7,Wednseday
2,12,23,35,2018,6,13,Wednseday
1,7,11,18,2018,7,30,Monday
2,10,25,35,2018,8,13,Monday
1,6,15,21,2018,5,8,Tuesday
1,6,10,16,2018,4,24,Tuesday
9,23,9,32,2017,5,27,Saturday
3,20,-3,17,2018,5,20,Sunday
7,14,6,20,2018,7,10,Tuesday
2,26,-5,21,2018,2,28,Wednseday
3,9,9,18,2018,3,11,Sunday
1,9,22,31,2018,1,22,Monday
0,7,18,25,2017,8,3,Thursday
4,12,13,25,2017,6,10,Saturday
3,13,14,27,2018,3,20,Tuesday
4,13,19,32,2018,5,25,Friday
2,16,15,31,2018,5,28,Monday
1,3,21,24,2018,5,8,Tuesday
2,4,17,21,2018,8,6,Monday
1,7,14,21,2017,9,11,Monday
4,6,15,21,2018,6,14,Thursday
6,13,31,44,2018,5,30,Wednseday
1,4,45,49,2017,1,30,Monday
1,6,10,16,2018,8,1,Wednseday
2,23,11,34,2018,2,7,Wednseday
5,12,12,24,2017,8,11,Friday
2,9,18,27,2018,5,1,Tuesday
5,13,25,38,2018,4,21,Saturday
1,4,11,15,2018,5,13,Sunday
5,11,3,14,2018,7,27,Friday
13,21,15,36,2017,12,7,Thursday
4,8,14,22,2018,5,13,Sunday
6,14,22,36,2018,5,29,Tuesday
13,18,6,24,2017,11,3,Friday
1,6,21,27,2018,8,17,Friday
2,10,20,30,2018,2,26,Monday
1,6,21,27,2018,4,12,Thursday
5,11,8,19,2017,10,19,Thursday
10,17,21,38,2018,6,24,Sunday
8,20,20,40,2017,7,20,Thursday
2,8,14,22,2017,4,24,Monday
2,10,15,25,2018,1,13,Saturday
2,4,21,25,2018,4,14,Saturday
2,7,14,21,2018,1,17,Wednseday
6,11,28,39,2017,1,5,Thursday
0,9,30,39,2018,2,8,Thursday
3,9,9,18,2018,7,23,Monday
1,2,9,11,2017,11,6,Monday
0,5,8,13,2018,8,9,Thursday
3,4,8,12,2018,4,6,Friday
5,8,19,27,2018,1,10,Wednseday
4,16,6,22,2017,9,21,Thursday
4,20,4,24,2018,3,2,Friday
4,14,9,23,2018,2,24,Saturday
3,6,7,13,2017,5,6,Saturday
6,10,10,20,2018,4,20,Friday
1,15,21,36,2018,6,12,Tuesday
8,16,22,38,2018,1,30,Tuesday
2,3,15,18,2017,7,24,Monday
2,6,19,25,2018,1,7,Sunday
5,14,12,26,2017,6,29,Thursday
2,10,20,30,2017,2,12,Sunday
4,11,18,29,2018,4,26,Thursday
1,7,16,23,2018,8,22,Wednseday
1,7,14,21,2018,8,20,Monday
1,4,15,19,2017,10,19,Thursday
2,25,9,34,2017,7,29,Saturday
1,3,0,3,2018,7,30,Monday
3,11,20,31,2018,4,15,Sunday
4,10,33,43,2017,7,16,Sunday
6,12,14,26,2017,7,12,Wednseday
5,6,8,14,2018,2,9,Friday
1,7,14,21,2018,7,26,Thursday
5,29,5,34,2017,12,30,Saturday
1,7,14,21,2018,3,19,Monday
1,11,9,20,2017,4,19,Wednseday
3,9,5,14,2017,11,27,Monday
2,34,-5,29,2018,2,13,Tuesday
2,13,9,22,2017,7,26,Wednseday
2,40,-13,27,2018,4,11,Wednseday
8,14,8,22,2017,5,10,Wednseday
2,10,21,31,2018,3,19,Monday
1,2,7,9,2018,7,29,Sunday
2,13,9,22,2017,7,11,Tuesday
3,6,14,20,2017,11,24,Friday
1,16,6,22,2018,3,7,Wednseday
1,6,7,13,2017,6,28,Wednseday
4,20,6,26,2017,11,16,Thursday
1,7,15,22,2017,8,1,Tuesday
2,10,20,30,2017,11,26,Sunday
1,80,-49,31,2018,2,5,Monday
0,16,14,30,2018,5,23,Wednseday
3,11,18,29,2018,8,12,Sunday
2,10,16,26,2017,2,19,Sunday
4,20,13,33,2018,2,2,Friday
4,12,15,27,2017,11,24,Friday
0,9,12,21,2017,11,22,Wednseday
4,4,9,13,2018,3,23,Friday
2,9,14,23,2017,5,9,Tuesday
2,5,8,13,2018,6,20,Wednseday
1,8,18,26,2017,12,27,Wednseday
4,13,20,33,2017,11,24,Friday
1,7,13,20,2018,2,20,Tuesday
4,13,5,18,2018,2,15,Thursday
3,12,11,23,2017,9,2,Saturday
3,16,7,23,2017,11,13,Monday
5,11,45,56,2017,1,26,Thursday
2,8,12,20,2018,8,7,Tuesday
2,4,9,13,2017,6,24,Saturday
4,12,10,22,2018,1,14,Sunday
2,8,18,26,2017,6,11,Sunday
12,22,-1,21,2018,7,18,Wednseday
4,7,12,19,2018,7,20,Friday
3,15,1,16,2017,11,21,Tuesday
1,18,6,24,2017,11,13,Monday
16,21,27,48,2018,1,9,Tuesday
2,5,8,13,2017,7,12,Wednseday
3,15,8,23,2017,11,28,Tuesday
3,6,11,17,2018,7,14,Saturday
1,7,16,23,2018,1,22,Monday
1,2,14,16,2018,1,2,Tuesday
6,14,8,22,2018,1,2,Tuesday
3,11,17,28,2018,5,4,Friday
0,5,14,19,2018,8,23,Thursday
18,35,-7,28,2018,2,2,Friday
1,12,18,30,2017,10,4,Wednseday
0,7,16,23,2018,6,12,Tuesday
4,7,11,18,2018,5,11,Friday
2,8,18,26,2018,7,4,Wednseday
1,11,18,29,2018,1,23,Tuesday
5,12,15,27,2018,3,30,Friday
2,3,18,21,2018,4,17,Tuesday
4,19,12,31,2018,4,21,Saturday
7,15,7,22,2017,11,29,Wednseday
1,5,15,20,2017,8,30,Wednseday
5,27,-1,26,2017,4,29,Saturday
5,8,17,25,2018,5,3,Thursday
8,20,7,27,2018,3,13,Tuesday
2,27,10,37,2017,4,15,Saturday
3,16,13,29,2017,12,11,Monday
2,3,3,6,2018,8,7,Tuesday
6,12,32,44,2018,8,18,Saturday
2,7,24,31,2017,5,22,Monday
8,22,44,66,2018,2,20,Tuesday
0,5,9,14,2018,7,26,Thursday
4,13,13,26,2018,3,23,Friday
1,15,6,21,2017,11,27,Monday
1,7,21,28,2017,10,25,Wednseday
2,5,20,25,2018,6,16,Saturday
5,9,13,22,2017,8,2,Wednseday
9,17,5,22,2017,11,26,Sunday
0,14,10,24,2017,7,10,Monday
5,15,6,21,2018,3,8,Thursday
4,29,9,38,2017,12,9,Saturday
2,5,14,19,2017,12,17,Sunday
5,12,12,24,2017,9,9,Saturday
11,25,15,40,2018,6,15,Friday
11,23,0,23,2018,7,16,Monday
11,20,17,37,2018,3,17,Saturday
1,35,-18,17,2017,9,4,Monday
1,9,14,23,2017,6,13,Tuesday
3,9,9,18,2017,12,18,Monday
1,2,1,3,2018,7,31,Tuesday
1,13,19,32,2017,6,29,Thursday
1,7,7,14,2017,6,12,Monday
0,8,31,39,2018,6,4,Monday
2,9,18,27,2018,8,14,Tuesday
5,12,11,23,2017,3,18,Saturday
3,15,9,24,2018,4,30,Monday
1,5,18,23,2018,4,15,Sunday
12,16,3,19,2018,1,3,Wednseday
1,2,12,14,2018,5,9,Wednseday
1,19,11,30,2017,9,13,Wednseday
1,2,20,22,2018,7,23,Monday
3,16,6,22,2017,10,23,Monday
2,7,17,24,2017,4,3,Monday
2,6,14,20,2018,7,4,Wednseday
2,4,9,13,2018,5,5,Saturday
2,18,12,30,2018,7,16,Monday
2,3,9,12,2017,7,2,Sunday
0,8,18,26,2018,5,3,Thursday
6,12,27,39,2017,1,5,Thursday
0,3,13,16,2018,8,21,Tuesday
8,16,13,29,2017,8,21,Monday
1,36,-15,21,2018,2,15,Thursday
5,13,28,41,2017,2,11,Saturday
1,11,15,26,2017,9,7,Thursday
2,6,6,12,2018,5,9,Wednseday
2,9,23,32,2018,6,16,Saturday
1,13,11,24,2017,4,4,Tuesday
2,7,28,35,2017,11,14,Tuesday
1,14,13,27,2017,12,12,Tuesday
3,15,8,23,2017,5,30,Tuesday
1,8,14,22,2017,6,22,Thursday
3,7,-4,3,2018,8,7,Tuesday
2,17,28,45,2018,6,2,Saturday
11,18,-4,14,2017,11,27,Monday
2,3,10,13,2017,5,20,Saturday
0,12,19,31,2018,1,19,Friday
3,6,21,27,2018,1,30,Tuesday
6,32,16,48,2018,3,23,Friday
2,7,17,24,2017,11,18,Saturday
2,12,18,30,2017,10,8,Sunday
3,7,10,17,2018,8,10,Friday
0,13,11,24,2017,7,14,Friday
1,9,15,24,2018,1,2,Tuesday
1,5,14,19,2018,5,23,Wednseday
1,5,36,41,2017,2,9,Thursday
2,9,28,37,2017,1,11,Wednseday
2,8,10,18,2017,8,14,Monday
1,27,3,30,2018,6,26,Tuesday
5,28,0,28,2018,2,21,Wednseday
1,10,30,40,2017,2,12,Sunday
2,8,16,24,2017,1,24,Tuesday
3,13,13,26,2017,10,1,Sunday
7,10,10,20,2017,8,1,Tuesday
3,11,6,17,2018,4,2,Monday
4,17,9,26,2017,4,29,Saturday
9,29,-9,20,2018,2,27,Tuesday
2,6,19,25,2018,4,28,Saturday
0,1,15,16,2017,8,21,Monday
2,14,6,20,2017,9,27,Wednseday
5,14,13,27,2017,8,23,Wednseday
6,22,14,36,2017,6,28,Wednseday
18,29,24,53,2016,10,3,Monday
3,4,8,12,2018,5,11,Friday
2,6,8,14,2017,11,7,Tuesday
3,14,13,27,2017,12,9,Saturday
1,8,12,20,2018,4,12,Thursday
2,9,49,58,2017,2,13,Monday
1,17,11,28,2018,2,27,Tuesday
2,8,35,43,2018,1,24,Wednseday
1,6,24,30,2018,2,27,Tuesday
5,13,15,28,2017,11,24,Friday
1,2,20,22,2017,6,7,Wednseday
2,5,14,19,2018,5,16,Wednseday
0,5,16,21,2017,3,9,Thursday
1,3,14,17,2017,6,18,Sunday
8,16,8,24,2018,5,1,Tuesday
4,13,15,28,2018,5,24,Thursday
3,7,15,22,2017,7,10,Monday
11,17,23,40,2018,4,13,Friday
2,9,15,24,2017,6,24,Saturday
3,11,14,25,2017,8,25,Friday
7,21,0,21,2017,3,10,Friday
4,24,7,31,2017,11,27,Monday
1,18,14,32,2018,1,18,Thursday
2,9,19,28,2018,3,20,Tuesday
4,25,16,41,2017,4,28,Friday
4,8,19,27,2017,9,22,Friday
1,4,17,21,2018,4,23,Monday
3,13,12,25,2017,8,18,Friday
2,5,17,22,2018,7,8,Sunday
1,8,8,16,2018,3,6,Tuesday
2,13,21,34,2018,4,3,Tuesday
1,21,4,25,2017,8,14,Monday
2,7,9,16,2017,9,24,Sunday
1,6,8,14,2018,5,15,Tuesday
1,8,19,27,2017,6,21,Wednseday
7,10,25,35,2018,6,18,Monday
1,5,16,21,2017,8,23,Wednseday
1,12,11,23,2017,8,23,Wednseday
2,6,28,34,2017,12,12,Tuesday
3,15,23,38,2017,5,7,Sunday
8,20,14,34,2017,5,24,Wednseday
1,7,23,30,2018,2,14,Wednseday
3,4,16,20,2017,7,8,Saturday
2,12,7,19,2018,2,25,Sunday
3,25,-1,24,2017,7,21,Friday
1,10,22,32,2017,4,17,Monday
0,35,-13,22,2017,11,6,Monday
2,17,9,26,2018,2,25,Sunday
3,5,7,12,2018,3,10,Saturday
7,11,7,18,2018,7,12,Thursday
5,36,-14,22,2017,11,29,Wednseday
4,25,-1,24,2018,1,26,Friday
3,9,13,22,2018,8,12,Sunday
2,7,17,24,2018,8,7,Tuesday
1,5,14,19,2018,8,8,Wednseday
1,12,30,42,2018,6,6,Wednseday
9,16,12,28,2018,2,26,Monday
3,17,18,35,2017,5,22,Monday
1,7,18,25,2018,1,25,Thursday
0,4,21,25,2018,5,24,Thursday
1,11,17,28,2017,10,26,Thursday
2,19,8,27,2017,4,22,Saturday
3,62,-36,26,2018,3,10,Saturday
1,8,17,25,2017,10,29,Sunday
1,17,3,20,2018,3,8,Thursday
0,7,17,24,2017,12,19,Tuesday
1,7,17,24,2018,7,24,Tuesday
1,15,14,29,2017,8,10,Thursday
2,15,15,30,2018,2,7,Wednseday
1,4,13,17,2017,3,27,Monday
0,5,24,29,2018,5,10,Thursday
0,22,-5,17,2017,8,29,Tuesday
2,9,10,19,2018,7,1,Sunday
3,10,13,23,2018,7,14,Saturday
0,1,10,11,2017,5,11,Thursday
3,18,16,34,2017,4,21,Friday
1,15,10,25,2017,6,8,Thursday
1,10,15,25,2017,7,23,Sunday
2,3,10,13,2017,7,18,Tuesday
2,9,15,24,2017,8,19,Saturday
6,7,7,14,2018,5,15,Tuesday
4,18,15,33,2018,1,4,Thursday
15,33,0,33,2017,10,5,Thursday
1,13,10,23,2017,8,23,Wednseday
48,76,-28,48,2017,12,9,Saturday
1,4,13,17,2018,7,9,Monday
2,6,18,24,2018,7,3,Tuesday
4,20,6,26,2018,2,10,Saturday
1,8,18,26,2018,1,28,Sunday
3,3,5,8,2018,8,6,Monday
3,4,9,13,2017,8,4,Friday
4,6,2,8,2018,7,19,Thursday
3,9,18,27,2017,5,6,Saturday
3,10,17,27,2017,6,9,Friday
1,9,22,31,2018,2,6,Tuesday
4,8,16,24,2018,1,9,Tuesday
2,3,9,12,2018,3,3,Saturday
1,18,10,28,2017,10,12,Thursday
1,4,6,10,2018,8,5,Sunday
1,5,6,11,2018,8,12,Sunday
1,22,3,25,2018,2,18,Sunday
2,20,8,28,2017,11,29,Wednseday
2,8,14,22,2017,4,2,Sunday
1,12,15,27,2018,3,22,Thursday
3,14,14,28,2017,9,1,Friday
1,24,6,30,2018,1,23,Tuesday
3,8,9,17,2017,5,14,Sunday
1,9,15,24,2018,5,1,Tuesday
2,5,21,26,2017,10,29,Sunday
1,12,27,39,2018,6,21,Thursday
3,30,-7,23,2018,5,15,Tuesday
7,15,-2,13,2017,8,1,Tuesday
0,11,16,27,2018,4,17,Tuesday
6,10,22,32,2018,6,23,Saturday
1,5,17,22,2017,3,22,Wednseday
3,3,14,17,2018,1,7,Sunday
1,15,7,22,2017,11,20,Monday
1,12,22,34,2018,6,7,Thursday
10,27,-3,24,2017,3,14,Tuesday
4,5,0,5,2018,8,9,Thursday
2,10,9,19,2017,3,11,Saturday
1,13,20,33,2017,4,5,Wednseday
28,48,-6,42,2017,4,21,Friday
8,9,7,16,2018,1,3,Wednseday
11,18,10,28,2017,10,26,Thursday
2,6,6,12,2018,8,18,Saturday
2,8,12,20,2017,12,6,Wednseday
5,13,23,36,2017,8,31,Thursday
11,12,5,17,2017,11,24,Friday
2,8,15,23,2017,10,22,Sunday
6,15,7,22,2018,3,14,Wednseday
2,10,14,24,2017,11,21,Tuesday
0,7,16,23,2017,7,19,Wednseday
3,11,14,25,2018,6,8,Friday
1,4,19,23,2018,5,7,Monday
1,12,20,32,2018,1,25,Thursday
1,9,34,43,2018,4,16,Monday
1,8,21,29,2018,1,9,Tuesday
0,4,21,25,2018,8,16,Thursday
0,5,8,13,2018,7,6,Friday
9,17,33,50,2018,1,16,Tuesday
3,9,20,29,2017,7,16,Sunday
3,21,-9,12,2018,8,3,Friday
3,14,4,18,2018,4,30,Monday
3,15,16,31,2017,11,5,Sunday
1,2,7,9,2018,7,9,Monday
2,7,13,20,2018,5,15,Tuesday
0,6,12,18,2018,7,19,Thursday
1,6,13,19,2017,10,18,Wednseday
6,15,20,35,2018,1,18,Thursday
4,11,13,24,2018,3,2,Friday
3,5,22,27,2018,2,6,Tuesday
3,25,2,27,2017,11,24,Friday
5,12,9,21,2018,1,17,Wednseday
10,12,10,22,2017,2,26,Sunday
2,12,9,21,2018,5,7,Monday
2,6,19,25,2017,3,11,Saturday
3,10,25,35,2018,8,17,Friday
9,30,4,34,2017,10,31,Tuesday
1,4,20,24,2017,5,28,Sunday
1,10,19,29,2017,10,25,Wednseday
1,18,5,23,2018,5,21,Monday
5,15,17,32,2017,9,1,Friday
1,5,17,22,2018,7,29,Sunday
1,7,3,10,2017,11,21,Tuesday
1,5,45,50,2018,6,3,Sunday
2,4,8,12,2018,8,5,Sunday
1,8,19,27,2018,3,15,Thursday
3,6,7,13,2017,8,22,Tuesday
3,16,14,30,2018,6,23,Saturday
1,3,13,16,2017,12,5,Tuesday
3,11,14,25,2017,6,23,Friday
3,30,-12,18,2018,3,5,Monday
0,11,18,29,2017,9,28,Thursday
1,19,4,23,2018,3,21,Wednseday
4,8,21,29,2017,8,17,Thursday
2,11,13,24,2017,11,5,Sunday
2,13,0,13,2017,7,25,Tuesday
1,30,3,33,2018,3,28,Wednseday
7,34,-11,23,2017,12,6,Wednseday
3,10,20,30,2017,5,23,Tuesday
4,5,14,19,2017,6,2,Friday
1,27,-9,18,2018,3,1,Thursday
5,11,10,21,2018,2,23,Friday
3,25,0,25,2018,4,13,Friday
1,7,15,22,2018,4,4,Wednseday
0,3,18,21,2017,5,29,Monday
2,7,11,18,2017,7,10,Monday
1,8,18,26,2018,4,19,Thursday
1,6,3,9,2018,7,31,Tuesday
1,6,17,23,2017,2,7,Tuesday
3,6,28,34,2018,6,8,Friday
4,18,24,42,2018,6,22,Friday
11,19,12,31,2018,3,16,Friday
8,14,17,31,2017,11,26,Sunday
1,29,-4,25,2018,3,15,Thursday
1,28,-1,27,2017,11,24,Friday
1,6,10,16,2018,3,27,Tuesday
2,22,-8,14,2018,8,14,Tuesday
0,33,-9,24,2018,3,9,Friday
3,6,13,19,2017,6,10,Saturday
2,5,12,17,2017,10,8,Sunday
3,12,14,26,2017,11,10,Friday
1,9,20,29,2017,7,11,Tuesday
14,14,6,20,2017,12,20,Wednseday
1,6,12,18,2018,7,19,Thursday
4,7,26,33,2018,6,2,Saturday
2,13,14,27,2017,10,25,Wednseday
0,1,13,14,2018,2,27,Tuesday
1,10,12,22,2017,7,18,Tuesday
2,13,14,27,2017,6,6,Tuesday
1,6,29,35,2018,5,16,Wednseday
5,21,-3,18,2018,3,2,Friday
1,2,3,5,2018,8,1,Wednseday
2,22,8,30,2018,1,9,Tuesday
4,5,8,13,2018,7,6,Friday
5,35,-5,30,2018,2,21,Wednseday
1,2,11,13,2017,8,23,Wednseday
3,5,19,24,2017,11,5,Sunday
0,14,14,28,2018,1,5,Friday
2,7,10,17,2018,5,7,Monday
1,2,23,25,2018,3,26,Monday
4,13,13,26,2017,11,2,Thursday
13,17,10,27,2017,2,25,Saturday
1,3,5,8,2018,5,9,Wednseday
1,9,27,36,2017,7,9,Sunday
2,13,9,22,2017,11,8,Wednseday
2,7,16,23,2018,4,30,Monday
5,13,20,33,2017,12,28,Thursday
1,10,13,23,2017,8,23,Wednseday
1,4,22,26,2018,1,7,Sunday
0,10,20,30,2018,4,16,Monday
4,8,11,19,2017,10,19,Thursday
5,10,2,12,2017,10,13,Friday
2,7,9,16,2018,5,7,Monday
1,2,26,28,2018,8,14,Tuesday
5,30,6,36,2017,8,20,Sunday
1,7,13,20,2018,5,9,Wednseday
4,11,18,29,2018,4,22,Sunday
4,6,20,26,2018,6,29,Friday
6,14,13,27,2017,12,28,Thursday
2,8,9,17,2018,8,20,Monday
11,43,-24,19,2017,3,3,Friday
4,8,10,18,2018,8,12,Sunday
5,16,19,35,2017,11,29,Wednseday
1,26,2,28,2018,4,12,Thursday
4,11,15,26,2018,8,10,Friday
5,17,7,24,2018,2,24,Saturday
2,4,19,23,2017,9,9,Saturday
3,22,10,32,2018,1,15,Monday
2,6,20,26,2018,6,30,Saturday
2,6,11,17,2017,12,12,Tuesday
0,27,-5,22,2017,11,30,Thursday
1,13,22,35,2017,8,15,Tuesday
0,4,34,38,2018,6,18,Monday
2,4,7,11,2017,11,20,Monday
2,9,15,24,2017,7,8,Saturday
2,10,19,29,2018,3,11,Sunday
2,13,10,23,2017,3,8,Wednseday
1,4,33,37,2017,2,7,Tuesday
7,15,7,22,2017,11,14,Tuesday
3,13,19,32,2017,10,28,Saturday
2,3,12,15,2017,6,4,Sunday
2,6,17,23,2017,3,11,Saturday
1,2,11,13,2018,4,17,Tuesday
4,19,7,26,2017,3,25,Saturday
1,26,10,36,2017,8,13,Sunday
6,19,4,23,2018,5,9,Wednseday
3,30,-1,29,2017,7,25,Tuesday
4,7,7,14,2018,1,26,Friday
3,6,0,6,2018,8,10,Friday
0,8,12,20,2018,2,22,Thursday
3,9,15,24,2017,7,1,Saturday
12,16,16,32,2017,12,7,Thursday
5,135,-109,26,2017,11,22,Wednseday
5,17,18,35,2018,1,5,Friday
1,23,3,26,2018,3,14,Wednseday
2,16,33,49,2018,5,28,Monday
0,6,19,25,2018,4,5,Thursday
3,16,7,23,2017,8,26,Saturday
1,7,31,38,2018,7,30,Monday
2,24,-1,23,2018,3,5,Monday
2,12,33,45,2018,8,12,Sunday
2,19,8,27,2017,11,25,Saturday
5,18,8,26,2018,2,10,Saturday
1,22,9,31,2017,5,8,Monday
4,11,16,27,2018,4,28,Saturday
7,13,24,37,2018,1,17,Wednseday
3,14,10,24,2017,9,1,Friday
1,14,14,28,2018,1,18,Thursday
1,14,9,23,2017,10,31,Tuesday
5,22,5,27,2018,5,17,Thursday
2,8,16,24,2018,4,22,Sunday
5,13,16,29,2018,1,4,Thursday
3,16,16,32,2017,5,6,Saturday
2,7,35,42,2018,6,18,Monday
3,10,10,20,2017,6,16,Friday
6,11,20,31,2018,2,9,Friday
1,5,16,21,2018,7,18,Wednseday
0,11,10,21,2018,4,19,Thursday
3,16,15,31,2017,10,14,Saturday
2,12,16,28,2018,2,26,Monday
4,16,6,22,2017,8,14,Monday
4,11,13,24,2017,4,8,Saturday
1,12,17,29,2017,8,27,Sunday
3,7,18,25,2018,2,23,Friday
1,8,18,26,2018,4,26,Thursday
1,9,17,26,2018,1,4,Thursday
2,7,10,17,2017,11,21,Tuesday
3,17,17,34,2017,2,7,Tuesday
2,7,10,17,2018,5,7,Monday
3,26,11,37,2017,12,3,Sunday
1,26,6,32,2018,4,8,Sunday
1,11,8,19,2018,4,4,Wednseday
3,27,4,31,2018,3,16,Friday
2,3,4,7,2018,8,20,Monday
1,12,30,42,2017,4,26,Wednseday
2,8,10,18,2018,3,25,Sunday
3,7,11,18,2018,5,14,Monday
0,3,11,14,2017,11,10,Friday
2,31,-10,21,2018,3,12,Monday
8,18,19,37,2018,2,25,Sunday
3,19,13,32,2017,9,24,Sunday
2,8,19,27,2017,9,26,Tuesday
2,16,21,37,2018,2,4,Sunday
4,5,14,19,2018,1,4,Thursday
1,2,11,13,2017,5,17,Wednseday
2,4,18,22,2018,6,25,Monday
5,14,10,24,2017,8,11,Friday
1,13,8,21,2017,5,3,Wednseday
1,5,2,7,2018,8,2,Thursday
9,31,15,46,2018,3,11,Sunday
1,3,14,17,2018,6,25,Monday
3,6,10,16,2018,1,3,Wednseday
5,7,17,24,2018,1,5,Friday
0,7,11,18,2018,5,25,Friday
1,20,20,40,2018,3,8,Thursday
2,10,12,22,2017,10,17,Tuesday
1,10,12,22,2018,4,3,Tuesday
2,6,11,17,2018,7,28,Saturday
5,17,11,28,2018,4,20,Friday
0,13,20,33,2018,4,25,Wednseday
4,6,18,24,2017,9,22,Friday
4,11,5,16,2018,8,12,Sunday
2,9,21,30,2018,5,8,Tuesday
3,15,14,29,2017,12,12,Tuesday
3,16,9,25,2017,5,6,Saturday
4,26,-2,24,2018,1,26,Friday
0,11,3,14,2018,1,26,Friday
2,8,18,26,2017,4,9,Sunday
1,7,14,21,2018,6,27,Wednseday
3,10,15,25,2017,6,9,Friday
6,12,15,27,2018,7,25,Wednseday
4,11,12,23,2017,5,21,Sunday
4,14,12,26,2017,5,19,Friday
0,2,13,15,2018,4,25,Wednseday
1,14,12,26,2017,5,11,Thursday
1,5,8,13,2018,8,22,Wednseday
1,8,8,16,2018,4,2,Monday
2,8,6,14,2018,8,22,Wednseday
2,7,17,24,2018,5,1,Tuesday
2,49,-26,23,2018,3,10,Saturday
4,5,20,25,2017,5,5,Friday
8,10,18,28,2018,2,19,Monday
2,3,14,17,2018,1,28,Sunday
2,15,9,24,2018,7,9,Monday
4,7,18,25,2017,8,18,Friday
1,7,14,21,2017,3,7,Tuesday
2,14,8,22,2017,9,6,Wednseday
4,9,30,39,2018,4,26,Thursday
2,7,13,20,2017,5,17,Wednseday
33,37,-9,28,2017,11,1,Wednseday
11,16,29,45,2018,5,28,Monday
2,9,13,22,2017,7,5,Wednseday
8,15,12,27,2017,5,3,Wednseday
25,29,4,33,2017,3,3,Friday
1,20,14,34,2017,3,14,Tuesday
2,12,13,25,2017,6,10,Saturday
1,14,25,39,2018,4,12,Thursday
2,38,-21,17,2018,3,6,Tuesday
3,12,7,19,2017,3,24,Friday
2,8,14,22,2018,2,13,Tuesday
2,13,10,23,2018,5,2,Wednseday
2,5,19,24,2017,10,8,Sunday
2,4,8,12,2018,3,3,Saturday
5,8,18,26,2017,1,25,Wednseday
1,3,11,14,2018,8,21,Tuesday
4,15,12,27,2017,11,30,Thursday
1,2,8,10,2018,6,10,Sunday
2,8,14,22,2017,7,18,Tuesday
2,6,10,16,2018,5,5,Saturday
5,17,9,26,2017,12,2,Saturday
2,10,15,25,2017,3,18,Saturday
2,8,21,29,2018,3,28,Wednseday
3,4,9,13,2018,5,12,Saturday
2,11,17,28,2018,8,13,Monday
0,7,13,20,2017,5,19,Friday
7,13,14,27,2018,4,25,Wednseday
5,12,10,22,2018,4,12,Thursday
1,9,14,23,2017,11,29,Wednseday
4,18,8,26,2017,8,10,Thursday
4,5,7,12,2018,7,26,Thursday
7,13,19,32,2017,6,9,Friday
1,10,14,24,2018,3,11,Sunday
3,9,22,31,2018,1,6,Saturday
7,12,9,21,2017,3,16,Thursday
1,13,12,25,2018,2,15,Thursday
1,10,14,24,2017,2,5,Sunday
2,3,11,14,2017,11,7,Tuesday
4,35,-8,27,2018,3,16,Friday
3,8,18,26,2017,8,6,Sunday
1,6,3,9,2018,7,31,Tuesday
4,18,10,28,2017,8,18,Friday
4,17,17,34,2018,3,13,Tuesday
2,8,13,21,2018,7,2,Monday
2,11,11,22,2018,1,29,Monday
2,8,14,22,2018,4,22,Sunday
1,4,17,21,2017,11,24,Friday
2,10,14,24,2018,7,23,Monday
3,14,13,27,2017,11,7,Tuesday
7,16,5,21,2018,1,16,Tuesday
1,16,28,44,2018,5,28,Monday
2,9,19,28,2017,11,21,Tuesday
7,15,15,30,2018,1,30,Tuesday
1,7,15,22,2017,7,31,Monday
0,3,16,19,2018,5,16,Wednseday
2,10,13,23,2018,1,30,Tuesday
1,11,16,27,2018,5,10,Thursday
3,4,6,10,2018,6,10,Sunday
6,9,20,29,2018,4,4,Wednseday
2,17,19,36,2017,7,4,Tuesday
0,33,-5,28,2017,11,24,Friday
2,6,16,22,2017,7,26,Wednseday
2,9,20,29,2017,9,27,Wednseday
4,14,21,35,2018,1,5,Friday
2,8,21,29,2018,6,17,Sunday
1,13,24,37,2017,4,11,Tuesday
0,7,31,38,2018,4,30,Monday
1,4,25,29,2017,12,10,Sunday
6,23,5,28,2018,1,25,Thursday
1,6,14,20,2018,6,13,Wednseday
0,9,9,18,2018,3,2,Friday
8,10,9,19,2017,7,26,Wednseday
0,14,12,26,2018,1,12,Friday
2,3,7,10,2017,9,19,Tuesday
3,44,-6,38,2018,3,3,Saturday
9,20,7,27,2017,12,19,Tuesday
3,14,8,22,2018,4,4,Wednseday
2,3,16,19,2018,1,13,Saturday
1,4,19,23,2017,5,21,Sunday
1,15,10,25,2017,5,11,Thursday
2,7,23,30,2017,5,30,Tuesday
1,2,12,14,2018,7,2,Monday
3,15,16,31,2018,3,9,Friday
3,24,-2,22,2017,9,19,Tuesday
2,6,6,12,2018,8,11,Saturday
2,13,7,20,2018,2,17,Saturday
3,19,1,20,2018,5,19,Saturday
1,7,23,30,2018,5,9,Wednseday
2,16,12,28,2017,2,7,Tuesday
6,26,8,34,2017,7,15,Saturday
2,9,16,25,2018,7,16,Monday
1,8,14,22,2017,9,4,Monday
0,8,16,24,2018,4,17,Tuesday
1,20,9,29,2018,1,3,Wednseday
3,18,-1,17,2018,3,26,Monday
2,5,13,18,2018,4,5,Thursday
9,11,27,38,2018,5,28,Monday
2,12,14,26,2017,3,15,Wednseday
5,8,12,20,2017,11,29,Wednseday
2,9,11,20,2017,10,11,Wednseday
4,15,8,23,2017,6,4,Sunday
2,13,13,26,2017,11,5,Sunday
2,13,36,49,2018,5,30,Wednseday
10,13,5,18,2017,10,14,Saturday
6,20,29,49,2017,3,10,Friday
3,10,9,19,2018,3,24,Saturday
1,13,14,27,2018,4,18,Wednseday
4,13,0,13,2017,5,25,Thursday
3,6,24,30,2018,6,16,Saturday
2,9,17,26,2017,11,25,Saturday
3,11,13,24,2017,6,16,Friday
1,5,15,20,2018,4,18,Wednseday
5,32,20,52,2018,4,27,Friday
2,9,23,32,2017,2,5,Sunday
4,7,10,17,2018,7,20,Friday
3,20,2,22,2018,3,13,Tuesday
1,7,28,35,2017,5,17,Wednseday
1,7,24,31,2017,8,28,Monday
2,26,3,29,2018,4,18,Wednseday
0,18,10,28,2017,6,16,Friday
7,20,14,34,2018,1,31,Wednseday
3,21,9,30,2017,4,17,Monday
5,5,7,12,2018,3,15,Thursday
10,20,2,22,2017,10,17,Tuesday
4,13,15,28,2018,6,22,Friday
1,9,19,28,2018,8,6,Monday
1,15,0,15,2018,5,22,Tuesday
2,9,13,22,2018,5,15,Tuesday
2,14,7,21,2018,3,5,Monday
1,9,26,35,2017,2,14,Tuesday
3,16,3,19,2017,9,16,Saturday
1,9,20,29,2017,12,26,Tuesday
10,14,-5,9,2018,8,14,Tuesday
2,29,-12,17,2018,5,20,Sunday
3,14,16,30,2017,10,10,Tuesday
0,7,17,24,2017,4,25,Tuesday
5,6,20,26,2017,8,17,Thursday
20,4,29,33,2017,2,10,Friday
3,7,13,20,2017,5,16,Tuesday
4,23,13,36,2017,3,27,Monday
3,23,13,36,2018,1,24,Wednseday
2,5,19,24,2018,8,18,Saturday
3,9,28,37,2017,2,14,Tuesday
2,8,22,30,2018,5,9,Wednseday
2,3,22,25,2018,6,3,Sunday
2,12,15,27,2017,9,16,Saturday
5,14,13,27,2017,3,23,Thursday
2,29,-4,25,2018,2,25,Sunday
5,18,14,32,2018,1,28,Sunday
3,14,21,35,2017,8,18,Friday
6,15,7,22,2017,7,6,Thursday
5,18,14,32,2017,11,12,Sunday
3,7,28,35,2017,2,7,Tuesday
6,10,10,20,2018,7,20,Friday
5,6,8,14,2017,5,31,Wednseday
2,3,4,7,2018,7,31,Tuesday
1,2,8,10,2018,6,10,Sunday
5,7,14,21,2017,8,18,Friday
9,16,12,28,2018,7,9,Monday
1,11,14,25,2017,2,2,Thursday
1,21,10,31,2018,3,13,Tuesday
1,7,21,28,2018,4,26,Thursday
2,8,20,28,2017,6,28,Wednseday
2,11,18,29,2017,12,4,Monday
3,10,13,23,2018,8,4,Saturday
5,12,12,24,2017,7,21,Friday
2,9,13,22,2018,4,17,Tuesday
1,8,14,22,2017,9,25,Monday
1,9,18,27,2018,6,6,Wednseday
7,31,-7,24,2017,4,11,Tuesday
13,15,-7,8,2018,8,1,Wednseday
2,7,16,23,2018,7,4,Wednseday
3,10,10,20,2018,4,27,Friday
0,4,15,19,2018,3,17,Saturday
1,7,18,25,2017,12,11,Monday
4,15,14,29,2017,6,8,Thursday
0,10,9,19,2018,3,23,Friday
2,20,12,32,2018,2,1,Thursday
6,13,12,25,2017,3,2,Thursday
1,22,12,34,2017,7,18,Tuesday
2,6,25,31,2018,6,16,Saturday
0,12,10,22,2017,7,6,Thursday
2,7,20,27,2017,8,15,Tuesday
3,10,13,23,2018,3,21,Wednseday
2,11,29,40,2018,4,14,Saturday
2,6,20,26,2017,12,13,Wednseday
3,16,7,23,2018,3,3,Saturday
1,15,11,26,2017,12,20,Wednseday
1,13,21,34,2018,5,31,Thursday
1,26,6,32,2017,4,23,Sunday
2,7,9,16,2018,2,7,Wednseday
2,6,11,17,2017,3,21,Tuesday
2,12,9,21,2018,7,18,Wednseday
1,7,9,16,2018,7,23,Monday
3,11,20,31,2017,9,22,Friday
3,9,13,22,2017,7,3,Monday
1,14,10,24,2018,7,16,Monday
2,13,7,20,2018,5,9,Wednseday
1,7,16,23,2017,5,8,Monday
2,8,17,25,2018,7,2,Monday
3,10,16,26,2017,4,22,Saturday
3,17,10,27,2017,11,4,Saturday
1,7,14,21,2017,3,21,Tuesday
1,11,1,12,2018,8,9,Thursday
1,2,3,5,2018,8,15,Wednseday
4,6,8,14,2017,6,8,Thursday
1,14,14,28,2018,2,27,Tuesday
1,15,4,19,2018,3,21,Wednseday
3,9,13,22,2017,6,4,Sunday
5,9,19,28,2018,1,24,Wednseday
2,10,14,24,2018,5,1,Tuesday
3,5,5,10,2018,5,14,Monday
8,16,5,21,2017,5,2,Tuesday
2,3,8,11,2017,11,6,Monday
3,5,14,19,2018,7,28,Saturday
2,10,30,40,2017,1,21,Saturday
6,11,11,22,2017,12,28,Thursday
6,10,17,27,2017,6,13,Tuesday
2,15,4,19,2018,4,1,Sunday
3,17,8,25,2018,3,12,Monday
2,17,22,39,2018,3,25,Sunday
2,15,6,21,2017,8,22,Tuesday
5,11,14,25,2018,7,1,Sunday
2,9,13,22,2017,10,9,Monday
4,11,15,26,2017,12,16,Saturday
2,8,26,34,2017,5,31,Wednseday
4,14,1,15,2017,10,30,Monday
2,15,11,26,2017,9,3,Sunday
6,12,19,31,2018,7,27,Friday
4,5,8,13,2017,5,12,Friday
2,3,17,20,2017,12,16,Saturday
1,2,17,19,2018,5,2,Wednseday
16,29,-5,24,2018,4,3,Tuesday
1,9,34,43,2018,8,21,Tuesday
2,11,19,30,2017,11,5,Sunday
1,7,23,30,2018,1,3,Wednseday
2,7,15,22,2017,9,4,Monday
2,30,-5,25,2018,3,19,Monday
2,6,13,19,2018,3,17,Saturday
9,27,8,35,2018,2,7,Wednseday
2,7,20,27,2018,2,14,Wednseday
1,6,8,14,2018,8,22,Wednseday
1,4,19,23,2018,7,29,Sunday
2,23,14,37,2017,12,18,Monday
4,6,18,24,2018,2,10,Saturday
7,15,12,27,2017,12,8,Friday
3,5,14,19,2018,4,20,Friday
1,8,9,17,2018,6,18,Monday
9,24,18,42,2017,3,27,Monday
1,24,5,29,2017,10,10,Tuesday
5,6,21,27,2018,5,30,Wednseday
30,33,-4,29,2017,8,23,Wednseday
3,10,19,29,2017,5,14,Sunday
2,7,10,17,2018,7,28,Saturday
2,10,18,28,2017,8,1,Tuesday
3,8,15,23,2018,4,29,Sunday
2,9,4,13,2018,8,15,Wednseday
1,13,10,23,2017,11,28,Tuesday
2,9,22,31,2018,5,26,Saturday
1,12,10,22,2018,7,26,Thursday
7,12,45,57,2017,12,5,Tuesday
1,3,8,11,2017,10,23,Monday
4,9,16,25,2018,3,11,Sunday
8,16,21,37,2017,12,31,Sunday
3,6,4,10,2018,8,10,Friday
2,8,14,22,2017,5,23,Tuesday
1,7,13,20,2017,6,27,Tuesday
4,12,12,24,2017,8,6,Sunday
3,17,18,35,2018,5,18,Friday
3,12,14,26,2017,10,13,Friday
7,15,18,33,2017,11,24,Friday
4,12,8,20,2017,11,24,Friday
3,10,13,23,2017,11,4,Saturday
1,10,11,21,2018,5,14,Monday
1,8,6,14,2018,8,13,Monday
1,7,8,15,2018,7,23,Monday
2,4,4,8,2018,8,6,Monday
3,8,16,24,2018,3,26,Monday
4,9,12,21,2017,8,21,Monday
1,5,21,26,2018,6,20,Wednseday
2,3,14,17,2017,8,22,Tuesday
1,7,14,21,2018,7,17,Tuesday
1,7,8,15,2018,4,25,Wednseday
1,9,13,22,2018,1,30,Tuesday
6,25,9,34,2017,4,14,Friday
2,10,4,14,2018,8,13,Monday
2,6,25,31,2018,4,22,Sunday
1,3,12,15,2018,4,24,Tuesday
2,10,8,18,2018,3,3,Saturday
1,14,4,18,2017,10,9,Monday
4,12,11,23,2017,7,30,Sunday
1,10,12,22,2018,6,19,Tuesday
2,3,16,19,2017,9,16,Saturday
2,6,19,25,2018,1,6,Saturday
2,13,4,17,2018,8,7,Tuesday
3,8,14,22,2017,5,15,Monday
5,12,12,24,2018,2,2,Friday
3,10,34,44,2017,7,24,Monday
0,24,4,28,2018,3,27,Tuesday
6,13,9,22,2017,11,23,Thursday
3,9,22,31,2017,6,10,Saturday
1,5,8,13,2017,8,9,Wednseday
16,35,-7,28,2018,1,24,Wednseday
6,10,26,36,2018,5,29,Tuesday
1,2,6,8,2018,8,14,Tuesday
5,11,9,20,2017,11,17,Friday
1,28,3,31,2017,11,28,Tuesday
22,26,-13,13,2018,4,4,Wednseday
2,10,35,45,2017,2,20,Monday
4,8,18,26,2017,9,7,Thursday
1,8,23,31,2017,7,11,Tuesday
6,12,16,28,2017,9,21,Thursday
6,11,15,26,2017,8,5,Saturday
2,10,3,13,2017,10,18,Wednseday
1,13,21,34,2017,5,4,Thursday
3,15,35,50,2018,4,1,Sunday
21,30,-7,23,2018,6,12,Tuesday
0,5,17,22,2017,4,12,Wednseday
1,15,37,52,2018,5,28,Monday
1,2,20,22,2018,1,8,Monday
6,33,1,34,2018,2,9,Friday
3,5,15,20,2018,1,6,Saturday
5,11,15,26,2018,2,16,Friday
8,20,7,27,2018,4,17,Tuesday
1,7,8,15,2018,7,17,Tuesday
2,20,-4,16,2017,9,12,Tuesday
3,16,1,17,2017,9,12,Tuesday
3,6,12,18,2018,8,17,Friday
3,14,14,28,2018,2,19,Monday
0,6,13,19,2018,5,3,Thursday
4,6,3,9,2018,7,28,Saturday
1,8,28,36,2018,7,19,Thursday
3,6,14,20,2018,2,17,Saturday
1,15,15,30,2018,5,2,Wednseday
4,11,14,25,2018,6,28,Thursday
5,12,10,22,2017,10,25,Wednseday
6,10,10,20,2018,2,14,Wednseday
1,10,13,23,2017,6,12,Monday
5,8,11,19,2018,5,11,Friday
3,5,19,24,2018,6,4,Monday
1,12,13,25,2018,6,24,Sunday
0,4,10,14,2018,7,20,Friday
2,4,6,10,2018,8,19,Sunday
2,10,13,23,2017,10,3,Tuesday
2,2,13,15,2018,2,18,Sunday
2,7,9,16,2018,3,5,Monday
3,9,12,21,2017,4,17,Monday
0,1,9,10,2018,7,20,Friday
1,14,16,30,2018,2,20,Tuesday
2,20,-3,17,2018,5,15,Tuesday
0,13,17,30,2017,12,27,Wednseday
9,12,13,25,2017,6,10,Saturday
2,5,10,15,2018,7,30,Monday
2,10,16,26,2017,6,17,Saturday
1,5,27,32,2018,6,17,Sunday
2,19,12,31,2018,3,17,Saturday
2,14,7,21,2018,2,19,Monday
0,34,-1,33,2017,12,1,Friday
4,38,-4,34,2017,4,8,Saturday
0,3,20,23,2017,10,24,Tuesday
3,10,17,27,2017,9,23,Saturday
4,10,32,42,2017,8,7,Monday
1,8,13,21,2017,6,8,Thursday
1,2,8,10,2017,11,21,Tuesday
6,13,11,24,2018,2,9,Friday
2,14,14,28,2017,7,12,Wednseday
3,5,16,21,2017,6,2,Friday
1,8,14,22,2017,11,19,Sunday
7,21,5,26,2017,12,28,Thursday
3,13,1,14,2017,11,28,Tuesday
0,6,19,25,2018,4,20,Friday
2,17,12,29,2018,2,4,Sunday
5,19,3,22,2018,8,1,Wednseday
2,5,13,18,2017,10,22,Sunday
5,7,18,25,2018,1,5,Friday
2,7,10,17,2018,1,20,Saturday
1,11,15,26,2018,5,24,Thursday
21,34,-5,29,2018,1,11,Thursday
0,29,12,41,2017,4,13,Thursday
1,8,14,22,2018,8,8,Wednseday
5,13,9,22,2017,8,3,Thursday
2,14,11,25,2017,9,18,Monday
1,6,16,22,2017,8,8,Tuesday
3,10,10,20,2017,11,11,Saturday
1,28,-2,26,2017,12,7,Thursday
3,5,7,12,2018,3,31,Saturday
3,9,12,21,2017,9,11,Monday
2,15,35,50,2017,7,16,Sunday
1,14,16,30,2017,7,5,Wednseday
2,8,12,20,2018,8,1,Wednseday
3,21,16,37,2017,5,6,Saturday
1,7,10,17,2017,4,25,Tuesday
1,10,17,27,2017,12,26,Tuesday
8,33,13,46,2017,7,27,Thursday
1,6,8,14,2018,7,17,Tuesday
2,9,16,25,2018,7,23,Monday
2,6,18,24,2018,4,21,Saturday
1,4,22,26,2018,5,31,Thursday
1,5,9,14,2017,11,27,Monday
3,17,15,32,2017,11,10,Friday
2,9,8,17,2018,5,12,Saturday
3,9,10,19,2017,10,21,Saturday
3,7,21,28,2018,2,23,Friday
2,7,11,18,2017,5,15,Monday
4,15,3,18,2018,3,19,Monday
1,11,18,29,2018,4,23,Monday
9,20,13,33,2018,2,28,Wednseday
4,12,13,25,2018,1,20,Saturday
2,4,8,12,2018,8,25,Saturday
2,9,15,24,2017,8,1,Tuesday
2,4,13,17,2017,10,30,Monday
1,21,1,22,2018,2,14,Wednseday
3,5,8,13,2018,7,21,Saturday
1,7,12,19,2018,8,1,Wednseday
1,2,9,11,2018,6,18,Monday
0,6,21,27,2018,4,26,Thursday
4,16,9,25,2018,2,1,Thursday
0,6,19,25,2017,10,19,Thursday
0,11,11,22,2018,3,27,Tuesday
3,11,37,48,2018,6,1,Friday
3,11,7,18,2018,3,3,Saturday
0,3,13,16,2018,2,6,Tuesday
1,4,25,29,2017,12,26,Tuesday
2,9,15,24,2018,5,5,Saturday
4,16,8,24,2018,8,6,Monday
1,8,18,26,2018,8,16,Thursday
2,6,10,16,2018,7,24,Tuesday
3,10,14,24,2018,8,20,Monday
2,15,27,42,2017,12,25,Monday
6,26,0,26,2018,5,9,Wednseday
3,8,9,17,2017,11,20,Monday
0,6,23,29,2018,7,5,Thursday
3,10,12,22,2018,8,20,Monday
1,8,10,18,2017,12,18,Monday
4,5,16,21,2017,12,15,Friday
3,20,13,33,2017,3,31,Friday
1,19,9,28,2018,5,31,Thursday
1,8,20,28,2018,6,19,Tuesday
3,12,19,31,2018,6,30,Saturday
3,10,15,25,2017,6,9,Friday
3,18,0,18,2018,5,18,Friday
1,8,3,11,2018,3,4,Sunday
2,8,15,23,2018,1,3,Wednseday
2,9,29,38,2018,5,26,Saturday
3,9,13,22,2018,5,6,Sunday
2,4,15,19,2018,4,8,Sunday
3,16,16,32,2017,10,21,Saturday
7,8,8,16,2017,5,9,Tuesday
2,16,16,32,2018,2,24,Saturday
11,27,3,30,2017,4,2,Sunday
3,6,3,9,2018,5,8,Tuesday
3,6,7,13,2018,5,8,Tuesday
3,17,2,19,2018,7,28,Saturday
6,13,8,21,2017,3,3,Friday
4,15,10,25,2017,6,15,Thursday
1,7,15,22,2018,1,2,Tuesday
6,13,14,27,2017,6,6,Tuesday
5,8,6,14,2018,8,8,Wednseday
7,15,12,27,2018,4,17,Tuesday
5,20,8,28,2017,9,27,Wednseday
1,10,14,24,2017,5,15,Monday
3,5,14,19,2017,8,13,Sunday
4,7,18,25,2017,9,22,Friday
10,13,44,57,2016,10,5,Wednseday
0,8,10,18,2017,7,3,Monday
1,26,-4,22,2018,3,12,Monday
6,11,28,39,2017,1,5,Thursday
7,9,6,15,2018,6,20,Wednseday
21,49,-13,36,2018,5,17,Thursday
13,25,10,35,2018,2,8,Thursday
0,7,8,15,2018,7,30,Monday
1,5,26,31,2017,10,1,Sunday
1,5,17,22,2018,7,23,Monday
3,5,15,20,2017,5,12,Friday
2,14,6,20,2017,10,11,Wednseday
0,3,4,7,2018,8,3,Friday
4,12,14,26,2017,12,9,Saturday
2,9,24,33,2018,4,25,Wednseday
3,15,-1,14,2018,5,18,Friday
1,25,6,31,2017,11,26,Sunday
5,7,7,14,2017,10,11,Wednseday
2,8,17,25,2018,7,22,Sunday
11,40,-17,23,2017,11,25,Saturday
1,8,15,23,2017,8,21,Monday
2,11,11,22,2017,6,19,Monday
2,7,13,20,2017,10,25,Wednseday
4,5,10,15,2017,11,26,Sunday
1,9,16,25,2018,3,11,Sunday
0,9,15,24,2018,1,16,Tuesday
2,7,28,35,2018,5,1,Tuesday
2,3,17,20,2018,7,24,Tuesday
4,14,9,23,2017,11,18,Saturday
9,13,18,31,2018,1,16,Tuesday
4,13,11,24,2017,9,30,Saturday
4,7,18,25,2017,6,2,Friday
6,13,8,21,2018,3,7,Wednseday
2,14,14,28,2017,5,23,Tuesday
5,12,11,23,2018,2,17,Saturday
3,16,7,23,2017,11,14,Tuesday
5,13,11,24,2017,7,29,Saturday
2,16,12,28,2018,1,29,Monday
1,22,6,28,2017,12,12,Tuesday
1,5,10,15,2018,2,21,Wednseday
6,47,-25,22,2018,3,1,Thursday
6,14,9,23,2017,6,7,Wednseday
2,6,19,25,2018,5,26,Saturday
1,6,13,19,2017,12,7,Thursday
0,6,22,28,2017,5,30,Tuesday
1,19,12,31,2018,1,14,Sunday
1,7,26,33,2017,3,16,Thursday
7,15,19,34,2018,3,29,Thursday
2,11,12,23,2017,4,30,Sunday
1,17,-5,12,2017,7,2,Sunday
4,19,8,27,2018,1,12,Friday
2,18,5,23,2017,6,25,Sunday
3,12,26,38,2018,8,18,Saturday
3,9,21,30,2018,7,14,Saturday
2,10,28,38,2018,6,5,Tuesday
1,2,12,14,2018,3,27,Tuesday
1,6,10,16,2017,12,5,Tuesday
0,20,12,32,2017,8,3,Thursday
1,15,12,27,2018,3,8,Thursday
3,10,16,26,2018,5,25,Friday
1,8,12,20,2017,8,31,Thursday
1,24,15,39,2018,1,8,Monday
3,9,16,25,2017,8,19,Saturday
10,28,17,45,2017,4,24,Monday
1,2,9,11,2017,11,20,Monday
8,51,-22,29,2017,7,26,Wednseday
5,9,11,20,2017,11,8,Wednseday
1,14,23,37,2017,12,26,Tuesday
1,4,18,22,2018,6,24,Sunday
6,11,23,34,2017,9,23,Saturday
1,4,22,26,2018,6,24,Sunday
2,14,16,30,2018,1,15,Monday
8,14,15,29,2018,7,31,Tuesday
2,8,22,30,2017,4,10,Monday
1,9,10,19,2018,3,14,Wednseday
4,8,17,25,2017,7,16,Sunday
4,29,7,36,2018,2,1,Thursday
4,36,-10,26,2017,12,14,Thursday
2,3,8,11,2017,11,6,Monday
1,14,18,32,2017,12,3,Sunday
2,7,12,19,2018,2,28,Wednseday
2,5,25,30,2017,3,4,Saturday
1,2,9,11,2017,11,20,Monday
2,17,20,37,2017,10,8,Sunday
4,15,14,29,2018,4,26,Thursday
5,8,4,12,2018,6,17,Sunday
3,11,23,34,2017,12,16,Saturday
7,54,-32,22,2018,2,8,Thursday
6,7,7,14,2018,6,14,Thursday
3,21,17,38,2017,7,21,Friday
4,26,11,37,2018,1,13,Saturday
5,22,12,34,2017,9,21,Thursday
2,7,14,21,2018,4,11,Wednseday
3,12,13,25,2018,7,13,Friday
4,5,6,11,2018,8,18,Saturday
1,6,9,15,2018,8,7,Tuesday
5,117,-104,13,2017,5,25,Thursday
1,6,7,13,2018,8,9,Thursday
2,5,8,13,2017,11,22,Wednseday
3,6,14,20,2018,8,17,Friday
3,8,14,22,2017,9,26,Tuesday
1,7,15,22,2018,7,24,Tuesday
1,7,36,43,2018,8,14,Tuesday
1,8,14,22,2018,7,19,Thursday
11,20,12,32,2017,9,8,Friday
5,11,24,35,2017,12,1,Friday
1,5,20,25,2018,7,8,Sunday
1,8,14,22,2018,7,16,Monday
9,11,14,25,2017,5,6,Saturday
3,17,9,26,2018,1,19,Friday
1,6,7,13,2018,8,15,Wednseday
1,12,8,20,2018,3,1,Thursday
1,5,14,19,2018,5,9,Wednseday
1,7,13,20,2017,7,5,Wednseday
1,8,16,24,2018,8,20,Monday
3,11,16,27,2018,6,23,Saturday
13,21,8,29,2017,12,7,Thursday
3,17,15,32,2018,2,3,Saturday
2,10,14,24,2018,3,24,Saturday
1,7,16,23,2017,8,14,Monday
2,9,19,28,2017,3,27,Monday
3,6,11,17,2018,8,10,Friday
2,7,13,20,2018,3,21,Wednseday
1,11,21,32,2018,6,21,Thursday
3,18,11,29,2018,4,30,Monday
1,8,6,14,2018,6,12,Tuesday
1,8,15,23,2018,5,13,Sunday
2,17,7,24,2018,6,24,Sunday
17,25,0,25,2017,12,25,Monday
4,12,13,25,2018,4,28,Saturday
1,18,3,21,2018,2,13,Tuesday
8,13,8,21,2017,7,4,Tuesday
1,17,6,23,2017,10,22,Sunday
1,16,9,25,2018,1,14,Sunday
5,11,21,32,2017,11,24,Friday
3,6,13,19,2017,3,25,Saturday
4,16,13,29,2017,9,4,Monday
3,4,9,13,2017,6,30,Friday
1,8,26,34,2018,4,10,Tuesday
0,8,19,27,2018,8,7,Tuesday
3,10,10,20,2018,7,13,Friday
2,11,24,35,2018,4,10,Tuesday
2,5,9,14,2017,10,9,Monday
3,11,13,24,2017,7,15,Saturday
1,16,6,22,2017,4,23,Sunday
3,9,8,17,2018,4,9,Monday
8,15,9,24,2017,10,16,Monday
6,11,44,55,2017,1,19,Thursday
0,1,30,31,2018,5,28,Monday
2,11,6,17,2017,11,20,Monday
3,16,15,31,2017,10,21,Saturday
5,8,18,26,2017,11,30,Thursday
6,26,13,39,2017,3,9,Thursday
0,4,10,14,2018,2,16,Friday
4,14,5,19,2018,3,23,Friday
5,11,16,27,2018,6,28,Thursday
6,7,3,10,2017,10,17,Tuesday
1,15,6,21,2017,9,13,Wednseday
2,12,16,28,2018,8,1,Wednseday
5,19,14,33,2018,1,18,Thursday
5,12,16,28,2017,4,27,Thursday
8,28,11,39,2018,2,15,Thursday
2,14,21,35,2017,2,21,Tuesday
1,9,18,27,2017,12,13,Wednseday
1,10,12,22,2018,7,16,Monday
1,9,18,27,2017,9,27,Wednseday
5,7,12,19,2017,3,10,Friday
5,19,8,27,2017,11,29,Wednseday
1,5,14,19,2017,8,30,Wednseday
10,11,8,19,2017,10,15,Sunday
3,11,7,18,2018,8,17,Friday
2,5,13,18,2018,8,25,Saturday
1,6,7,13,2018,8,10,Friday
1,15,28,43,2017,2,2,Thursday
2,22,7,29,2017,11,28,Tuesday
1,6,9,15,2018,8,16,Thursday
2,5,40,45,2018,8,11,Saturday
1,26,18,44,2018,3,19,Monday
1,6,13,19,2018,7,4,Wednseday
2,21,15,36,2017,3,28,Tuesday
7,13,10,23,2017,10,3,Tuesday
10,16,2,18,2018,8,6,Monday
1,15,9,24,2017,3,12,Sunday
1,15,12,27,2018,4,12,Thursday
4,12,8,20,2018,3,29,Thursday
3,7,13,20,2018,5,18,Friday
1,6,11,17,2018,3,27,Tuesday
4,7,11,18,2018,8,3,Friday
1,10,13,23,2017,9,5,Tuesday
1,8,17,25,2017,6,1,Thursday
1,5,15,20,2017,3,29,Wednseday
3,28,3,31,2018,2,17,Saturday
3,19,25,44,2017,2,19,Sunday
1,12,6,18,2018,4,29,Sunday
1,11,9,20,2017,9,14,Thursday
1,5,23,28,2018,6,6,Wednseday
1,13,18,31,2018,2,13,Tuesday
4,23,15,38,2017,7,2,Sunday
6,35,-13,22,2017,11,29,Wednseday
3,7,21,28,2018,8,17,Friday
2,11,11,22,2017,8,1,Tuesday
1,7,36,43,2018,8,22,Wednseday
5,12,15,27,2017,5,4,Thursday
2,2,12,14,2017,7,31,Monday
2,16,5,21,2018,5,2,Wednseday
1,17,10,27,2017,12,12,Tuesday
1,5,18,23,2017,7,30,Sunday
1,9,40,49,2018,5,31,Thursday
2,10,24,34,2017,7,8,Saturday
3,12,1,13,2018,8,10,Friday
0,13,15,28,2017,12,6,Wednseday
1,8,28,36,2018,8,16,Thursday
4,8,19,27,2017,8,17,Thursday
3,7,2,9,2018,7,30,Monday
11,20,12,32,2017,2,9,Thursday
1,9,14,23,2018,6,10,Sunday
6,16,6,22,2018,4,10,Tuesday
3,41,-10,31,2018,1,26,Friday
1,14,15,29,2017,2,23,Thursday
1,2,6,8,2018,5,22,Tuesday
1,3,6,9,2018,5,15,Tuesday
2,8,20,28,2018,7,2,Monday
4,26,7,33,2017,11,24,Friday
3,6,15,21,2018,1,12,Friday
2,18,6,24,2017,9,16,Saturday
3,12,7,19,2018,2,28,Wednseday
5,24,6,30,2017,12,3,Sunday
3,4,8,12,2018,3,31,Saturday
3,4,16,20,2018,2,17,Saturday
5,13,17,30,2017,7,8,Saturday
4,14,16,30,2017,12,16,Saturday
1,4,7,11,2018,5,10,Thursday
1,5,2,7,2018,8,2,Thursday
1,16,17,33,2017,8,17,Thursday
1,19,0,19,2018,3,7,Wednseday
17,25,-5,20,2017,11,10,Friday
2,4,7,11,2017,9,4,Monday
1,20,8,28,2018,4,19,Thursday
6,13,14,27,2018,6,20,Wednseday
1,4,12,16,2017,10,2,Monday
4,7,9,16,2017,10,2,Monday
3,24,14,38,2017,11,3,Friday
5,7,7,14,2018,5,3,Thursday
1,2,13,15,2018,6,27,Wednseday
1,16,12,28,2018,1,23,Tuesday
1,6,6,12,2018,3,8,Thursday
2,6,20,26,2017,3,1,Wednseday
1,13,16,29,2018,4,12,Thursday
2,4,19,23,2018,4,23,Monday
9,10,-2,8,2018,8,6,Monday
27,29,-2,27,2017,11,29,Wednseday
1,7,15,22,2017,8,15,Tuesday
4,26,6,32,2018,5,3,Thursday
2,3,1,4,2018,7,29,Sunday
1,14,16,30,2018,1,16,Tuesday
4,17,9,26,2017,11,24,Friday
3,22,7,29,2017,2,7,Tuesday
6,13,15,28,2018,5,24,Thursday
1,40,-18,22,2018,3,22,Thursday
5,27,8,35,2018,4,27,Friday
9,12,12,24,2018,7,1,Sunday
1,4,16,20,2017,11,29,Wednseday
5,12,17,29,2017,4,20,Thursday
7,13,14,27,2018,6,15,Friday
7,9,5,14,2017,11,23,Thursday
3,5,15,20,2017,12,16,Saturday
1,7,12,19,2017,11,16,Thursday
7,9,11,20,2017,8,16,Wednseday
6,9,10,19,2017,10,11,Wednseday
2,3,7,10,2018,7,23,Monday
1,7,20,27,2018,1,18,Thursday
20,22,-5,17,2017,10,10,Tuesday
5,44,-24,20,2018,4,28,Saturday
6,7,8,15,2018,7,31,Tuesday
1,8,21,29,2017,11,23,Thursday
2,17,3,20,2018,3,27,Tuesday
2,4,11,15,2018,4,5,Thursday
0,4,17,21,2017,7,27,Thursday
4,7,12,19,2017,9,1,Friday
1,6,21,27,2017,2,16,Thursday
2,6,13,19,2018,3,3,Saturday
2,12,14,26,2018,2,3,Saturday
1,12,8,20,2018,2,14,Wednseday
4,12,14,26,2018,1,26,Friday
2,12,24,36,2017,9,20,Wednseday
2,7,16,23,2018,1,24,Wednseday
2,3,12,15,2017,10,16,Monday
4,5,7,12,2017,5,28,Sunday
0,26,7,33,2017,3,16,Thursday
2,13,13,26,2017,5,10,Wednseday
2,7,9,16,2018,1,3,Wednseday
2,6,31,37,2017,6,24,Saturday
2,5,11,16,2017,5,15,Monday
2,9,18,27,2017,6,10,Saturday
3,30,-3,27,2018,2,21,Wednseday
3,4,14,18,2018,4,14,Saturday
2,33,-4,29,2018,4,1,Sunday
2,15,12,27,2017,8,30,Wednseday
3,11,15,26,2017,7,9,Sunday
3,15,21,36,2017,8,20,Sunday
0,4,22,26,2018,1,19,Friday
4,14,9,23,2017,6,5,Monday
4,15,20,35,2017,6,15,Thursday
16,32,-10,22,2018,7,16,Monday
9,12,12,24,2018,7,1,Sunday
10,12,14,26,2018,1,28,Sunday
4,11,8,19,2018,8,16,Thursday
1,13,7,20,2017,11,23,Thursday
0,3,18,21,2017,4,5,Wednseday
4,15,18,33,2017,6,4,Sunday
6,15,12,27,2017,5,23,Tuesday
0,1,13,14,2018,5,2,Wednseday
0,9,25,34,2017,7,20,Thursday
1,14,9,23,2017,9,12,Tuesday
3,28,-4,24,2017,12,12,Tuesday
15,22,4,26,2018,2,9,Friday
8,23,6,29,2017,10,16,Monday
0,6,2,8,2017,5,11,Thursday
2,16,11,27,2018,2,13,Tuesday
1,20,14,34,2017,7,5,Wednseday
2,13,9,22,2017,7,19,Wednseday
5,17,13,30,2017,4,15,Saturday
1,39,-17,22,2018,2,15,Thursday
6,12,8,20,2017,8,16,Wednseday
2,8,8,16,2018,5,7,Monday
1,5,20,25,2018,4,5,Thursday
7,15,14,29,2018,1,16,Tuesday
1,4,14,18,2017,11,30,Thursday
2,6,19,25,2018,8,4,Saturday
1,2,10,12,2017,7,16,Sunday
19,26,2,28,2017,9,8,Friday
2,9,18,27,2018,6,23,Saturday
4,7,18,25,2017,10,20,Friday
1,4,17,21,2018,7,16,Monday
2,4,19,23,2018,1,8,Monday
1,6,8,14,2018,7,18,Wednseday
1,16,14,30,2018,1,22,Monday
1,10,17,27,2017,10,31,Tuesday
2,13,7,20,2017,11,15,Wednseday
4,10,8,18,2017,9,15,Friday
2,5,8,13,2018,8,8,Wednseday
19,23,6,29,2017,6,11,Sunday
1,8,13,21,2018,7,19,Thursday
4,11,2,13,2018,8,3,Friday
2,3,11,14,2018,2,27,Tuesday
1,4,4,8,2018,8,23,Thursday
3,6,5,11,2018,8,3,Friday
1,12,0,12,2018,8,16,Thursday
1,7,9,16,2018,4,2,Monday
7,8,12,20,2017,10,17,Tuesday
2,9,12,21,2017,8,21,Monday
15,22,14,36,2017,11,6,Monday
3,12,33,45,2017,10,27,Friday
14,26,13,39,2017,9,14,Thursday
5,16,7,23,2017,6,25,Sunday
0,2,15,17,2017,8,29,Tuesday
1,23,15,38,2018,2,6,Tuesday
3,17,21,38,2018,4,27,Friday
1,12,9,21,2018,8,8,Wednseday
1,11,18,29,2018,2,5,Monday
4,6,5,11,2018,8,2,Thursday
2,12,41,53,2018,6,3,Sunday
1,6,6,12,2018,8,9,Thursday
4,19,13,32,2018,1,8,Monday
3,15,7,22,2017,2,26,Sunday
2,8,21,29,2017,10,3,Tuesday
4,18,8,26,2017,12,16,Saturday
2,11,13,24,2017,9,3,Sunday
1,10,19,29,2018,1,9,Tuesday
4,16,16,32,2017,5,15,Monday
3,13,14,27,2018,7,28,Saturday
4,13,13,26,2017,6,30,Friday
2,7,17,24,2018,6,9,Saturday
1,9,15,24,2017,12,3,Sunday
9,21,-1,20,2017,11,7,Tuesday
1,8,21,29,2017,12,14,Thursday
4,28,6,34,2018,1,26,Friday
4,5,14,19,2017,6,25,Sunday
3,11,13,24,2017,4,14,Friday
3,22,10,32,2018,5,6,Sunday
2,9,18,27,2018,4,3,Tuesday
1,7,22,29,2018,6,13,Wednseday
2,7,13,20,2018,3,17,Saturday
13,42,-15,27,2017,11,24,Friday
7,9,4,13,2017,6,1,Thursday
1,4,18,22,2017,3,12,Sunday
4,12,13,25,2018,5,25,Friday
3,7,21,28,2018,5,7,Monday
3,15,9,24,2017,7,31,Monday
0,6,14,20,2017,11,10,Friday
5,7,11,18,2017,9,22,Friday
6,21,11,32,2017,2,9,Thursday
1,12,23,35,2017,12,27,Wednseday
4,9,27,36,2017,9,18,Monday
3,10,11,21,2018,5,14,Monday
2,7,17,24,2018,7,16,Monday
1,9,8,17,2017,10,10,Tuesday
1,4,18,22,2017,5,15,Monday
1,14,7,21,2018,4,2,Monday
16,38,-11,27,2018,2,24,Saturday
2,8,22,30,2018,4,11,Wednseday
1,12,17,29,2017,6,7,Wednseday
1,6,17,23,2018,4,17,Tuesday
2,6,19,25,2018,5,13,Sunday
2,9,17,26,2017,2,5,Sunday
2,6,17,23,2017,8,13,Sunday
5,13,10,23,2018,4,25,Wednseday
5,10,27,37,2017,1,22,Sunday
8,15,22,37,2017,12,5,Tuesday
1,9,15,24,2018,1,16,Tuesday
3,6,12,18,2018,8,3,Friday
1,2,16,18,2018,4,15,Sunday
3,7,18,25,2017,3,31,Friday
8,18,8,26,2018,3,29,Thursday
1,2,18,20,2017,12,26,Tuesday
1,5,14,19,2018,7,5,Thursday
2,15,18,33,2017,6,7,Wednseday
5,22,17,39,2018,1,18,Thursday
2,8,21,29,2017,6,27,Tuesday
2,5,7,12,2018,7,28,Saturday
2,13,30,43,2018,6,13,Wednseday
7,8,13,21,2017,12,21,Thursday
3,15,24,39,2018,6,3,Sunday
2,23,5,28,2018,2,19,Monday
3,20,11,31,2018,1,26,Friday
7,11,3,14,2017,11,10,Friday
1,3,13,16,2018,1,2,Tuesday
8,29,14,43,2017,10,16,Monday
4,23,8,31,2018,2,4,Sunday
2,30,3,33,2017,10,14,Saturday
1,16,14,30,2017,10,1,Sunday
5,12,10,22,2017,6,22,Thursday
5,18,15,33,2017,12,22,Friday
2,3,16,19,2018,4,21,Saturday
8,13,38,51,2017,2,21,Tuesday
4,28,-4,24,2017,11,24,Friday
0,5,20,25,2018,1,5,Friday
2,20,20,40,2017,9,13,Wednseday
10,19,27,46,2018,5,26,Saturday
6,38,-9,29,2018,2,27,Tuesday
2,24,6,30,2017,9,10,Sunday
4,11,10,21,2017,8,21,Monday
1,8,14,22,2018,6,20,Wednseday
1,3,12,15,2018,4,4,Wednseday
2,9,16,25,2017,9,23,Saturday
6,6,12,18,2017,7,20,Thursday
1,10,18,28,2017,10,10,Tuesday
2,8,10,18,2018,2,26,Monday
1,5,15,20,2018,5,2,Wednseday
1,37,-13,24,2018,2,26,Monday
1,4,5,9,2018,7,29,Sunday
2,16,17,33,2018,1,7,Sunday
1,9,7,16,2018,2,6,Tuesday
0,7,15,22,2018,1,18,Thursday
1,8,29,37,2018,5,8,Tuesday
0,2,13,15,2018,7,24,Tuesday
4,6,14,20,2017,11,23,Thursday
1,8,9,17,2018,8,7,Tuesday
6,8,10,18,2018,1,4,Thursday
6,12,11,23,2017,4,26,Wednseday
3,13,6,19,2018,3,31,Saturday
14,42,-17,25,2017,10,6,Friday
2,10,11,21,2017,11,14,Tuesday
2,15,5,20,2018,8,11,Saturday
1,10,7,17,2018,8,19,Sunday
1,5,18,23,2017,10,8,Sunday
3,15,8,23,2018,5,22,Tuesday
3,14,8,22,2018,7,24,Tuesday
2,7,14,21,2018,1,17,Wednseday
8,19,9,28,2017,11,9,Thursday
2,6,18,24,2017,8,26,Saturday
1,3,6,9,2018,6,12,Tuesday
2,22,-1,21,2018,2,27,Tuesday
2,4,12,16,2018,4,2,Monday
2,7,6,13,2018,8,1,Wednseday
4,18,2,20,2018,2,23,Friday
3,14,17,31,2017,10,13,Friday
6,13,-2,11,2018,4,27,Friday
3,9,11,20,2017,10,28,Saturday
1,11,12,23,2017,6,5,Monday
1,13,8,21,2018,6,26,Tuesday
2,29,-1,28,2018,3,12,Monday
5,10,18,28,2017,7,7,Friday
3,4,11,15,2017,7,17,Monday
3,11,22,33,2018,8,11,Saturday
0,1,4,5,2018,8,29,Wednseday
3,30,1,31,2018,1,7,Sunday
3,6,21,27,2018,6,15,Friday
4,5,5,10,2018,7,20,Friday
2,9,24,33,2018,1,13,Saturday
3,7,14,21,2017,8,18,Friday
10,18,6,24,2018,4,16,Monday
6,15,8,23,2017,9,5,Tuesday
3,6,21,27,2017,4,1,Saturday
2,16,21,37,2017,11,15,Wednseday
2,14,15,29,2017,4,25,Tuesday
17,64,38,102,2017,12,25,Monday
3,7,17,24,2017,7,3,Monday
3,29,-8,21,2018,2,28,Wednseday
4,7,21,28,2018,8,16,Thursday
2,17,3,20,2018,4,3,Tuesday
2,7,21,28,2018,8,7,Tuesday
1,9,10,19,2017,4,26,Wednseday
6,12,10,22,2018,3,21,Wednseday
3,11,20,31,2017,8,21,Monday
4,15,16,31,2017,5,27,Saturday
1,20,18,38,2017,8,1,Tuesday
1,4,9,13,2017,5,18,Thursday
8,28,4,32,2018,3,5,Monday
1,27,-1,26,2018,1,31,Wednseday
2,21,4,25,2018,2,26,Monday
5,11,13,24,2017,7,22,Saturday
8,13,10,23,2018,3,6,Tuesday
1,28,-4,24,2018,2,26,Monday
2,11,19,30,2018,1,20,Saturday
0,4,11,15,2018,7,23,Monday
5,10,24,34,2017,12,29,Friday
7,8,5,13,2018,7,5,Thursday
2,20,8,28,2017,8,29,Tuesday
1,2,8,10,2018,6,25,Monday
1,10,12,22,2018,2,13,Tuesday
5,9,9,18,2018,7,19,Thursday
1,9,17,26,2017,4,6,Thursday
4,28,3,31,2018,1,5,Friday
5,11,9,20,2017,11,24,Friday
1,2,1,3,2018,7,31,Tuesday
2,7,14,21,2017,10,9,Monday
0,8,13,21,2017,9,12,Tuesday
3,11,13,24,2017,11,3,Friday
4,26,3,29,2018,6,14,Thursday
1,6,9,15,2018,5,17,Thursday
3,6,13,19,2017,10,20,Friday
0,12,35,47,2017,2,3,Friday
3,7,13,20,2017,8,4,Friday
4,17,15,32,2017,11,24,Friday
1,2,11,13,2017,8,22,Tuesday
1,31,-15,16,2018,3,7,Wednseday
1,4,13,17,2018,7,23,Monday
4,17,16,33,2018,3,16,Friday
5,25,4,29,2018,2,22,Thursday
6,12,19,31,2017,12,30,Saturday
1,10,7,17,2017,10,30,Monday
1,5,19,24,2018,7,29,Sunday
2,7,21,28,2017,9,26,Tuesday
0,6,21,27,2017,5,4,Thursday
1,2,13,15,2018,6,27,Wednseday
10,16,7,23,2017,4,24,Monday
1,2,3,5,2018,8,8,Wednseday
0,4,14,18,2017,9,15,Friday
8,15,0,15,2018,6,14,Thursday
3,16,15,31,2017,9,25,Monday
41,50,-22,28,2017,11,24,Friday
8,13,9,22,2017,9,13,Wednseday
2,4,10,14,2018,2,19,Monday
4,8,3,11,2017,7,24,Monday
5,23,10,33,2018,5,16,Wednseday
2,10,16,26,2018,2,7,Wednseday
2,14,23,37,2018,1,10,Wednseday
2,8,20,28,2018,4,25,Wednseday
1,9,13,22,2017,10,16,Monday
1,9,7,16,2017,11,21,Tuesday
4,10,7,17,2018,5,5,Saturday
3,16,5,21,2018,2,27,Tuesday
3,8,15,23,2018,2,21,Wednseday
5,15,13,28,2017,4,12,Wednseday
0,11,20,31,2018,4,17,Tuesday
2,10,9,19,2017,5,14,Sunday
5,7,9,16,2018,2,24,Saturday
1,7,10,17,2018,7,23,Monday
5,6,0,6,2018,8,10,Friday
1,8,25,33,2018,6,20,Wednseday
4,9,7,16,2017,11,21,Tuesday
4,13,8,21,2018,4,20,Friday
3,10,15,25,2017,5,5,Friday
5,20,7,27,2017,6,14,Wednseday
3,20,11,31,2018,2,3,Saturday
2,10,14,24,2017,9,16,Saturday
1,11,11,22,2017,7,6,Thursday
0,13,20,33,2017,12,28,Thursday
2,23,-6,17,2018,3,11,Sunday
1,6,22,28,2017,5,31,Wednseday
2,23,15,38,2017,4,10,Monday
1,7,20,27,2017,5,4,Thursday
2,9,19,28,2018,5,1,Tuesday
3,18,10,28,2018,1,29,Monday
0,8,11,19,2018,8,17,Friday
4,12,27,39,2018,1,11,Thursday
2,21,10,31,2018,1,29,Monday
23,24,-8,16,2018,7,8,Sunday
1,5,6,11,2018,8,6,Monday
4,19,6,25,2017,11,10,Friday
1,6,23,29,2018,6,14,Thursday
4,15,16,31,2017,5,14,Sunday
1,13,7,20,2018,3,28,Wednseday
5,6,8,14,2017,11,17,Friday
2,9,8,17,2018,4,1,Sunday
3,16,17,33,2017,8,6,Sunday
4,25,-6,19,2018,4,8,Sunday
3,23,3,26,2017,7,22,Saturday
8,14,8,22,2017,10,3,Tuesday
1,27,4,31,2018,2,13,Tuesday
2,3,14,17,2018,5,6,Sunday
1,12,15,27,2017,3,30,Thursday
2,16,11,27,2017,7,1,Saturday
0,6,26,32,2017,2,10,Friday
2,5,13,18,2018,4,8,Sunday
2,8,29,37,2017,6,14,Wednseday
1,12,15,27,2017,11,9,Thursday
9,14,13,27,2017,9,12,Tuesday
7,21,18,39,2017,8,11,Friday
1,6,20,26,2017,5,18,Thursday
1,43,-2,41,2018,5,31,Thursday
2,3,17,20,2018,4,24,Tuesday
1,9,9,18,2018,8,5,Sunday
5,14,20,34,2017,4,5,Wednseday
4,14,17,31,2018,2,2,Friday
2,43,-18,25,2017,11,25,Saturday
3,6,8,14,2018,4,27,Friday
1,4,9,13,2017,7,20,Thursday
3,14,12,26,2018,1,26,Friday
1,6,17,23,2018,8,1,Wednseday
2,3,22,25,2017,2,20,Monday
1,8,10,18,2017,11,19,Sunday
5,11,24,35,2018,7,19,Thursday
4,9,9,18,2017,10,23,Monday
0,8,13,21,2018,5,7,Monday
2,8,16,24,2017,3,13,Monday
1,2,22,24,2018,1,2,Tuesday
2,6,5,11,2018,5,10,Thursday
1,11,14,25,2017,4,23,Sunday
3,9,13,22,2018,1,14,Sunday
1,22,-1,21,2017,10,24,Tuesday
4,17,23,40,2018,6,8,Friday
2,48,-25,23,2018,2,27,Tuesday
3,5,7,12,2018,5,18,Friday
1,18,9,27,2017,9,21,Thursday
2,13,3,16,2017,11,22,Wednseday
3,7,13,20,2018,4,27,Friday
1,4,15,19,2017,11,5,Sunday
2,19,14,33,2018,2,7,Wednseday
2,15,8,23,2018,7,25,Wednseday
3,50,-24,26,2017,10,1,Sunday
0,9,29,38,2017,1,31,Tuesday
3,6,13,19,2018,7,14,Saturday
3,14,7,21,2017,11,27,Monday
4,8,14,22,2018,1,18,Thursday
2,5,6,11,2018,7,30,Monday
3,7,6,13,2017,9,2,Saturday
0,7,23,30,2018,4,16,Monday
1,15,18,33,2018,4,15,Sunday
4,22,25,47,2018,6,3,Sunday
1,7,7,14,2018,7,16,Monday
5,11,10,21,2017,3,3,Friday
0,53,-19,34,2017,3,30,Thursday
4,13,9,22,2018,3,20,Tuesday
6,17,4,21,2018,4,13,Friday
3,8,21,29,2018,3,26,Monday
2,8,15,23,2017,8,9,Wednseday
1,9,10,19,2018,4,25,Wednseday
3,44,-21,23,2017,11,13,Monday
3,10,8,18,2018,8,17,Friday
2,9,29,38,2017,7,29,Saturday
3,17,13,30,2017,7,10,Monday
1,10,10,20,2017,5,16,Tuesday
1,5,18,23,2017,4,5,Wednseday
1,2,16,18,2018,4,23,Monday
3,9,7,16,2018,7,28,Saturday
1,4,14,18,2018,4,26,Thursday
1,27,3,30,2018,2,6,Tuesday
7,14,11,25,2017,12,1,Friday
0,13,13,26,2018,4,4,Wednseday
10,11,1,12,2018,8,4,Saturday
3,10,32,42,2018,6,1,Friday
0,4,20,24,2017,5,19,Friday
9,15,53,68,2017,1,25,Wednseday
3,16,0,16,2018,8,6,Monday
2,9,17,26,2017,7,19,Wednseday
2,8,30,38,2018,1,22,Monday
9,19,27,46,2018,5,26,Saturday
1,2,23,25,2018,8,19,Sunday
1,5,22,27,2018,1,4,Thursday
5,25,1,26,2017,9,30,Saturday
3,15,10,25,2018,1,14,Sunday
6,7,1,8,2018,8,23,Thursday
1,4,25,29,2017,5,21,Sunday
2,15,6,21,2018,2,27,Tuesday
25,28,6,34,2018,2,10,Saturday
3,26,0,26,2017,11,25,Saturday
10,14,4,18,2018,8,10,Friday
2,12,10,22,2018,3,15,Thursday
3,17,23,40,2018,6,1,Friday
3,15,6,21,2017,10,10,Tuesday
4,13,6,19,2018,3,9,Friday
2,10,10,20,2017,7,15,Saturday
6,19,21,40,2018,4,19,Thursday
7,15,27,42,2017,3,16,Thursday
1,8,12,20,2017,8,31,Thursday
4,7,49,56,2017,1,30,Monday
4,41,-13,28,2017,10,12,Thursday
2,6,5,11,2018,8,4,Saturday
4,16,7,23,2018,1,9,Tuesday
6,14,-1,13,2018,3,21,Wednseday
2,11,8,19,2017,11,26,Sunday
3,7,18,25,2018,1,5,Friday
6,24,7,31,2017,11,25,Saturday
9,11,4,15,2017,11,12,Sunday
2,4,42,46,2018,6,2,Saturday
1,29,0,29,2017,12,11,Monday
2,10,6,16,2018,8,1,Wednseday
2,9,11,20,2018,2,27,Tuesday
2,10,19,29,2018,2,12,Monday
1,18,12,30,2017,4,23,Sunday
1,34,1,35,2018,5,2,Wednseday
1,20,12,32,2017,11,24,Friday
5,15,10,25,2017,8,27,Sunday
1,8,17,25,2018,4,22,Sunday
2,13,17,30,2017,12,3,Sunday
3,25,-4,21,2018,6,12,Tuesday
4,11,13,24,2018,2,23,Friday
3,13,14,27,2018,5,5,Saturday
6,21,5,26,2017,12,27,Wednseday
21,21,22,43,2017,2,20,Monday
3,14,5,19,2017,9,15,Friday
1,5,17,22,2017,10,26,Thursday
4,12,13,25,2017,6,16,Friday
1,21,21,42,2018,2,20,Tuesday
2,6,12,18,2018,2,24,Saturday
6,19,3,22,2018,2,1,Thursday
2,9,9,18,2017,10,22,Sunday
4,14,19,33,2017,12,7,Thursday
1,21,9,30,2017,9,17,Sunday
4,14,11,25,2017,8,18,Friday
2,8,18,26,2018,8,19,Sunday
0,5,28,33,2017,2,8,Wednseday
2,16,8,24,2017,4,2,Sunday
2,8,10,18,2018,4,30,Monday
1,6,16,22,2018,7,3,Tuesday
2,8,26,34,2018,2,7,Wednseday
4,12,20,32,2017,12,23,Saturday
2,3,17,20,2017,12,16,Saturday
8,13,14,27,2017,12,7,Thursday
4,6,14,20,2018,1,6,Saturday
3,8,10,18,2018,4,30,Monday
1,7,28,35,2017,9,25,Monday
0,1,12,13,2018,2,28,Wednseday
5,19,7,26,2017,10,15,Sunday
5,10,8,18,2017,5,12,Friday
3,9,5,14,2018,4,24,Tuesday
2,10,5,15,2017,11,12,Sunday
2,20,4,24,2018,5,12,Saturday
3,7,10,17,2018,7,13,Friday
1,15,16,31,2017,5,8,Monday
0,7,18,25,2017,6,1,Thursday
1,11,14,25,2017,8,24,Thursday
4,12,15,27,2017,8,24,Thursday
0,6,16,22,2017,4,13,Thursday
5,13,12,25,2017,4,1,Saturday
2,25,26,51,2018,6,16,Saturday
6,7,18,25,2018,6,1,Friday
2,10,15,25,2017,6,12,Monday
2,8,9,17,2018,6,25,Monday
3,6,27,33,2018,4,13,Friday
2,24,-1,23,2018,3,18,Sunday
1,2,14,16,2018,4,9,Monday
6,8,25,33,2017,12,21,Thursday
3,35,-10,25,2018,3,11,Sunday
5,7,9,16,2018,2,10,Saturday
1,12,15,27,2018,1,4,Thursday
2,7,6,13,2018,8,1,Wednseday
1,24,6,30,2018,1,21,Sunday
15,19,4,23,2018,5,9,Wednseday
0,10,14,24,2017,7,11,Tuesday
4,12,12,24,2017,6,23,Friday
1,13,14,27,2017,11,29,Wednseday
4,10,9,19,2017,3,3,Friday
3,6,17,23,2017,9,16,Saturday
2,16,15,31,2017,10,9,Monday
1,21,4,25,2017,8,21,Monday
0,3,11,14,2017,11,28,Tuesday
3,15,5,20,2017,7,11,Tuesday
1,4,20,24,2017,9,26,Tuesday
1,10,22,32,2018,6,18,Monday
5,12,12,24,2018,2,17,Saturday
1,2,13,15,2018,6,11,Monday
2,8,17,25,2018,6,17,Sunday
8,9,1,10,2017,11,21,Tuesday
3,25,9,34,2018,1,30,Tuesday
2,6,7,13,2018,8,18,Saturday
4,10,4,14,2018,8,17,Friday
5,13,18,31,2018,2,10,Saturday
1,5,17,22,2017,10,22,Sunday
1,7,28,35,2017,9,25,Monday
2,11,6,17,2018,8,11,Saturday
4,5,13,18,2017,11,30,Thursday
4,6,15,21,2018,2,20,Tuesday
1,8,24,32,2017,2,2,Thursday
4,14,7,21,2018,4,6,Friday
1,15,20,35,2017,10,26,Thursday
2,5,28,33,2017,2,4,Saturday
2,14,8,22,2017,7,19,Wednseday
1,3,7,10,2018,7,29,Sunday
1,7,27,34,2018,4,25,Wednseday
11,14,22,36,2018,7,12,Thursday
2,11,22,33,2018,2,17,Saturday
1,6,17,23,2017,2,7,Tuesday
1,3,15,18,2018,2,26,Monday
2,13,-3,10,2018,8,11,Saturday
4,7,10,17,2018,8,17,Friday
0,12,20,32,2017,12,15,Friday
15,37,12,49,2018,1,22,Monday
1,3,10,13,2017,7,18,Tuesday
3,11,13,24,2017,9,15,Friday
1,7,15,22,2017,10,12,Thursday
3,18,11,29,2018,4,16,Monday
1,17,5,22,2018,4,26,Thursday
9,12,8,20,2017,11,15,Wednseday
1,7,15,22,2017,10,17,Tuesday
4,5,6,11,2017,10,15,Sunday
1,8,18,26,2017,7,19,Wednseday
4,5,13,18,2018,4,6,Friday
2,17,1,18,2018,4,8,Sunday
1,3,12,15,2018,8,20,Monday
2,16,8,24,2017,7,18,Tuesday
1,4,9,13,2018,7,24,Tuesday
0,7,16,23,2018,6,12,Tuesday
3,10,4,14,2018,7,13,Friday
3,12,12,24,2018,8,17,Friday
4,13,7,20,2018,2,16,Friday
3,24,7,31,2018,4,6,Friday
1,3,6,9,2018,7,31,Tuesday
7,8,2,10,2017,10,16,Monday
2,15,5,20,2017,11,8,Wednseday
0,6,15,21,2018,4,12,Thursday
2,13,14,27,2017,5,31,Wednseday
3,6,7,13,2018,8,24,Friday
1,3,14,17,2018,4,9,Monday
3,5,11,16,2018,6,25,Monday
1,7,18,25,2017,11,23,Thursday
5,7,18,25,2018,6,28,Thursday
1,11,13,24,2018,1,23,Tuesday
1,6,11,17,2018,5,15,Tuesday
3,5,9,14,2018,1,26,Friday
1,8,30,38,2017,2,5,Sunday
1,5,13,18,2018,6,10,Sunday
0,10,15,25,2017,5,8,Monday
1,16,14,30,2018,1,22,Monday
4,13,29,42,2017,11,24,Friday
3,6,7,13,2018,8,3,Friday
5,13,12,25,2017,7,13,Thursday
3,8,12,20,2017,10,10,Tuesday
1,50,-17,33,2018,3,15,Thursday
2,14,4,18,2018,2,19,Monday
1,3,14,17,2018,7,3,Tuesday
7,15,21,36,2018,2,7,Wednseday
5,18,14,32,2018,5,17,Thursday
1,10,15,25,2018,8,20,Monday
3,13,12,25,2017,5,27,Saturday
3,10,15,25,2018,6,30,Saturday
19,27,48,75,2017,8,30,Wednseday
4,13,13,26,2018,3,23,Friday
5,31,-11,20,2017,5,12,Friday
1,8,20,28,2018,1,8,Monday
5,10,29,39,2017,7,7,Friday
3,9,15,24,2017,9,24,Sunday
2,12,16,28,2018,4,12,Thursday
1,8,17,25,2017,5,25,Thursday
1,16,8,24,2018,4,1,Sunday
8,13,11,24,2017,8,15,Tuesday
1,22,1,23,2018,3,19,Monday
1,2,11,13,2018,3,20,Tuesday
5,8,-4,4,2018,8,5,Sunday
1,14,8,22,2018,7,9,Monday
2,17,6,23,2017,3,14,Tuesday
2,4,2,6,2018,8,4,Saturday
0,5,28,33,2017,8,23,Wednseday
14,23,5,28,2017,9,18,Monday
4,19,11,30,2018,7,28,Saturday
1,13,15,28,2018,1,3,Wednseday
1,14,5,19,2018,3,14,Wednseday
1,8,15,23,2017,11,13,Monday
5,11,13,24,2018,2,16,Friday
2,3,1,4,2018,8,19,Sunday
1,6,23,29,2018,4,3,Tuesday
1,20,1,21,2017,6,6,Tuesday
1,57,-33,24,2018,2,5,Monday
3,8,16,24,2018,1,26,Friday
4,9,21,30,2018,6,30,Saturday
20,28,-3,25,2018,1,20,Saturday
5,9,28,37,2017,12,3,Sunday
9,22,5,27,2017,6,7,Wednseday
1,2,14,16,2018,4,10,Tuesday
5,17,15,32,2017,12,29,Friday
1,9,41,50,2018,6,4,Monday
2,14,3,17,2018,3,26,Monday
2,10,8,18,2018,3,31,Saturday
2,20,16,36,2017,6,28,Wednseday
1,7,14,21,2017,3,16,Thursday
1,14,2,16,2018,3,5,Monday
2,7,16,23,2018,3,21,Wednseday
2,11,11,22,2017,4,11,Tuesday
1,7,20,27,2018,6,14,Thursday
3,10,7,17,2018,4,30,Monday
0,3,15,18,2017,7,24,Monday
3,13,11,24,2017,7,7,Friday
6,9,24,33,2017,7,5,Wednseday
2,9,9,18,2018,4,8,Sunday
1,8,9,17,2018,6,12,Tuesday
2,7,18,25,2017,5,27,Saturday
5,17,15,32,2018,2,25,Sunday
1,21,5,26,2018,1,31,Wednseday
4,11,18,29,2017,11,27,Monday
2,13,14,27,2017,1,31,Tuesday
1,9,6,15,2018,5,23,Wednseday
5,10,17,27,2018,6,8,Friday
3,14,14,28,2018,1,22,Monday
6,18,8,26,2017,4,20,Thursday
4,18,20,38,2017,4,22,Saturday
2,15,4,19,2017,11,26,Sunday
2,14,10,24,2017,10,3,Tuesday
1,6,14,20,2017,11,22,Wednseday
0,13,12,25,2017,5,25,Thursday
0,13,13,26,2017,7,19,Wednseday
1,10,11,21,2018,5,8,Tuesday
2,9,12,21,2017,4,24,Monday
1,4,15,19,2018,1,11,Thursday
1,8,19,27,2017,12,7,Thursday
1,7,12,19,2017,10,19,Thursday
1,22,7,29,2018,4,12,Thursday
4,14,24,38,2018,6,29,Friday
1,4,26,30,2017,3,20,Monday
1,7,13,20,2017,5,23,Tuesday
2,13,7,20,2018,5,12,Saturday
2,17,25,42,2017,5,22,Monday
4,13,20,33,2017,12,24,Sunday
1,9,20,29,2018,7,4,Wednseday
1,26,9,35,2017,12,28,Thursday
3,15,8,23,2017,10,29,Sunday
4,14,10,24,2018,1,16,Tuesday
2,3,10,13,2018,7,11,Wednseday
1,2,13,15,2017,9,20,Wednseday
1,16,3,19,2018,7,11,Wednseday
1,8,14,22,2017,5,16,Tuesday
3,27,6,33,2017,12,8,Friday
0,4,20,24,2017,7,28,Friday
0,12,29,41,2018,5,25,Friday
3,9,15,24,2017,5,28,Sunday
2,8,11,19,2017,10,11,Wednseday
2,12,14,26,2018,1,20,Saturday
3,9,-4,5,2018,8,5,Sunday
1,22,8,30,2018,2,13,Tuesday
7,8,13,21,2017,11,27,Monday
3,6,12,18,2017,5,12,Friday
5,13,19,32,2018,4,27,Friday
2,3,13,16,2018,7,10,Tuesday
2,6,14,20,2017,5,17,Wednseday
0,1,14,15,2018,4,12,Thursday
0,5,22,27,2018,7,5,Thursday
3,4,21,25,2018,6,1,Friday
7,13,9,22,2017,10,17,Tuesday
1,15,-4,11,2017,7,10,Monday
1,6,17,23,2017,4,4,Tuesday
2,4,10,14,2018,8,6,Monday
1,3,7,10,2018,5,14,Monday
4,5,12,17,2018,1,19,Friday
1,5,23,28,2017,9,11,Monday
3,4,5,9,2018,5,21,Monday
6,13,7,20,2017,8,10,Thursday
2,16,9,25,2017,11,25,Saturday
3,13,13,26,2017,8,11,Friday
2,8,22,30,2018,5,6,Sunday
1,12,11,23,2017,7,2,Sunday
1,2,14,16,2018,1,3,Wednseday
4,11,13,24,2017,5,19,Friday
1,8,14,22,2017,11,22,Wednseday
1,5,9,14,2018,7,26,Thursday
26,30,-9,21,2017,6,14,Wednseday
1,6,15,21,2017,3,23,Thursday
4,6,21,27,2017,2,9,Thursday
2,11,4,15,2018,5,21,Monday
2,8,21,29,2017,7,31,Monday
2,3,20,23,2017,6,3,Saturday
3,24,22,46,2018,5,12,Saturday
2,10,27,37,2018,7,1,Sunday
3,12,6,18,2018,3,4,Sunday
7,20,19,39,2017,6,9,Friday
2,5,14,19,2017,6,14,Wednseday
2,11,19,30,2018,2,4,Sunday
0,5,12,17,2018,8,24,Friday
4,25,-10,15,2017,9,21,Thursday
7,19,2,21,2017,6,16,Friday
0,12,13,25,2017,3,17,Friday
2,8,9,17,2017,9,12,Tuesday
2,9,22,31,2017,2,21,Tuesday
3,6,20,26,2017,4,7,Friday
0,9,5,14,2018,3,29,Thursday
0,8,18,26,2017,12,21,Thursday
4,10,23,33,2017,11,24,Friday
3,9,11,20,2017,12,8,Friday
3,7,28,35,2018,7,3,Tuesday
4,18,8,26,2018,5,3,Thursday
1,18,16,34,2018,6,21,Thursday
3,10,14,24,2017,7,4,Tuesday
4,10,10,20,2017,11,25,Saturday
3,17,32,49,2017,2,14,Tuesday
2,24,-10,14,2018,5,7,Monday
4,37,-17,20,2018,3,1,Thursday
2,11,26,37,2018,5,12,Saturday
3,20,10,30,2017,9,26,Tuesday
1,12,20,32,2018,4,22,Sunday
3,6,11,17,2018,7,21,Saturday
2,31,-11,20,2018,2,20,Tuesday
1,9,20,29,2018,2,7,Wednseday
2,6,21,27,2017,9,26,Tuesday
8,14,15,29,2018,1,16,Tuesday
1,4,13,17,2017,11,20,Monday
1,7,13,20,2017,11,28,Tuesday
1,3,5,8,2018,8,6,Monday
7,19,13,32,2018,8,2,Thursday
3,17,11,28,2018,1,19,Friday
2,6,3,9,2018,8,15,Wednseday
1,13,11,24,2017,7,25,Tuesday
1,7,19,26,2017,3,30,Thursday
2,8,35,43,2018,8,20,Monday
5,29,-8,21,2017,3,8,Wednseday
1,11,4,15,2018,5,8,Tuesday
2,6,29,35,2018,1,17,Wednseday
2,5,21,26,2018,4,4,Wednseday
2,5,18,23,2017,3,11,Saturday
3,9,11,20,2018,3,24,Saturday
1,9,37,46,2017,1,30,Monday
6,10,16,26,2018,6,22,Friday
1,6,15,21,2018,5,2,Wednseday
0,2,1,3,2018,8,28,Tuesday
1,4,18,22,2018,7,3,Tuesday
3,6,4,10,2017,9,12,Tuesday
2,5,13,18,2018,7,21,Saturday
1,7,15,22,2017,9,12,Tuesday
1,15,8,23,2018,3,20,Tuesday
1,4,9,13,2017,6,1,Thursday
4,8,7,15,2018,8,9,Thursday
1,7,12,19,2018,5,2,Wednseday
2,3,6,9,2018,5,15,Tuesday
1,30,-5,25,2017,11,27,Monday
3,7,10,17,2017,9,22,Friday
2,7,20,27,2017,6,3,Saturday
13,32,-3,29,2018,1,4,Thursday
4,7,19,26,2018,8,10,Friday
2,7,9,16,2017,9,19,Tuesday
14,22,33,55,2017,12,26,Tuesday
4,26,2,28,2018,5,10,Thursday
6,11,15,26,2018,2,16,Friday
0,1,15,16,2018,1,17,Wednseday
1,5,18,23,2017,11,26,Sunday
0,20,12,32,2018,1,19,Friday
2,6,23,29,2018,7,29,Sunday
0,8,22,30,2017,10,24,Tuesday
35,45,14,59,2016,10,10,Monday
0,3,10,13,2018,3,28,Wednseday
4,9,8,17,2018,4,3,Tuesday
3,11,26,37,2018,6,9,Saturday
8,17,18,35,2018,6,26,Tuesday
7,15,23,38,2018,5,28,Monday
1,18,9,27,2018,7,12,Thursday
1,9,18,27,2018,1,23,Tuesday
1,6,6,12,2018,8,22,Wednseday
15,21,34,55,2016,10,6,Thursday
4,10,25,35,2017,5,12,Friday
1,7,17,24,2017,7,11,Tuesday
2,9,15,24,2017,7,25,Tuesday
3,21,5,26,2017,12,3,Sunday
7,8,13,21,2017,12,21,Thursday
4,7,11,18,2018,1,1,Monday
4,24,-3,21,2018,3,23,Friday
2,11,6,17,2018,4,1,Sunday
1,14,15,29,2018,3,20,Tuesday
2,10,18,28,2018,1,9,Tuesday
9,19,13,32,2017,7,29,Saturday
3,12,12,24,2017,4,21,Friday
1,8,6,14,2017,11,15,Wednseday
2,5,27,32,2018,8,11,Saturday
1,6,14,20,2017,7,19,Wednseday
3,10,15,25,2018,4,22,Sunday
1,13,10,23,2018,2,20,Tuesday
1,5,17,22,2017,9,13,Wednseday
1,2,16,18,2017,12,18,Monday
2,23,0,23,2018,3,3,Saturday
0,2,2,4,2018,8,13,Monday
2,6,24,30,2018,4,17,Tuesday
2,3,8,11,2017,8,28,Monday
7,12,14,26,2018,2,7,Wednseday
2,11,10,21,2018,2,20,Tuesday
1,8,10,18,2017,11,27,Monday
1,4,15,19,2018,8,26,Sunday
1,13,15,28,2017,6,20,Tuesday
11,14,61,75,2016,10,6,Thursday
3,11,22,33,2017,5,20,Saturday
2,20,11,31,2017,12,16,Saturday
9,10,8,18,2018,3,19,Monday
3,4,10,14,2018,2,26,Monday
1,15,10,25,2018,2,19,Monday
11,15,27,42,2018,7,6,Friday
4,11,8,19,2017,7,23,Sunday
2,6,21,27,2017,8,12,Saturday
3,9,6,15,2018,1,16,Tuesday
10,11,22,33,2018,6,15,Friday
2,6,10,16,2017,6,20,Tuesday
1,8,14,22,2017,4,10,Monday
2,7,15,22,2018,8,22,Wednseday
3,6,18,24,2017,10,20,Friday
2,13,3,16,2018,7,25,Wednseday
4,13,9,22,2017,6,22,Thursday
1,8,22,30,2017,12,13,Wednseday
8,22,-3,19,2017,7,5,Wednseday
1,2,12,14,2017,11,23,Thursday
3,7,19,26,2017,3,31,Friday
4,11,18,29,2018,1,11,Thursday
2,4,13,17,2018,2,4,Sunday
3,13,7,20,2018,6,8,Friday
2,8,15,23,2017,10,9,Monday
5,18,6,24,2018,4,6,Friday
9,14,20,34,2018,6,26,Tuesday
3,12,19,31,2018,4,6,Friday
5,10,17,27,2017,6,9,Friday
3,9,16,25,2017,10,7,Saturday
0,30,-7,23,2018,1,16,Tuesday
3,9,12,21,2018,1,16,Tuesday
2,7,18,25,2017,10,2,Monday
3,7,13,20,2018,6,29,Friday
12,14,16,30,2018,3,17,Saturday
1,18,11,29,2018,3,8,Thursday
1,9,12,21,2017,3,14,Tuesday
1,3,7,10,2018,6,10,Sunday
0,6,5,11,2018,8,16,Thursday
1,10,25,35,2017,4,10,Monday
3,9,9,18,2018,5,7,Monday
4,12,15,27,2018,6,7,Thursday
2,3,6,9,2018,7,28,Saturday
0,7,9,16,2018,4,10,Tuesday
3,11,18,29,2017,2,13,Monday
5,12,11,23,2017,7,5,Wednseday
8,26,9,35,2017,12,11,Monday
3,8,17,25,2017,10,22,Sunday
8,42,-11,31,2018,1,19,Friday
4,14,8,22,2018,2,1,Thursday
1,32,5,37,2018,1,29,Monday
2,13,9,22,2017,9,13,Wednseday
1,2,13,15,2018,1,23,Tuesday
6,13,10,23,2018,4,11,Wednseday
2,24,5,29,2018,4,16,Monday
10,17,11,28,2018,4,27,Friday
2,5,17,22,2018,7,29,Sunday
6,11,20,31,2017,6,16,Friday
5,9,12,21,2017,9,20,Wednseday
1,15,10,25,2018,1,8,Monday
0,6,8,14,2018,7,31,Tuesday
3,30,-5,25,2018,2,17,Saturday
1,9,14,23,2017,6,7,Wednseday
4,7,17,24,2018,7,6,Friday
4,17,5,22,2017,11,26,Sunday
1,3,18,21,2017,8,22,Tuesday
1,10,14,24,2018,2,5,Monday
0,8,18,26,2018,1,4,Thursday
1,17,5,22,2018,5,3,Thursday
1,7,21,28,2017,11,28,Tuesday
2,20,4,24,2017,11,25,Saturday
2,4,32,36,2017,2,19,Sunday
2,14,1,15,2018,2,14,Wednseday
3,19,12,31,2017,12,23,Saturday
0,12,15,27,2017,4,26,Wednseday
1,7,15,22,2017,11,15,Wednseday
1,11,4,15,2017,9,3,Sunday
2,17,4,21,2018,3,5,Monday
4,21,19,40,2017,10,19,Thursday
4,12,14,26,2018,7,22,Sunday
7,10,11,21,2018,7,3,Tuesday
5,19,5,24,2018,5,18,Friday
7,14,6,20,2017,9,20,Wednseday
2,8,8,16,2018,2,7,Wednseday
5,8,12,20,2017,11,24,Friday
3,8,8,16,2018,5,20,Sunday
2,10,14,24,2018,3,24,Saturday
2,8,19,27,2018,2,27,Tuesday
1,10,13,23,2017,4,3,Monday
3,26,-9,17,2018,3,11,Sunday
0,6,33,39,2018,6,29,Friday
1,18,6,24,2017,3,12,Sunday
0,3,11,14,2017,11,24,Friday
1,21,-5,16,2018,5,14,Monday
2,17,6,23,2018,3,25,Sunday
2,7,17,24,2018,1,22,Monday
2,16,2,18,2018,4,2,Monday
3,9,21,30,2018,1,20,Saturday
1,7,15,22,2017,8,29,Tuesday
4,10,12,22,2017,8,14,Monday
3,16,31,47,2018,6,2,Saturday
3,24,6,30,2018,1,15,Monday
2,6,16,22,2018,6,19,Tuesday
2,10,17,27,2018,4,24,Tuesday
6,8,6,14,2017,11,8,Wednseday
1,17,10,27,2018,5,15,Tuesday
2,20,14,34,2018,4,7,Saturday
1,2,11,13,2018,5,2,Wednseday
6,13,7,20,2018,7,17,Tuesday
2,7,13,20,2017,6,20,Tuesday
4,10,25,35,2017,2,3,Friday
2,8,25,33,2018,8,15,Wednseday
1,14,8,22,2017,7,12,Wednseday
2,10,16,26,2017,5,7,Sunday
3,7,10,17,2018,5,4,Friday
1,5,11,16,2017,9,13,Wednseday
5,13,14,27,2018,1,18,Thursday
4,11,7,18,2018,7,30,Monday
6,28,-3,25,2017,11,24,Friday
0,3,22,25,2018,4,16,Monday
2,7,17,24,2017,5,29,Monday
1,6,14,20,2017,3,7,Tuesday
4,19,15,34,2018,5,4,Friday
5,26,-1,25,2017,11,17,Friday
1,4,17,21,2018,1,15,Monday
0,5,17,22,2018,6,20,Wednseday
3,10,7,17,2017,10,15,Sunday
4,20,18,38,2017,5,12,Friday
5,16,3,19,2018,3,22,Thursday
3,6,10,16,2018,8,18,Saturday
1,15,21,36,2018,6,5,Tuesday
1,20,14,34,2018,1,3,Wednseday
0,4,10,14,2018,6,29,Friday
2,6,7,13,2017,7,5,Wednseday
2,10,13,23,2018,3,11,Sunday
7,17,18,35,2017,5,19,Friday
8,26,-3,23,2018,2,21,Wednseday
1,3,7,10,2018,7,31,Tuesday
4,24,9,33,2018,4,6,Friday
2,9,24,33,2018,1,3,Wednseday
3,10,23,33,2018,6,1,Friday
6,41,-21,20,2018,3,7,Wednseday
2,7,15,22,2017,4,20,Thursday
3,25,4,29,2017,9,17,Sunday
6,12,12,24,2017,12,22,Friday
1,34,-5,29,2018,2,21,Wednseday
4,18,17,35,2017,6,8,Thursday
7,9,2,11,2017,7,24,Monday
1,24,15,39,2018,1,22,Monday
1,4,16,20,2017,3,16,Thursday
21,27,8,35,2017,5,4,Thursday
2,5,10,15,2017,7,5,Wednseday
4,7,21,28,2017,2,9,Thursday
1,10,9,19,2017,3,1,Wednseday
3,10,15,25,2017,11,24,Friday
2,5,19,24,2017,7,9,Sunday
5,13,14,27,2018,4,5,Thursday
3,7,10,17,2018,7,23,Monday
2,10,13,23,2017,5,2,Tuesday
1,6,16,22,2017,8,1,Tuesday
2,6,4,10,2018,5,13,Sunday
2,11,19,30,2017,9,26,Tuesday
2,5,22,27,2018,6,6,Wednseday
1,8,10,18,2017,11,13,Monday
2,9,11,20,2017,7,12,Wednseday
1,8,19,27,2018,1,18,Thursday
3,4,14,18,2017,9,29,Friday
1,8,13,21,2018,5,15,Tuesday
4,9,3,12,2018,3,8,Thursday
1,24,7,31,2018,1,30,Tuesday
2,11,12,23,2017,6,18,Sunday
1,10,12,22,2018,4,3,Tuesday
1,6,20,26,2018,6,7,Thursday
3,10,5,15,2018,1,23,Tuesday
1,14,17,31,2017,10,24,Tuesday
4,11,11,22,2017,11,16,Thursday
1,3,14,17,2018,5,22,Tuesday
3,9,23,32,2018,6,2,Saturday
4,11,11,22,2017,5,15,Monday
1,4,19,23,2018,8,26,Sunday
1,10,12,22,2017,7,18,Tuesday
1,15,1,16,2017,11,21,Tuesday
3,13,18,31,2018,4,21,Saturday
2,9,19,28,2017,12,18,Monday
9,21,14,35,2017,6,7,Wednseday
0,1,7,8,2018,7,31,Tuesday
8,9,10,19,2018,1,21,Sunday
1,8,11,19,2018,8,8,Wednseday
0,11,7,18,2018,3,9,Friday
2,14,11,25,2018,4,9,Monday
3,6,9,15,2017,6,20,Tuesday
4,10,25,35,2017,2,10,Friday
2,10,14,24,2017,3,13,Monday
2,3,13,16,2018,4,3,Tuesday
0,11,8,19,2018,3,29,Thursday
2,20,5,25,2018,2,22,Thursday
4,30,13,43,2018,7,8,Sunday
9,11,11,22,2017,5,22,Monday
1,8,27,35,2018,6,26,Tuesday
0,9,22,31,2018,2,5,Monday
2,15,14,29,2018,3,7,Wednseday
2,9,17,26,2018,1,21,Sunday
1,8,21,29,2017,12,5,Tuesday
11,26,6,32,2018,3,15,Thursday
1,3,20,23,2018,5,29,Tuesday
1,17,16,33,2018,2,16,Friday
1,10,16,26,2017,9,24,Sunday
2,11,14,25,2018,1,14,Sunday
2,17,16,33,2017,12,17,Sunday
1,25,11,36,2017,12,13,Wednseday
1,2,15,17,2017,12,11,Monday
3,5,14,19,2018,4,27,Friday
1,3,27,30,2017,7,10,Monday
4,36,-10,26,2018,3,30,Friday
3,5,13,18,2018,7,28,Saturday
1,13,7,20,2018,2,23,Friday
1,8,12,20,2018,2,21,Wednseday
2,9,15,24,2017,9,5,Tuesday
1,7,24,31,2018,6,18,Monday
6,8,25,33,2018,3,21,Wednseday
1,6,11,17,2018,6,12,Tuesday
13,20,18,38,2017,7,7,Friday
0,1,19,20,2018,1,10,Wednseday
2,3,10,13,2017,10,21,Saturday
1,15,8,23,2018,1,23,Tuesday
0,5,15,20,2017,8,2,Wednseday
2,4,20,24,2017,9,30,Saturday
3,17,5,22,2018,2,19,Monday
14,42,-18,24,2017,8,8,Tuesday
2,3,23,26,2018,6,2,Saturday
4,13,11,24,2017,11,12,Sunday
4,12,16,28,2017,11,9,Thursday
13,20,6,26,2017,12,14,Thursday
1,8,6,14,2018,4,26,Thursday
2,7,8,15,2018,1,24,Wednseday
1,11,13,24,2018,1,16,Tuesday
2,8,7,15,2018,8,1,Wednseday
2,11,19,30,2017,3,6,Monday
35,40,13,53,2016,10,7,Friday
1,4,19,23,2017,10,22,Sunday
2,23,-3,20,2017,11,29,Wednseday
1,2,11,13,2017,5,25,Thursday
2,25,5,30,2018,3,3,Saturday
4,16,24,40,2018,1,20,Saturday
5,11,9,20,2017,7,7,Friday
2,14,14,28,2018,4,18,Wednseday
0,10,17,27,2017,5,5,Friday
5,15,17,32,2018,4,12,Thursday
0,1,12,13,2017,8,16,Wednseday
5,10,13,23,2017,4,1,Saturday
2,10,17,27,2018,1,20,Saturday
4,14,20,34,2018,4,3,Tuesday
1,6,20,26,2018,4,18,Wednseday
4,5,7,12,2018,7,19,Thursday
4,13,19,32,2017,7,6,Thursday
7,15,6,21,2018,7,30,Monday
1,11,9,20,2017,11,23,Thursday
2,20,-4,16,2018,5,22,Tuesday
1,6,16,22,2018,5,15,Tuesday
2,3,13,16,2017,10,2,Monday
2,15,10,25,2018,2,26,Monday
9,19,26,45,2018,6,2,Saturday
1,10,11,21,2018,5,22,Tuesday
6,18,8,26,2017,7,27,Thursday
3,6,27,33,2017,8,19,Saturday
1,7,10,17,2018,7,16,Monday
2,11,19,30,2017,9,26,Tuesday
5,15,12,27,2017,11,24,Friday
4,19,4,23,2018,2,18,Sunday
2,7,12,19,2018,6,9,Saturday
3,10,1,11,2018,8,6,Monday
0,10,14,24,2017,12,18,Monday
2,10,36,46,2018,6,2,Saturday
13,16,6,22,2018,8,7,Tuesday
3,4,7,11,2017,9,17,Sunday
1,18,20,38,2017,6,5,Monday
2,5,11,16,2018,6,13,Wednseday
8,35,-7,28,2018,5,8,Tuesday
3,20,7,27,2018,1,26,Friday
2,13,25,38,2018,1,27,Saturday
3,11,13,24,2018,4,16,Monday
4,10,15,25,2017,10,22,Sunday
2,10,19,29,2018,5,7,Monday
4,5,8,13,2017,7,6,Thursday
2,8,25,33,2017,8,24,Thursday
1,11,15,26,2017,11,19,Sunday
6,19,9,28,2018,6,20,Wednseday
5,7,8,15,2017,8,17,Thursday
7,23,-8,15,2018,1,16,Tuesday
8,13,21,34,2018,5,22,Tuesday
1,3,13,16,2018,1,30,Tuesday
2,6,27,33,2018,6,2,Saturday
5,10,35,45,2018,2,25,Sunday
1,14,12,26,2018,1,24,Wednseday
3,8,17,25,2017,7,23,Sunday
2,4,7,11,2018,6,10,Sunday
4,5,12,17,2018,1,19,Friday
5,12,17,29,2018,6,21,Thursday
2,3,14,17,2018,6,3,Sunday
1,3,20,23,2017,12,26,Tuesday
0,10,15,25,2018,7,16,Monday
2,20,9,29,2018,2,7,Wednseday
4,9,12,21,2018,1,18,Thursday
9,20,4,24,2018,3,20,Tuesday
3,8,7,15,2017,6,11,Sunday
8,18,0,18,2018,3,8,Thursday
5,32,0,32,2018,2,15,Thursday
3,36,-15,21,2018,3,2,Friday
1,14,17,31,2017,8,14,Monday
1,13,18,31,2017,3,28,Tuesday
3,11,13,24,2017,7,10,Monday
1,5,10,15,2018,4,23,Monday
5,20,13,33,2018,5,18,Friday
1,10,18,28,2018,4,16,Monday
1,5,9,14,2018,4,26,Thursday
2,10,20,30,2018,4,30,Monday
1,8,6,14,2018,8,7,Tuesday
1,5,19,24,2018,5,6,Sunday
1,46,-17,29,2017,12,19,Tuesday
0,7,15,22,2017,7,19,Wednseday
2,7,13,20,2018,7,24,Tuesday
2,12,21,33,2018,5,26,Saturday
5,12,14,26,2018,7,25,Wednseday
1,12,11,23,2017,4,5,Wednseday
2,9,12,21,2018,4,23,Monday
9,23,17,40,2017,8,16,Wednseday
2,9,25,34,2017,10,4,Wednseday
1,2,8,10,2018,5,7,Monday
6,21,-4,17,2018,5,22,Tuesday
2,12,25,37,2018,6,9,Saturday
3,28,4,32,2018,4,14,Saturday
3,4,13,17,2017,8,19,Saturday
4,9,22,31,2018,6,10,Sunday
1,12,13,25,2017,6,15,Thursday
4,15,4,19,2017,7,16,Sunday
1,3,8,11,2017,5,22,Monday
5,6,6,12,2017,10,20,Friday
4,8,9,17,2018,2,17,Saturday
2,17,5,22,2018,2,12,Monday
3,10,8,18,2018,6,8,Friday
2,7,22,29,2018,4,3,Tuesday
5,36,-15,21,2018,3,8,Thursday
3,18,5,23,2018,3,5,Monday
7,20,7,27,2017,4,20,Thursday
1,3,11,14,2018,6,12,Tuesday
3,4,9,13,2017,10,28,Saturday
2,3,15,18,2018,4,15,Sunday
26,42,5,47,2017,12,14,Thursday
3,8,19,27,2017,5,23,Tuesday
5,19,11,30,2017,12,9,Saturday
15,26,18,44,2018,5,9,Wednseday
1,7,16,23,2018,2,26,Monday
0,6,10,16,2018,4,4,Wednseday
5,8,19,27,2017,12,22,Friday
3,16,-3,13,2018,5,22,Tuesday
5,25,2,27,2017,12,9,Saturday
5,20,14,34,2018,6,14,Thursday
1,14,7,21,2017,9,13,Wednseday
1,3,12,15,2018,1,16,Tuesday
5,12,9,21,2018,1,18,Thursday
0,7,20,27,2017,9,27,Wednseday
1,49,-20,29,2017,4,24,Monday
3,22,3,25,2018,5,13,Sunday
3,13,16,29,2017,11,1,Wednseday
8,15,2,17,2018,3,19,Monday
1,9,22,31,2017,12,26,Tuesday
3,14,7,21,2018,1,12,Friday
13,20,25,45,2017,5,5,Friday
1,5,31,36,2018,6,27,Wednseday
2,8,14,22,2018,8,13,Monday
3,6,6,12,2018,3,9,Friday
6,14,12,26,2017,9,15,Friday
0,6,21,27,2018,5,2,Wednseday
4,15,18,33,2018,3,23,Friday
4,11,11,22,2017,10,23,Monday
1,3,2,5,2018,8,15,Wednseday
4,20,1,21,2017,11,24,Friday
2,9,3,12,2017,7,30,Sunday
3,16,15,31,2017,12,11,Monday
1,8,23,31,2018,6,25,Monday
1,9,13,22,2017,10,31,Tuesday
0,14,13,27,2018,4,5,Thursday
5,12,14,26,2017,11,18,Saturday
2,10,12,22,2017,11,15,Wednseday
1,4,21,25,2018,6,17,Sunday
4,13,1,14,2018,2,23,Friday
1,3,9,12,2018,3,14,Wednseday
7,9,32,41,2017,2,8,Wednseday
1,16,12,28,2018,1,9,Tuesday
4,23,16,39,2017,12,31,Sunday
3,4,2,6,2018,8,11,Saturday
3,4,1,5,2018,8,17,Friday
1,7,20,27,2018,3,6,Tuesday
2,9,14,23,2018,5,1,Tuesday
0,9,11,20,2018,2,21,Wednseday
2,11,12,23,2017,11,25,Saturday
3,6,7,13,2018,8,24,Friday
5,8,6,14,2017,11,23,Thursday
3,20,4,24,2018,5,18,Friday
8,11,4,15,2018,4,26,Thursday
7,11,11,22,2018,3,1,Thursday
2,7,15,22,2018,1,30,Tuesday
5,6,20,26,2018,5,30,Wednseday
4,10,8,18,2017,12,1,Friday
0,1,12,13,2018,5,3,Thursday
2,5,21,26,2018,1,14,Sunday
2,8,14,22,2018,5,10,Thursday
13,33,3,36,2018,1,4,Thursday
2,11,21,32,2018,1,22,Monday
1,5,5,10,2018,6,18,Monday
1,4,13,17,2018,6,18,Monday
2,8,22,30,2018,4,15,Sunday
12,19,27,46,2017,3,10,Friday
2,5,8,13,2018,2,28,Wednseday
1,12,12,24,2017,11,24,Friday
2,10,13,23,2018,4,17,Tuesday
13,16,26,42,2018,5,31,Thursday
4,10,14,24,2017,11,24,Friday
2,18,15,33,2017,4,9,Sunday
4,27,7,34,2018,2,1,Thursday
1,3,147,150,2018,3,6,Tuesday
3,8,15,23,2018,2,20,Tuesday
4,18,8,26,2018,2,25,Sunday
2,7,20,27,2018,4,5,Thursday
1,6,15,21,2018,5,15,Tuesday
1,4,11,15,2018,7,22,Sunday
7,14,14,28,2018,1,8,Monday
5,22,14,36,2017,4,13,Thursday
2,31,-10,21,2018,4,2,Monday
1,17,19,36,2017,12,19,Tuesday
5,30,-8,22,2017,11,29,Wednseday
2,9,14,23,2017,3,6,Monday
7,10,17,27,2017,8,15,Tuesday
2,7,4,11,2018,3,26,Monday
1,52,-24,28,2018,1,17,Wednseday
2,17,9,26,2017,12,17,Sunday
1,2,12,14,2017,11,29,Wednseday
1,14,13,27,2018,4,19,Thursday
1,11,11,22,2017,10,26,Thursday
1,2,9,11,2018,8,20,Monday
8,9,2,11,2018,8,6,Monday
6,13,21,34,2018,1,18,Thursday
7,8,2,10,2018,3,19,Monday
1,2,11,13,2017,8,9,Wednseday
1,7,20,27,2018,1,25,Thursday
1,8,16,24,2018,6,11,Monday
3,10,17,27,2017,11,4,Saturday
3,28,-3,25,2018,2,19,Monday
7,28,-3,25,2017,5,5,Friday
2,4,11,15,2018,8,20,Monday
1,19,7,26,2017,10,29,Sunday
3,10,8,18,2017,5,13,Saturday
1,7,24,31,2017,9,26,Tuesday
1,20,1,21,2018,3,6,Tuesday
4,39,-9,30,2017,5,8,Monday
2,10,8,18,2018,8,18,Saturday
2,3,10,13,2018,8,18,Saturday
4,7,11,18,2018,3,1,Thursday
19,47,-10,37,2018,4,18,Wednseday
3,24,1,25,2018,5,13,Sunday
6,10,-3,7,2018,8,3,Friday
16,20,11,31,2018,5,12,Saturday
23,36,28,64,2018,6,6,Wednseday
5,7,8,15,2018,2,14,Wednseday
20,40,1,41,2017,11,30,Thursday
4,14,20,34,2017,12,5,Tuesday
1,8,7,15,2017,9,21,Thursday
2,7,3,10,2018,8,20,Monday
3,13,11,24,2018,1,14,Sunday
2,14,8,22,2017,7,5,Wednseday
5,26,9,35,2017,4,20,Thursday
2,7,16,23,2018,1,8,Monday
4,13,11,24,2017,11,24,Friday
3,8,12,20,2018,2,21,Wednseday
3,7,4,11,2018,8,3,Friday
5,8,28,36,2017,4,5,Wednseday
3,4,13,17,2017,7,14,Friday
2,8,14,22,2017,6,4,Sunday
3,24,6,30,2017,10,23,Monday
2,13,18,31,2018,8,4,Saturday
10,18,6,24,2018,2,16,Friday
2,25,15,40,2017,12,9,Saturday
1,10,12,22,2017,6,27,Tuesday
2,11,14,25,2017,9,25,Monday
2,8,16,24,2018,3,25,Sunday
0,8,14,22,2018,1,18,Thursday
2,3,28,31,2018,4,8,Sunday
2,42,-13,29,2018,2,21,Wednseday
1,11,10,21,2017,3,23,Thursday
9,26,18,44,2018,5,13,Sunday
1,4,4,8,2018,8,23,Thursday
5,10,15,25,2017,12,30,Saturday
5,13,15,28,2018,1,17,Wednseday
1,6,14,20,2018,7,26,Thursday
4,7,10,17,2017,9,26,Tuesday
0,23,5,28,2017,12,6,Wednseday
2,6,18,24,2018,5,8,Tuesday
5,6,8,14,2018,2,22,Thursday
1,14,11,25,2017,11,23,Thursday
1,5,9,14,2018,5,16,Wednseday
0,9,38,47,2018,5,30,Wednseday
0,7,19,26,2018,2,7,Wednseday
3,11,21,32,2017,12,10,Sunday
1,2,3,5,2018,8,15,Wednseday
2,3,12,15,2018,4,8,Sunday
1,10,19,29,2018,1,31,Wednseday
1,5,11,16,2017,9,13,Wednseday
2,7,28,35,2018,6,26,Tuesday
6,15,13,28,2017,9,13,Wednseday
3,13,19,32,2017,6,9,Friday
1,10,12,22,2018,2,1,Thursday
1,8,28,36,2018,6,7,Thursday
2,4,12,16,2018,1,14,Sunday
2,8,17,25,2017,10,1,Sunday
5,6,8,14,2017,11,24,Friday
0,17,10,27,2018,4,11,Wednseday
2,15,21,36,2018,7,8,Sunday
0,22,19,41,2017,7,13,Thursday
18,38,5,43,2018,6,3,Sunday
0,5,15,20,2017,8,10,Thursday
1,5,15,20,2017,5,18,Thursday
2,7,19,26,2018,5,9,Wednseday
3,9,18,27,2018,6,19,Tuesday
5,7,14,21,2017,9,27,Wednseday
5,5,9,14,2018,4,6,Friday
2,3,7,10,2018,7,22,Sunday
3,12,20,32,2018,4,6,Friday
3,10,24,34,2018,1,12,Friday
1,4,37,41,2017,6,15,Thursday
2,9,15,24,2018,1,21,Sunday
3,10,23,33,2017,8,11,Friday
6,14,14,28,2018,1,18,Thursday
1,2,9,11,2017,10,15,Sunday
1,20,6,26,2018,2,7,Wednseday
1,15,6,21,2018,5,21,Monday
1,2,17,19,2018,8,26,Sunday
0,6,22,28,2017,3,8,Wednseday
2,11,-3,8,2018,8,6,Monday
1,4,6,10,2018,7,30,Monday
3,13,17,30,2017,11,18,Saturday
3,32,-9,23,2017,9,16,Saturday
6,9,12,21,2017,4,4,Tuesday
5,19,15,34,2017,6,23,Friday
6,14,10,24,2017,8,11,Friday
1,25,4,29,2017,12,11,Monday
0,3,15,18,2018,4,30,Monday
3,13,3,16,2017,11,21,Tuesday
2,14,15,29,2017,12,26,Tuesday
5,14,6,20,2017,9,13,Wednseday
7,13,4,17,2017,9,5,Tuesday
1,5,18,23,2018,4,11,Wednseday
1,7,15,22,2017,5,22,Monday
3,11,22,33,2018,1,12,Friday
2,29,-7,22,2017,3,5,Sunday
1,14,25,39,2017,10,5,Thursday
5,14,1,15,2018,8,16,Thursday
1,6,17,23,2017,12,4,Monday
2,9,15,24,2018,1,15,Monday
1,7,15,22,2017,8,2,Wednseday
1,2,10,12,2018,5,20,Sunday
1,8,15,23,2018,6,25,Monday
3,16,13,29,2017,9,3,Sunday
3,6,10,16,2017,11,25,Saturday
7,21,14,35,2017,8,4,Friday
1,20,15,35,2017,2,16,Thursday
6,12,14,26,2017,11,16,Thursday
5,20,7,27,2018,1,13,Saturday
16,38,-15,23,2018,7,3,Tuesday
1,46,-25,21,2018,3,6,Tuesday
1,24,13,37,2018,4,16,Monday
3,14,9,23,2017,8,21,Monday
4,17,17,34,2018,1,5,Friday
5,47,-11,36,2017,12,7,Thursday
0,10,17,27,2018,8,17,Friday
5,16,8,24,2017,8,5,Saturday
1,13,23,36,2017,7,6,Thursday
2,7,16,23,2018,4,17,Tuesday
1,12,13,25,2018,1,7,Sunday
1,7,25,32,2018,1,15,Monday
5,16,17,33,2017,7,15,Saturday
1,17,11,28,2017,10,17,Tuesday
1,8,15,23,2018,1,24,Wednseday
2,6,27,33,2018,8,23,Thursday
6,15,15,30,2017,10,11,Wednseday
4,5,8,13,2017,11,17,Friday
2,8,15,23,2018,1,30,Tuesday
3,14,8,22,2018,5,1,Tuesday
0,12,12,24,2017,7,7,Friday
1,2,13,15,2018,6,18,Monday
6,34,-3,31,2017,11,14,Tuesday
1,12,17,29,2018,6,24,Sunday
3,7,7,14,2017,10,27,Friday
2,15,7,22,2018,1,15,Monday
2,7,10,17,2018,4,17,Tuesday
1,8,14,22,2017,8,8,Tuesday
1,13,9,22,2018,2,28,Wednseday
1,10,14,24,2017,10,3,Tuesday
3,10,31,41,2017,2,21,Tuesday
2,3,5,8,2018,7,24,Tuesday
1,12,13,25,2018,7,15,Sunday
2,8,13,21,2018,1,18,Thursday
2,6,7,13,2018,3,27,Tuesday
5,7,13,20,2017,7,22,Saturday
3,12,19,31,2018,5,12,Saturday
5,12,7,19,2018,3,16,Friday
0,15,19,34,2018,4,19,Thursday
2,3,15,18,2018,6,11,Monday
3,9,4,13,2018,8,11,Saturday
11,18,13,31,2017,3,17,Friday
5,22,4,26,2017,12,28,Thursday
10,13,13,26,2017,11,17,Friday
1,5,10,15,2017,6,11,Sunday
10,15,19,34,2017,10,6,Friday
0,21,6,27,2017,12,12,Tuesday
4,7,12,19,2018,4,5,Thursday
1,15,15,30,2017,10,17,Tuesday
3,5,7,12,2018,8,24,Friday
0,6,15,21,2018,4,5,Thursday
0,11,20,31,2017,9,25,Monday
2,5,11,16,2018,1,3,Wednseday
4,12,7,19,2017,10,22,Sunday
2,6,24,30,2018,1,6,Saturday
3,8,15,23,2017,5,28,Sunday
3,13,8,21,2018,1,12,Friday
9,32,-1,31,2017,12,2,Saturday
4,16,10,26,2017,11,5,Sunday
5,13,14,27,2018,1,10,Wednseday
3,10,8,18,2017,7,10,Monday
5,13,22,35,2017,4,27,Thursday
1,6,16,22,2018,6,12,Tuesday
1,13,28,41,2017,2,16,Thursday
3,6,12,18,2018,7,14,Saturday
4,12,6,18,2017,11,23,Thursday
4,21,11,32,2017,12,7,Thursday
1,27,-6,21,2018,3,1,Thursday
6,11,12,23,2017,6,3,Saturday
4,23,2,25,2018,3,25,Sunday
1,4,10,14,2018,3,19,Monday
1,6,13,19,2017,10,19,Thursday
1,15,3,18,2018,5,20,Sunday
1,6,16,22,2018,8,15,Wednseday
2,18,11,29,2017,12,11,Monday
1,4,24,28,2017,12,18,Monday
8,25,-2,23,2018,2,12,Monday
3,4,11,15,2017,11,19,Sunday
3,9,40,49,2018,6,5,Tuesday
2,9,22,31,2017,6,26,Monday
1,2,13,15,2018,8,21,Tuesday
3,9,14,23,2017,6,10,Saturday
1,10,12,22,2018,7,4,Wednseday
0,6,16,22,2017,5,9,Tuesday
2,4,12,16,2018,1,22,Monday
1,8,17,25,2018,3,18,Sunday
1,8,16,24,2017,7,16,Sunday
7,9,17,26,2017,3,15,Wednseday
10,14,3,17,2017,11,6,Monday
3,27,4,31,2018,1,23,Tuesday
5,39,-5,34,2017,12,7,Thursday
2,10,20,30,2018,1,3,Wednseday
7,14,14,28,2018,4,10,Tuesday
1,6,8,14,2018,7,19,Thursday
0,5,21,26,2017,10,6,Friday
1,17,-1,16,2017,10,3,Tuesday
1,5,12,17,2018,3,20,Tuesday
4,13,16,29,2018,1,4,Thursday
4,8,20,28,2017,11,23,Thursday
0,5,15,20,2018,5,3,Thursday
4,21,18,39,2017,12,29,Friday
2,10,22,32,2018,1,8,Monday
3,17,15,32,2017,7,21,Friday
1,9,9,18,2017,10,23,Monday
1,17,22,39,2018,1,22,Monday
1,4,19,23,2018,6,25,Monday
4,175,-161,14,2017,6,12,Monday
1,21,8,29,2018,4,9,Monday
2,18,14,32,2018,4,8,Sunday
3,10,7,17,2018,8,4,Saturday
3,19,5,24,2018,3,24,Saturday
2,21,5,26,2017,11,1,Wednseday
1,6,23,29,2017,2,16,Thursday
1,9,14,23,2018,7,17,Tuesday
1,5,14,19,2017,3,9,Thursday
5,8,18,26,2018,1,25,Thursday
1,6,21,27,2017,10,3,Tuesday
1,7,6,13,2017,6,29,Thursday
6,9,4,13,2017,8,30,Wednseday
5,20,39,59,2017,8,11,Friday
6,22,0,22,2018,4,8,Sunday
0,2,10,12,2018,4,18,Wednseday
1,8,17,25,2017,7,20,Thursday
6,10,20,30,2018,7,31,Tuesday
4,9,29,38,2018,6,10,Sunday
4,12,17,29,2017,11,12,Sunday
4,7,7,14,2017,11,24,Friday
1,17,10,27,2017,5,23,Tuesday
6,19,13,32,2017,12,21,Thursday
2,15,8,23,2018,1,13,Saturday
10,11,-4,7,2018,8,3,Friday
6,7,6,13,2018,3,22,Thursday
11,20,5,25,2017,10,14,Saturday
2,8,5,13,2018,8,1,Wednseday
1,15,20,35,2017,1,31,Tuesday
1,2,10,12,2018,6,13,Wednseday
6,13,8,21,2018,8,9,Thursday
4,14,14,28,2017,9,4,Monday
1,5,14,19,2018,1,11,Thursday
2,46,-9,37,2018,4,9,Monday
1,10,16,26,2018,1,10,Wednseday
14,21,25,46,2017,11,30,Thursday
14,16,1,17,2017,8,15,Tuesday
3,17,11,28,2018,1,12,Friday
18,24,-2,22,2018,3,5,Monday
5,12,23,35,2017,12,29,Friday
1,5,22,27,2018,8,22,Wednseday
3,21,-5,16,2018,3,13,Tuesday
3,8,14,22,2017,5,7,Sunday
2,6,4,10,2018,4,3,Tuesday
3,11,10,21,2018,3,23,Friday
1,7,14,21,2018,7,17,Tuesday
13,34,-7,27,2017,11,24,Friday
2,5,5,10,2018,8,6,Monday
2,20,7,27,2017,12,20,Wednseday
10,17,5,22,2017,11,19,Sunday
1,8,9,17,2018,5,13,Sunday
2,8,10,18,2018,3,25,Sunday
3,16,11,27,2018,4,10,Tuesday
6,15,14,29,2018,1,31,Wednseday
3,5,7,12,2018,3,16,Friday
1,2,12,14,2017,6,5,Monday
6,18,14,32,2017,4,21,Friday
1,13,7,20,2018,3,20,Tuesday
9,19,13,32,2017,10,29,Sunday
1,6,11,17,2018,7,31,Tuesday
6,12,22,34,2017,7,6,Thursday
1,16,13,29,2017,6,7,Wednseday
1,21,3,24,2018,4,23,Monday
8,23,5,28,2018,2,6,Tuesday
1,6,15,21,2018,6,28,Thursday
1,9,13,22,2017,11,29,Wednseday
4,8,18,26,2017,11,2,Thursday
2,3,1,4,2018,8,12,Sunday
1,7,8,15,2018,7,16,Monday
2,16,9,25,2017,8,28,Monday
1,5,11,16,2018,4,29,Sunday
5,16,10,26,2017,11,18,Saturday
2,8,20,28,2018,6,13,Wednseday
1,15,9,24,2017,12,5,Tuesday
1,11,33,44,2017,10,9,Monday
9,26,3,29,2017,5,31,Wednseday
1,10,10,20,2018,7,17,Tuesday
1,16,6,22,2018,3,11,Sunday
5,6,11,17,2018,6,9,Saturday
1,2,10,12,2017,8,13,Sunday
1,8,17,25,2017,3,16,Thursday
4,11,28,39,2017,9,28,Thursday
5,12,25,37,2017,12,6,Wednseday
6,15,18,33,2018,1,18,Thursday
5,12,17,29,2017,10,29,Sunday
4,8,14,22,2018,4,8,Sunday
7,10,24,34,2017,8,25,Friday
1,4,15,19,2017,7,9,Sunday
5,20,15,35,2017,6,14,Wednseday
3,21,8,29,2018,2,12,Monday
17,24,14,38,2018,2,2,Friday
2,11,11,22,2017,12,24,Sunday
13,65,-40,25,2018,2,17,Saturday
4,7,33,40,2018,4,19,Thursday
5,9,19,28,2018,5,24,Thursday
2,12,6,18,2018,3,4,Sunday
3,14,17,31,2018,6,26,Tuesday
5,9,10,19,2017,10,19,Thursday
1,5,35,40,2017,1,15,Sunday
6,14,7,21,2018,2,14,Wednseday
4,24,10,34,2017,12,15,Friday
0,10,15,25,2017,6,2,Friday
4,13,17,30,2017,10,28,Saturday
4,7,15,22,2017,9,21,Thursday
15,20,19,39,2018,1,18,Thursday
1,6,16,22,2018,6,24,Sunday
9,14,3,17,2017,7,11,Tuesday
3,21,7,28,2018,2,12,Monday
5,22,15,37,2018,1,10,Wednseday
2,5,19,24,2018,4,15,Sunday
2,3,15,18,2017,12,18,Monday
1,6,23,29,2018,6,19,Tuesday
1,3,10,13,2018,3,8,Thursday
1,4,19,23,2018,7,9,Monday
2,28,-2,26,2017,9,13,Wednseday
0,9,22,31,2017,1,31,Tuesday
1,17,7,24,2017,11,26,Sunday
4,6,11,17,2018,2,23,Friday
3,28,-5,23,2017,11,21,Tuesday
9,10,19,29,2017,4,3,Monday
1,8,14,22,2018,2,13,Tuesday
23,23,-5,18,2018,2,19,Monday
2,9,26,35,2018,7,2,Monday
1,13,-3,10,2018,8,12,Sunday
9,15,6,21,2017,4,24,Monday
2,10,19,29,2018,5,1,Tuesday
1,5,6,11,2018,8,23,Thursday
5,9,16,25,2017,11,16,Thursday
6,18,7,25,2018,3,15,Thursday
1,2,22,24,2018,6,5,Tuesday
5,7,13,20,2018,6,28,Thursday
6,14,16,30,2017,11,8,Wednseday
3,8,8,16,2018,2,6,Tuesday
3,9,15,24,2017,7,24,Monday
2,6,10,16,2018,7,10,Tuesday
3,10,13,23,2017,10,21,Saturday
5,11,18,29,2018,4,12,Thursday
2,7,15,22,2017,4,20,Thursday
2,16,5,21,2018,5,21,Monday
0,2,16,18,2017,12,1,Friday
4,18,9,27,2017,11,30,Thursday
2,6,18,24,2018,5,1,Tuesday
7,25,13,38,2017,11,10,Friday
1,10,14,24,2017,7,3,Monday
4,10,16,26,2018,6,29,Friday
2,16,25,41,2018,6,6,Wednseday
3,11,14,25,2017,9,1,Friday
3,10,14,24,2017,8,12,Saturday
1,7,14,21,2017,3,20,Monday
2,3,20,23,2017,12,24,Sunday
3,19,5,24,2017,12,31,Sunday
6,18,8,26,2017,11,18,Saturday
3,10,24,34,2017,10,14,Saturday
2,24,14,38,2017,4,8,Saturday
13,23,1,24,2017,7,15,Saturday
4,42,-13,29,2017,11,16,Thursday
7,14,20,34,2018,6,29,Friday
3,9,21,30,2017,2,28,Tuesday
1,4,32,36,2017,1,23,Monday
5,27,2,29,2017,8,30,Wednseday
2,10,26,36,2018,4,23,Monday
3,7,17,24,2017,7,21,Friday
1,13,17,30,2017,10,17,Tuesday
3,34,5,39,2017,4,16,Sunday
3,4,7,11,2018,6,24,Sunday
7,17,3,20,2017,7,28,Friday
1,4,11,15,2018,5,13,Sunday
0,1,22,23,2018,6,18,Monday
2,5,9,14,2018,4,5,Thursday
3,7,18,25,2017,11,24,Friday
4,20,0,20,2017,11,24,Friday
6,23,11,34,2017,12,13,Wednseday
1,5,18,23,2018,4,22,Sunday
1,9,17,26,2018,2,18,Sunday
1,9,9,18,2017,12,18,Monday
1,22,-7,15,2018,5,21,Monday
1,6,7,13,2018,8,9,Thursday
3,12,2,14,2017,10,27,Friday
2,3,9,12,2018,3,14,Wednseday
1,6,8,14,2018,8,7,Tuesday
5,14,10,24,2018,5,11,Friday
2,3,7,10,2018,5,6,Sunday
7,14,20,34,2017,5,4,Thursday
1,32,-10,22,2017,11,20,Monday
6,12,16,28,2017,8,18,Friday
0,8,26,34,2018,1,11,Thursday
0,3,16,19,2017,11,24,Friday
1,5,9,14,2018,7,25,Wednseday
2,6,13,19,2018,2,28,Wednseday
1,7,2,9,2018,8,6,Monday
2,36,-8,28,2018,5,1,Tuesday
16,17,15,32,2018,1,22,Monday
2,15,16,31,2017,12,2,Saturday
3,9,21,30,2018,6,16,Saturday
1,8,14,22,2017,5,22,Monday
4,11,14,25,2017,4,23,Sunday
6,8,11,19,2018,4,5,Thursday
2,15,8,23,2017,5,30,Tuesday
2,17,15,32,2018,5,19,Saturday
4,11,14,25,2017,9,15,Friday
1,3,17,20,2017,11,28,Tuesday
1,28,-6,22,2018,3,13,Tuesday
5,41,-13,28,2018,3,15,Thursday
3,7,31,38,2018,6,22,Friday
1,5,14,19,2018,3,28,Wednseday
1,8,14,22,2017,5,16,Tuesday
1,6,21,27,2017,3,23,Thursday
2,15,15,30,2018,1,22,Monday
7,14,6,20,2017,11,9,Thursday
2,16,14,30,2017,12,25,Monday
3,7,14,21,2017,10,20,Friday
5,6,15,21,2018,6,21,Thursday
2,10,15,25,2018,3,18,Sunday
9,15,14,29,2017,6,4,Sunday
4,22,5,27,2018,1,11,Thursday
1,13,15,28,2018,3,13,Tuesday
3,6,13,19,2017,12,9,Saturday
1,5,10,15,2018,6,28,Thursday
5,20,7,27,2017,9,7,Thursday
2,5,32,37,2018,7,21,Saturday
1,6,22,28,2018,7,19,Thursday
6,8,11,19,2017,3,15,Wednseday
1,14,22,36,2017,4,6,Thursday
9,28,-11,17,2017,11,21,Tuesday
4,5,10,15,2018,7,29,Sunday
2,32,-4,28,2018,3,13,Tuesday
5,11,3,14,2018,2,23,Friday
5,19,8,27,2017,8,24,Thursday
4,11,11,22,2018,7,26,Thursday
1,8,14,22,2018,2,14,Wednseday
2,12,12,24,2017,8,12,Saturday
1,9,17,26,2018,6,24,Sunday
0,4,17,21,2017,8,18,Friday
1,37,-9,28,2017,10,25,Wednseday
6,19,10,29,2017,11,29,Wednseday
3,34,-11,23,2018,4,3,Tuesday
7,8,-1,7,2018,8,13,Monday
1,8,23,31,2018,1,9,Tuesday
1,2,17,19,2018,8,15,Wednseday
3,4,13,17,2017,11,25,Saturday
3,11,13,24,2018,2,5,Monday
5,10,25,35,2018,5,25,Friday
3,15,32,47,2017,10,20,Friday
2,8,21,29,2017,5,21,Sunday
2,9,18,27,2017,5,27,Saturday
2,26,14,40,2017,11,1,Wednseday
1,4,17,21,2017,9,11,Monday
2,9,18,27,2017,11,8,Wednseday
7,12,30,42,2018,8,2,Thursday
2,23,4,27,2018,7,24,Tuesday
1,7,10,17,2018,7,16,Monday
7,34,-8,26,2018,5,9,Wednseday
0,6,19,25,2018,4,20,Friday
0,5,7,12,2018,8,17,Friday
3,15,22,37,2017,10,2,Monday
4,21,4,25,2018,1,29,Monday
2,5,15,20,2018,7,7,Saturday
1,6,21,27,2017,6,8,Thursday
0,4,10,14,2018,7,23,Monday
0,5,7,12,2018,8,16,Thursday
3,5,13,18,2018,1,28,Sunday
3,16,6,22,2018,3,19,Monday
0,2,13,15,2018,8,13,Monday
1,14,13,27,2018,4,26,Thursday
2,8,14,22,2017,8,14,Monday
3,8,1,9,2018,8,7,Tuesday
0,4,10,14,2018,8,14,Tuesday
3,8,20,28,2017,10,17,Tuesday
3,21,7,28,2017,7,12,Wednseday
3,9,19,28,2018,1,2,Tuesday
1,3,6,9,2018,2,14,Wednseday
3,7,12,19,2018,3,9,Friday
3,24,10,34,2017,4,21,Friday
0,9,19,28,2017,5,29,Monday
6,12,15,27,2017,7,13,Thursday
1,6,7,13,2018,6,12,Tuesday
0,2,15,17,2017,8,28,Monday
3,8,14,22,2018,1,30,Tuesday
0,21,31,52,2018,1,8,Monday
1,7,15,22,2018,5,10,Thursday
24,19,61,80,2017,1,27,Friday
5,18,6,24,2017,10,6,Friday
0,1,12,13,2017,5,18,Thursday
2,9,21,30,2018,3,12,Monday
2,15,21,36,2018,6,18,Monday
1,6,17,23,2017,3,14,Tuesday
2,3,10,13,2017,8,26,Saturday
1,11,6,17,2018,8,6,Monday
2,5,19,24,2018,4,15,Sunday
2,8,9,17,2017,10,9,Monday
5,19,14,33,2017,11,30,Thursday
13,20,9,29,2017,11,14,Tuesday
1,8,15,23,2017,3,7,Tuesday
5,10,8,18,2018,8,4,Saturday
4,7,14,21,2018,4,20,Friday
4,11,9,20,2017,9,7,Thursday
1,12,3,15,2018,2,8,Thursday
3,12,9,21,2017,11,24,Friday
2,3,15,18,2017,12,10,Sunday
9,19,6,25,2017,11,18,Saturday
3,9,25,34,2018,5,26,Saturday
1,3,10,13,2018,6,20,Wednseday
1,13,36,49,2018,5,24,Thursday
1,7,18,25,2017,2,6,Monday
9,9,8,17,2018,3,18,Sunday
2,46,-20,26,2018,2,25,Sunday
4,5,13,18,2018,5,24,Thursday
2,8,19,27,2018,5,1,Tuesday
1,4,12,16,2017,10,2,Monday
3,30,-1,29,2018,3,18,Sunday
5,6,9,15,2017,7,19,Wednseday
1,8,27,35,2018,6,12,Tuesday
2,11,15,26,2017,6,24,Saturday
1,6,9,15,2017,11,26,Sunday
6,13,17,30,2017,11,29,Wednseday
5,10,14,24,2018,2,9,Friday
0,6,34,40,2017,4,5,Wednseday
2,7,14,21,2017,3,6,Monday
1,8,20,28,2018,1,24,Wednseday
1,10,16,26,2017,12,8,Friday
3,22,0,22,2018,2,25,Sunday
4,13,2,15,2018,8,16,Thursday
2,19,-3,16,2018,4,2,Monday
2,10,12,22,2017,5,22,Monday
1,10,12,22,2017,9,18,Monday
1,17,16,33,2017,4,9,Sunday
3,6,-3,3,2018,8,7,Tuesday
8,15,2,17,2018,5,21,Monday
2,10,4,14,2018,8,20,Monday
4,5,20,25,2018,6,1,Friday
1,9,13,22,2018,7,2,Monday
1,20,9,29,2018,1,10,Wednseday
3,10,11,21,2017,6,13,Tuesday
5,8,21,29,2017,4,12,Wednseday
4,5,12,17,2017,6,2,Friday
3,11,15,26,2017,7,21,Friday
2,14,16,30,2017,9,25,Monday
4,12,9,21,2018,1,12,Friday
3,6,6,12,2018,8,3,Friday
11,14,5,19,2018,8,2,Thursday
7,18,21,39,2017,10,2,Monday
2,3,11,14,2017,6,5,Monday
2,8,19,27,2017,3,14,Tuesday
3,6,15,21,2017,3,3,Friday
7,13,19,32,2018,6,14,Thursday
2,5,17,22,2017,9,11,Monday
1,8,24,32,2018,8,19,Sunday
4,5,8,13,2018,3,1,Thursday
4,10,37,47,2018,6,15,Friday
7,14,4,18,2018,1,4,Thursday
4,15,14,29,2018,2,4,Sunday
7,15,3,18,2018,8,16,Thursday
12,20,12,32,2018,4,12,Thursday
6,28,5,33,2017,12,30,Saturday
4,12,0,12,2018,8,16,Thursday
10,32,-11,21,2018,5,11,Friday
2,11,16,27,2017,11,9,Thursday
4,7,8,15,2018,5,7,Monday
7,12,26,38,2018,7,20,Friday
6,8,2,10,2018,8,14,Tuesday
1,7,7,14,2018,7,31,Tuesday
5,7,20,27,2018,5,10,Thursday
1,28,-8,20,2018,3,20,Tuesday
1,5,16,21,2017,8,23,Wednseday
2,8,8,16,2018,5,8,Tuesday
6,10,14,24,2018,6,22,Friday
1,4,15,19,2017,11,30,Thursday
0,12,20,32,2017,6,2,Friday
1,11,6,17,2017,4,24,Monday
4,5,6,11,2018,4,1,Sunday
7,14,15,29,2018,8,1,Wednseday
5,13,9,22,2017,11,23,Thursday
5,12,1,13,2018,8,9,Thursday
21,34,1,35,2017,12,19,Tuesday
0,10,11,21,2017,5,16,Tuesday
2,17,28,45,2017,1,22,Sunday
1,4,9,13,2017,8,31,Thursday
7,14,6,20,2017,5,10,Wednseday
1,29,3,32,2017,10,26,Thursday
2,9,0,9,2018,8,20,Monday
3,12,13,25,2017,10,20,Friday
0,1,18,19,2018,6,27,Wednseday
3,15,19,34,2018,1,30,Tuesday
15,20,4,24,2017,11,24,Friday
5,22,10,32,2017,3,5,Sunday
5,11,15,26,2018,5,12,Saturday
6,23,-2,21,2018,8,1,Wednseday
0,15,6,21,2017,6,20,Tuesday
6,12,3,15,2018,8,8,Wednseday
1,22,5,27,2018,5,1,Tuesday
1,4,15,19,2017,11,26,Sunday
1,8,13,21,2017,3,21,Tuesday
8,51,-12,39,2018,2,12,Monday
1,12,8,20,2018,3,28,Wednseday
1,36,-18,18,2018,3,4,Sunday
2,3,16,19,2017,12,17,Sunday
5,14,14,28,2018,5,2,Wednseday
11,15,4,19,2017,12,8,Friday
2,10,10,20,2017,11,4,Saturday
1,7,14,21,2017,11,9,Thursday
5,13,14,27,2017,5,4,Thursday
1,4,18,22,2017,8,31,Thursday
0,6,21,27,2018,6,20,Wednseday
5,12,14,26,2017,2,26,Sunday
0,2,6,8,2018,7,25,Wednseday
2,12,25,37,2018,8,18,Saturday
6,12,13,25,2017,9,28,Thursday
2,5,21,26,2018,6,17,Sunday
1,2,18,20,2017,12,26,Tuesday
3,24,1,25,2018,2,17,Saturday
1,15,7,22,2017,7,26,Wednseday
3,5,12,17,2018,7,20,Friday
3,9,3,12,2018,8,18,Saturday
1,20,2,22,2017,5,10,Wednseday
3,27,-6,21,2018,3,23,Friday
3,24,-6,18,2018,3,3,Saturday
5,15,1,16,2017,11,26,Sunday
2,7,25,32,2017,12,14,Thursday
2,7,11,18,2018,4,5,Thursday
1,8,28,36,2018,6,17,Sunday
4,24,17,41,2018,1,6,Saturday
9,15,2,17,2018,7,31,Tuesday
2,11,18,29,2018,1,21,Sunday
5,19,1,20,2017,9,13,Wednseday
1,2,10,12,2017,8,13,Sunday
4,18,10,28,2018,3,19,Monday
1,18,15,33,2018,7,5,Thursday
3,8,12,20,2017,10,24,Tuesday
1,6,19,25,2018,4,19,Thursday
2,7,13,20,2017,8,2,Wednseday
6,12,15,27,2018,7,19,Thursday
1,13,34,47,2017,2,2,Thursday
6,22,9,31,2017,11,28,Tuesday
3,5,7,12,2018,3,3,Saturday
4,8,18,26,2018,6,21,Thursday
1,14,12,26,2018,3,15,Thursday
1,17,4,21,2018,5,21,Monday
0,15,34,49,2018,5,24,Thursday
4,7,8,15,2018,1,18,Thursday
2,12,14,26,2017,8,2,Wednseday
3,5,17,22,2018,4,1,Sunday
1,15,21,36,2017,3,29,Wednseday
1,5,32,37,2018,4,15,Sunday
1,7,12,19,2018,7,4,Wednseday
6,28,-5,23,2018,3,21,Wednseday
3,8,14,22,2018,1,14,Sunday
4,14,13,27,2017,8,18,Friday
3,10,17,27,2017,11,24,Friday
4,8,18,26,2018,2,16,Friday
0,3,33,36,2018,6,5,Tuesday
2,8,8,16,2018,2,6,Tuesday
3,9,18,27,2018,5,5,Saturday
1,8,8,16,2018,8,21,Tuesday
10,12,9,21,2017,11,24,Friday
3,6,20,26,2018,8,10,Friday
1,8,14,22,2018,1,2,Tuesday
2,6,8,14,2018,6,19,Tuesday
6,12,20,32,2018,6,21,Thursday
5,14,8,22,2017,7,19,Wednseday
1,24,7,31,2017,7,30,Sunday
8,15,18,33,2018,1,14,Sunday
1,4,23,27,2017,8,24,Thursday
6,22,19,41,2018,8,8,Wednseday
10,12,-2,10,2017,5,14,Sunday
1,9,14,23,2017,6,13,Tuesday
4,10,9,19,2018,3,16,Friday
6,7,5,12,2017,9,15,Friday
2,9,9,18,2018,8,19,Sunday
1,8,34,42,2018,6,7,Thursday
14,21,-1,20,2017,11,28,Tuesday
0,8,17,25,2017,11,27,Monday
2,8,17,25,2018,1,21,Sunday
2,20,6,26,2018,3,21,Wednseday
6,44,-13,31,2017,12,5,Tuesday
2,10,19,29,2017,6,11,Sunday
1,2,9,11,2018,8,20,Monday
3,16,13,29,2018,1,31,Wednseday
3,9,24,33,2018,8,11,Saturday
2,9,16,25,2018,1,1,Monday
2,9,32,41,2017,2,8,Wednseday
1,6,10,16,2018,7,18,Wednseday
3,17,19,36,2018,1,1,Monday
5,12,15,27,2017,7,14,Friday
5,20,4,24,2017,5,19,Friday
4,7,11,18,2018,7,13,Friday
1,17,12,29,2018,4,23,Monday
1,14,4,18,2018,3,5,Monday
5,20,0,20,2018,5,19,Saturday
1,15,13,28,2018,6,7,Thursday
4,10,16,26,2017,12,29,Friday
1,4,32,36,2017,1,30,Monday
1,8,20,28,2018,4,18,Wednseday
4,13,9,22,2017,7,6,Thursday
5,19,4,23,2018,5,5,Saturday
2,15,8,23,2017,12,5,Tuesday
2,13,24,37,2017,9,30,Saturday
5,22,8,30,2018,1,31,Wednseday
2,12,11,23,2018,3,10,Saturday
1,9,13,22,2017,7,17,Monday
5,11,1,12,2017,9,14,Thursday
3,13,11,24,2017,8,5,Saturday
5,22,13,35,2017,5,17,Wednseday
1,6,7,13,2017,6,28,Wednseday
4,5,8,13,2017,11,17,Friday
2,5,14,19,2018,2,14,Wednseday
3,6,2,8,2018,8,7,Tuesday
0,7,26,33,2018,3,8,Thursday
2,5,16,21,2017,12,13,Wednseday
11,31,1,32,2018,7,15,Sunday
1,15,9,24,2017,8,27,Sunday
3,8,8,16,2018,7,24,Tuesday
0,8,3,11,2018,8,13,Monday
0,10,17,27,2017,11,7,Tuesday
4,12,15,27,2018,8,2,Thursday
2,6,27,33,2018,7,22,Sunday
8,14,14,28,2018,2,19,Monday
1,48,-22,26,2018,3,18,Sunday
6,12,20,32,2017,9,21,Thursday
6,7,6,13,2018,4,26,Thursday
5,16,6,22,2017,10,4,Wednseday
2,12,14,26,2017,11,2,Thursday
3,17,14,31,2018,1,30,Tuesday
1,20,2,22,2018,3,20,Tuesday
20,27,5,32,2017,8,5,Saturday
7,8,6,14,2018,2,20,Tuesday
1,8,12,20,2017,6,29,Thursday
1,7,11,18,2018,2,8,Thursday
1,5,15,20,2017,8,2,Wednseday
2,3,11,14,2017,11,28,Tuesday
3,9,19,28,2018,2,21,Wednseday
1,8,25,33,2017,2,15,Wednseday
2,6,24,30,2017,10,11,Wednseday
3,10,29,39,2018,6,9,Saturday
18,22,2,24,2018,5,20,Sunday
5,12,15,27,2018,6,30,Saturday
1,8,15,23,2018,1,24,Wednseday
2,12,20,32,2017,7,16,Sunday
2,11,17,28,2018,2,5,Monday
2,6,24,30,2018,6,16,Saturday
2,5,12,17,2018,1,7,Sunday
1,7,20,27,2018,5,15,Tuesday
5,10,18,28,2018,1,5,Friday
8,10,0,10,2018,8,10,Friday
1,17,29,46,2018,5,31,Thursday
1,10,18,28,2017,12,12,Tuesday
6,13,14,27,2017,6,6,Tuesday
1,10,0,10,2018,7,16,Monday
2,7,11,18,2017,10,30,Monday
2,34,16,50,2018,1,15,Monday
8,9,12,21,2017,8,24,Thursday
1,9,11,20,2018,7,17,Tuesday
4,20,16,36,2018,2,1,Thursday
3,11,13,24,2017,7,31,Monday
3,4,9,13,2017,7,8,Saturday
3,7,17,24,2017,11,25,Saturday
2,14,36,50,2018,6,5,Tuesday
0,2,8,10,2018,7,31,Tuesday
1,16,20,36,2018,1,17,Wednseday
2,7,9,16,2018,8,6,Monday
4,10,13,23,2017,10,16,Monday
1,9,7,16,2018,5,7,Monday
2,20,29,49,2017,1,31,Tuesday
5,10,11,21,2018,1,12,Friday
3,19,12,31,2018,3,2,Friday
3,13,17,30,2018,4,21,Saturday
3,26,7,33,2017,11,24,Friday
5,33,-1,32,2018,6,21,Thursday
5,13,16,29,2017,12,28,Thursday
2,4,20,24,2018,4,8,Sunday
1,19,16,35,2018,8,9,Thursday
1,14,9,23,2018,1,15,Monday
1,9,8,17,2018,7,15,Sunday
4,18,1,19,2018,3,23,Friday
6,7,34,41,2018,6,1,Friday
7,15,26,41,2017,4,12,Wednseday
2,15,7,22,2018,1,31,Wednseday
2,8,6,14,2018,5,7,Monday
0,8,14,22,2017,10,9,Monday
4,17,24,41,2017,1,27,Friday
0,8,13,21,2018,1,17,Wednseday
6,8,14,22,2018,4,18,Wednseday
15,18,15,33,2017,2,5,Sunday
1,8,14,22,2018,7,15,Sunday
3,27,5,32,2017,6,30,Friday
0,6,23,29,2017,2,14,Tuesday
2,7,15,22,2017,10,25,Wednseday
7,22,1,23,2018,2,21,Wednseday
1,6,12,18,2017,10,5,Thursday
1,2,9,11,2018,5,7,Monday
3,4,6,10,2018,7,27,Friday
2,22,8,30,2018,2,7,Wednseday
3,7,23,30,2017,10,24,Tuesday
1,9,5,14,2018,3,12,Monday
2,17,21,38,2017,8,20,Sunday
4,18,9,27,2018,2,3,Saturday
4,8,17,25,2017,3,30,Thursday
8,13,10,23,2017,3,14,Tuesday
2,4,8,12,2017,8,20,Sunday
4,18,17,35,2017,6,9,Friday
6,8,5,13,2018,3,27,Tuesday
1,7,20,27,2018,5,8,Tuesday
1,10,6,16,2018,2,13,Tuesday
1,8,-4,4,2018,8,20,Monday
4,5,7,12,2017,9,14,Thursday
9,24,32,56,2018,4,25,Wednseday
4,9,8,17,2018,8,11,Saturday
1,15,16,31,2017,8,6,Sunday
0,22,6,28,2018,4,5,Thursday
1,8,10,18,2018,8,5,Sunday
0,10,23,33,2017,2,10,Friday
8,19,7,26,2017,11,24,Friday
3,8,6,14,2018,6,12,Tuesday
1,2,8,10,2018,4,10,Tuesday
5,13,0,13,2017,5,13,Saturday
4,12,10,22,2017,5,7,Sunday
1,2,13,15,2018,1,22,Monday
0,7,19,26,2017,4,6,Thursday
1,6,14,20,2018,7,10,Tuesday
4,10,9,19,2017,11,17,Friday
3,28,11,39,2017,4,9,Sunday
4,11,23,34,2018,6,14,Thursday
2,16,25,41,2017,1,18,Wednseday
1,9,9,18,2017,9,17,Sunday
2,5,34,39,2017,3,25,Saturday
2,13,10,23,2017,11,29,Wednseday
1,8,19,27,2018,1,30,Tuesday
1,2,6,8,2018,7,29,Sunday
1,23,7,30,2018,4,17,Tuesday
1,6,18,24,2018,6,5,Tuesday
4,14,13,27,2018,3,31,Saturday
0,1,8,9,2018,5,14,Monday
3,22,5,27,2018,5,18,Friday
3,11,22,33,2017,1,27,Friday
0,1,12,13,2018,5,3,Thursday
1,18,7,25,2017,11,26,Sunday
3,40,26,66,2018,1,6,Saturday
5,7,18,25,2018,6,1,Friday
1,2,14,16,2018,5,23,Wednseday
2,6,25,31,2017,2,11,Saturday
2,29,0,29,2017,11,29,Wednseday
1,4,24,28,2018,4,9,Monday
7,12,11,23,2017,3,15,Wednseday
2,9,25,34,2018,7,11,Wednseday
1,12,9,21,2018,2,28,Wednseday
5,7,6,13,2018,3,28,Wednseday
5,12,9,21,2017,3,16,Thursday
3,33,-6,27,2018,4,21,Saturday
2,14,6,20,2017,11,28,Tuesday
5,20,2,22,2018,3,22,Thursday
2,3,10,13,2017,8,15,Tuesday
1,13,8,21,2018,1,10,Wednseday
1,23,10,33,2017,6,25,Sunday
3,7,17,24,2018,1,26,Friday
1,6,20,26,2018,6,27,Wednseday
1,4,3,7,2018,8,23,Thursday
2,25,6,31,2018,1,29,Monday
3,9,18,27,2017,3,21,Tuesday
3,4,11,15,2017,9,11,Monday
3,8,8,16,2018,1,30,Tuesday
1,7,12,19,2017,3,22,Wednseday
0,4,15,19,2018,7,5,Thursday
3,9,17,26,2018,7,21,Saturday
2,17,13,30,2018,4,15,Sunday
4,7,14,21,2018,4,16,Monday
1,14,22,36,2018,5,9,Wednseday
1,7,16,23,2017,5,16,Tuesday
0,14,20,34,2018,6,21,Thursday
3,9,7,16,2017,11,21,Tuesday
1,9,35,44,2018,6,6,Wednseday
3,34,-10,24,2017,11,24,Friday
2,14,7,21,2017,10,24,Tuesday
3,6,0,6,2018,8,24,Friday
1,3,18,21,2017,5,29,Monday
2,11,7,18,2018,3,4,Sunday
2,13,10,23,2018,2,28,Wednseday
4,17,11,28,2018,1,29,Monday
3,8,22,30,2018,5,6,Sunday
2,10,13,23,2017,8,8,Tuesday
2,4,6,10,2018,4,2,Monday
7,42,-16,26,2018,2,14,Wednseday
5,9,12,21,2018,1,10,Wednseday
1,34,-3,31,2018,1,16,Tuesday
3,4,13,17,2018,2,4,Sunday
1,12,31,43,2018,6,6,Wednseday
2,22,1,23,2018,2,27,Tuesday
1,3,7,10,2018,3,13,Tuesday
2,14,-1,13,2018,5,16,Wednseday
8,20,27,47,2017,3,16,Thursday
2,7,5,12,2018,8,8,Wednseday
5,25,0,25,2017,6,15,Thursday
2,16,6,22,2017,7,12,Wednseday
3,25,-6,19,2018,3,17,Saturday
1,12,35,47,2018,5,31,Thursday
2,4,11,15,2018,5,14,Monday
1,7,15,22,2018,2,1,Thursday
0,1,12,13,2017,9,5,Tuesday
4,9,24,33,2018,1,21,Sunday
1,2,12,14,2018,7,2,Monday
6,12,13,25,2017,9,28,Thursday
0,5,20,25,2017,8,3,Thursday
2,13,21,34,2017,7,12,Wednseday
0,4,9,13,2018,8,14,Tuesday
1,9,36,45,2018,8,20,Monday
3,6,18,24,2018,1,26,Friday
1,9,11,20,2017,11,16,Thursday
2,5,19,24,2017,7,15,Saturday
1,2,9,11,2017,9,10,Sunday
4,12,9,21,2017,6,2,Friday
6,13,17,30,2017,7,29,Saturday
1,15,8,23,2017,10,22,Sunday
4,10,7,17,2018,8,10,Friday
6,16,12,28,2018,3,20,Tuesday
5,19,14,33,2018,2,3,Saturday
7,12,14,26,2018,7,12,Thursday
1,4,9,13,2018,8,23,Thursday
2,3,12,15,2017,8,29,Tuesday
3,27,15,42,2017,8,29,Tuesday
2,33,0,33,2018,2,14,Wednseday
3,8,12,20,2017,11,14,Tuesday
1,2,11,13,2017,8,15,Tuesday
9,14,6,20,2017,7,19,Wednseday
1,15,14,29,2017,9,19,Tuesday
2,15,34,49,2017,9,12,Tuesday
4,9,5,14,2018,8,9,Thursday
2,9,20,29,2017,7,12,Wednseday
12,19,17,36,2017,5,7,Sunday
4,12,25,37,2018,4,28,Saturday
2,6,13,19,2018,7,28,Saturday
0,8,18,26,2017,12,13,Wednseday
3,10,10,20,2017,7,15,Saturday
6,7,7,14,2018,2,22,Thursday
3,7,17,24,2017,7,14,Friday
6,14,15,29,2018,2,1,Thursday
1,6,14,20,2017,6,29,Thursday
4,13,20,33,2018,3,23,Friday
1,2,15,17,2017,12,11,Monday
4,13,6,19,2017,10,15,Sunday
1,8,19,27,2018,8,22,Wednseday
4,5,9,14,2017,8,10,Thursday
3,7,12,19,2017,8,26,Saturday
5,12,13,25,2017,12,30,Saturday
4,8,17,25,2018,2,11,Sunday
6,36,-14,22,2018,5,16,Wednseday
1,20,15,35,2018,1,30,Tuesday
2,17,35,52,2018,6,26,Tuesday
3,7,20,27,2018,2,2,Friday
5,20,16,36,2018,2,1,Thursday
1,3,20,23,2018,1,23,Tuesday
4,38,7,45,2018,2,10,Saturday
5,13,13,26,2018,2,28,Wednseday
2,13,20,33,2017,8,20,Sunday
1,15,20,35,2018,3,5,Monday
3,10,9,19,2018,8,3,Friday
1,24,11,35,2017,8,15,Tuesday
5,10,4,14,2018,5,11,Friday
8,9,6,15,2018,1,18,Thursday
4,6,20,26,2018,8,11,Saturday
4,13,7,20,2017,11,3,Friday
3,10,18,28,2017,8,4,Friday
2,10,9,19,2017,11,12,Sunday
3,11,15,26,2017,7,29,Saturday
2,7,21,28,2018,7,3,Tuesday
3,9,16,25,2018,6,25,Monday
5,8,18,26,2017,10,12,Thursday
3,13,14,27,2017,8,18,Friday
2,4,4,8,2018,8,20,Monday
2,13,9,22,2018,3,14,Wednseday
1,13,15,28,2018,1,10,Wednseday
1,15,11,26,2018,2,7,Wednseday
1,6,19,25,2018,7,26,Thursday
1,5,15,20,2018,1,10,Wednseday
10,19,13,32,2017,8,5,Saturday
3,7,13,20,2017,7,14,Friday
3,13,12,25,2017,6,9,Friday
4,32,-9,23,2017,11,25,Saturday
1,4,14,18,2018,5,14,Monday
2,7,8,15,2018,5,15,Tuesday
3,4,6,10,2018,7,21,Saturday
5,6,7,13,2017,5,17,Wednseday
2,7,18,25,2018,1,15,Monday
1,11,22,33,2018,3,15,Thursday
2,8,18,26,2018,3,25,Sunday
13,20,7,27,2018,7,25,Wednseday
4,17,7,24,2018,5,18,Friday
15,37,12,49,2018,1,22,Monday
7,9,18,27,2018,3,14,Wednseday
3,35,-7,28,2018,2,12,Monday
1,6,14,20,2018,4,13,Friday
11,18,19,37,2017,4,23,Sunday
1,5,10,15,2018,2,15,Thursday
1,6,9,15,2018,7,31,Tuesday
5,8,12,20,2017,12,28,Thursday
1,11,15,26,2017,9,7,Thursday
3,14,14,28,2018,1,9,Tuesday
4,12,20,32,2018,7,13,Friday
1,4,10,14,2018,7,23,Monday
3,18,9,27,2018,2,2,Friday
1,10,16,26,2018,2,18,Sunday
3,4,5,9,2017,5,15,Monday
3,15,17,32,2017,9,24,Sunday
0,21,19,40,2017,11,9,Thursday
4,13,11,24,2017,3,25,Saturday
3,8,23,31,2018,1,26,Friday
5,14,26,40,2017,3,1,Wednseday
1,3,16,19,2018,1,7,Sunday
3,15,15,30,2018,1,15,Monday
1,3,11,14,2017,11,27,Monday
13,22,5,27,2017,9,14,Thursday
1,8,20,28,2017,7,4,Tuesday
0,8,26,34,2018,6,13,Wednseday
5,37,10,47,2018,4,25,Wednseday
2,4,6,10,2018,4,2,Monday
2,7,14,21,2018,7,16,Monday
3,8,15,23,2018,1,22,Monday
3,17,14,31,2018,2,12,Monday
2,15,2,17,2018,7,30,Monday
1,10,19,29,2017,2,14,Tuesday
3,10,15,25,2018,4,1,Sunday
5,8,5,13,2017,6,21,Wednseday
5,29,-7,22,2017,11,16,Thursday
1,22,15,37,2018,1,8,Monday
2,8,29,37,2018,7,22,Sunday
1,9,17,26,2017,5,28,Sunday
1,5,9,14,2018,5,16,Wednseday
2,4,12,16,2018,5,13,Sunday
3,14,22,36,2017,8,14,Monday
2,5,11,16,2018,1,3,Wednseday
5,10,4,14,2018,7,20,Friday
15,46,-7,39,2017,10,30,Monday
4,5,6,11,2018,5,10,Thursday
1,6,23,29,2018,1,3,Wednseday
4,17,9,26,2017,4,28,Friday
4,9,21,30,2017,8,21,Monday
2,4,18,22,2017,8,20,Sunday
2,5,7,12,2018,6,13,Wednseday
3,16,6,22,2018,1,30,Tuesday
2,3,14,17,2018,1,9,Tuesday
3,9,28,37,2017,4,8,Saturday
5,9,10,19,2017,3,1,Wednseday
1,26,-7,19,2018,7,25,Wednseday
2,15,9,24,2017,7,11,Tuesday
1,11,4,15,2017,6,11,Sunday
6,10,23,33,2017,2,4,Saturday
2,7,10,17,2017,8,29,Tuesday
6,26,8,34,2017,4,13,Thursday
1,14,11,25,2017,6,8,Thursday
2,4,14,18,2017,7,31,Monday
2,4,0,4,2018,8,20,Monday
3,23,9,32,2017,7,22,Saturday
7,11,6,17,2017,9,18,Monday
2,3,15,18,2018,4,22,Sunday
1,9,12,21,2018,2,26,Monday
6,20,15,35,2017,5,30,Tuesday
1,14,8,22,2018,2,8,Thursday
3,30,2,32,2017,9,30,Saturday
2,7,0,7,2018,8,2,Thursday
1,8,12,20,2018,7,5,Thursday
2,7,22,29,2017,2,7,Tuesday
1,7,11,18,2017,8,14,Monday
1,9,23,32,2018,1,7,Sunday
2,6,10,16,2018,7,24,Tuesday
9,38,-15,23,2017,11,28,Tuesday
2,7,16,23,2017,3,13,Monday
1,3,12,15,2017,11,26,Sunday
3,12,16,28,2017,4,21,Friday
4,13,14,27,2018,1,26,Friday
7,14,7,21,2018,4,23,Monday
2,4,7,11,2018,7,8,Sunday
1,16,3,19,2018,3,25,Sunday
5,21,5,26,2018,1,10,Wednseday
7,13,9,22,2017,7,11,Tuesday
1,15,13,28,2018,5,9,Wednseday
0,20,14,34,2017,7,21,Friday
6,15,14,29,2018,3,28,Wednseday
3,15,8,23,2017,9,5,Tuesday
5,13,14,27,2017,8,24,Thursday
4,8,13,21,2017,8,24,Thursday
5,8,11,19,2018,5,10,Thursday
2,7,21,28,2018,4,16,Monday
2,4,9,13,2018,5,5,Saturday
2,22,2,24,2017,7,4,Tuesday
2,33,-10,23,2018,3,19,Monday
3,4,28,32,2018,5,13,Sunday
0,13,22,35,2018,1,18,Thursday
1,11,4,15,2018,1,15,Monday
6,21,12,33,2017,11,30,Thursday
6,8,12,20,2018,4,5,Thursday
2,3,19,22,2017,8,7,Monday
1,14,9,23,2018,2,14,Wednseday
1,10,15,25,2017,5,1,Monday
1,10,15,25,2017,11,13,Monday
0,9,4,13,2018,5,16,Wednseday
1,13,15,28,2018,5,23,Wednseday
6,13,47,60,2017,9,22,Friday
7,14,8,22,2017,5,16,Tuesday
5,18,2,20,2017,11,24,Friday
3,7,13,20,2017,3,28,Tuesday
35,50,-22,28,2017,10,19,Thursday
5,9,15,24,2017,4,2,Sunday
2,15,8,23,2018,4,23,Monday
1,9,29,38,2018,6,4,Monday
5,10,9,19,2017,10,13,Friday
1,28,-1,27,2018,2,9,Friday
3,23,1,24,2018,3,5,Monday
2,31,-6,25,2018,4,1,Sunday
4,12,7,19,2017,9,14,Thursday
7,18,11,29,2018,6,12,Tuesday
2,31,-10,21,2017,3,22,Wednseday
12,16,0,16,2018,8,4,Saturday
1,4,9,13,2017,7,27,Thursday
4,6,22,28,2017,11,24,Friday
2,15,7,22,2017,11,26,Sunday
5,17,8,25,2018,8,9,Thursday
7,14,21,35,2018,2,8,Thursday
2,7,15,22,2017,3,20,Monday
1,10,7,17,2018,5,8,Tuesday
2,12,14,26,2018,7,4,Wednseday
5,7,16,23,2018,6,20,Wednseday
3,11,17,28,2018,1,26,Friday
3,14,2,16,2018,3,13,Tuesday
3,15,23,38,2018,6,10,Sunday
1,8,27,35,2018,6,13,Wednseday
2,8,16,24,2017,5,1,Monday
3,15,6,21,2017,11,14,Tuesday
1,2,14,16,2018,4,10,Tuesday
2,8,18,26,2017,8,2,Wednseday
2,28,3,31,2018,1,6,Saturday
1,12,9,21,2018,7,25,Wednseday
4,10,21,31,2017,3,10,Friday
4,27,-9,18,2018,3,1,Thursday
7,13,9,22,2017,5,16,Tuesday
3,10,14,24,2018,4,1,Sunday
1,8,17,25,2017,5,4,Thursday
3,5,12,17,2017,11,27,Monday
6,15,5,20,2018,2,20,Tuesday
7,21,3,24,2017,7,28,Friday
2,13,6,19,2017,10,18,Wednseday
13,33,21,54,2018,1,18,Thursday
2,8,9,17,2018,8,14,Tuesday
19,25,1,26,2018,5,11,Friday
6,15,13,28,2017,8,9,Wednseday
0,13,9,22,2018,3,28,Wednseday
7,28,-1,27,2018,1,9,Tuesday
1,7,25,32,2018,1,18,Thursday
0,11,15,26,2018,1,25,Thursday
1,2,1,3,2018,8,27,Monday
1,12,19,31,2017,5,14,Sunday
3,7,15,22,2017,9,25,Monday
3,12,9,21,2018,4,23,Monday
9,19,8,27,2017,3,29,Wednseday
5,12,8,20,2017,10,20,Friday
2,4,14,18,2018,3,18,Sunday
4,40,-6,34,2017,11,24,Friday
2,11,14,25,2017,9,25,Monday
3,14,10,24,2018,3,16,Friday
3,4,7,11,2017,6,19,Monday
1,20,4,24,2018,1,30,Tuesday
3,16,11,27,2017,10,17,Tuesday
3,24,3,27,2018,1,26,Friday
0,5,18,23,2018,1,24,Wednseday
1,10,13,23,2018,4,24,Tuesday
6,16,20,36,2017,6,6,Tuesday
10,25,14,39,2017,12,3,Sunday
0,10,19,29,2017,4,17,Monday
3,18,6,24,2017,7,14,Friday
1,9,16,25,2017,10,23,Monday
1,48,-15,33,2017,2,9,Thursday
7,11,26,37,2018,4,30,Monday
3,17,15,32,2017,12,30,Saturday
1,15,4,19,2018,5,17,Thursday
4,7,11,18,2018,1,20,Saturday
6,16,14,30,2017,12,13,Wednseday
1,3,14,17,2017,9,12,Tuesday
2,9,20,29,2018,1,21,Sunday
0,5,9,14,2018,7,20,Friday
7,35,-1,34,2018,2,14,Wednseday
2,9,15,24,2018,1,9,Tuesday
4,7,14,21,2017,12,29,Friday
0,1,19,20,2017,12,28,Thursday
7,20,21,41,2018,2,13,Tuesday
1,33,17,50,2018,7,15,Sunday
0,11,27,38,2018,6,15,Friday
0,7,16,23,2018,8,14,Tuesday
2,13,40,53,2018,5,26,Saturday
18,28,4,32,2017,4,7,Friday
1,12,17,29,2017,11,13,Monday
3,10,19,29,2017,7,18,Tuesday
3,26,7,33,2018,3,2,Friday
0,1,12,13,2018,5,16,Wednseday
1,6,24,30,2018,1,9,Tuesday
6,13,6,19,2018,8,8,Wednseday
3,4,5,9,2018,5,6,Sunday
2,16,11,27,2018,7,28,Saturday
3,26,-8,18,2018,5,20,Sunday
4,5,13,18,2018,8,5,Sunday
4,12,26,38,2017,4,7,Friday
2,4,18,22,2018,5,6,Sunday
3,16,7,23,2017,8,26,Saturday
4,6,17,23,2017,5,27,Saturday
9,27,4,31,2018,1,30,Tuesday
3,4,15,19,2017,12,2,Saturday
3,14,8,22,2017,6,26,Monday
2,7,9,16,2018,7,17,Tuesday
1,5,14,19,2018,7,19,Thursday
2,5,19,24,2017,10,29,Sunday
2,7,20,27,2017,12,20,Wednseday
3,13,10,23,2017,7,30,Sunday
2,3,11,14,2018,6,12,Tuesday
2,8,9,17,2017,3,13,Monday
2,21,6,27,2018,3,13,Tuesday
3,31,-2,29,2017,12,5,Tuesday
2,3,27,30,2017,11,26,Sunday
6,11,11,22,2018,4,26,Thursday
0,5,8,13,2018,3,21,Wednseday
1,11,12,23,2017,12,4,Monday
7,10,10,20,2018,2,27,Tuesday
5,8,12,20,2018,7,5,Thursday
3,58,-19,39,2017,1,7,Saturday
2,7,4,11,2018,8,13,Monday
4,5,1,6,2018,8,4,Saturday
1,18,13,31,2017,7,23,Sunday
1,34,-10,24,2017,9,12,Tuesday
4,22,3,25,2018,2,1,Thursday
1,4,19,23,2017,9,18,Monday
2,21,2,23,2017,10,21,Saturday
1,17,7,24,2017,5,15,Monday
5,7,14,21,2017,4,5,Wednseday
5,12,21,33,2018,1,3,Wednseday
3,4,7,11,2017,5,13,Saturday
1,31,-11,20,2018,3,13,Tuesday
0,6,21,27,2018,8,7,Tuesday
3,20,7,27,2018,3,16,Friday
1,4,4,8,2018,4,19,Thursday
2,46,-11,35,2018,2,26,Monday
2,3,13,16,2018,6,26,Tuesday
5,26,1,27,2017,9,30,Saturday
3,7,13,20,2017,11,28,Tuesday
3,4,14,18,2018,1,27,Saturday
1,9,19,28,2018,5,2,Wednseday
5,19,2,21,2018,7,11,Wednseday
3,10,3,13,2018,8,17,Friday
1,5,18,23,2017,10,16,Monday
1,67,-41,26,2018,7,22,Sunday
7,12,9,21,2018,7,26,Thursday
2,16,20,36,2017,12,27,Wednseday
3,8,27,35,2018,1,31,Wednseday
1,8,15,23,2017,11,26,Sunday
1,10,16,26,2018,2,18,Sunday
3,7,10,17,2018,8,10,Friday
4,11,41,52,2018,6,22,Friday
4,10,16,26,2017,11,24,Friday
1,8,11,19,2018,8,16,Thursday
2,11,16,27,2017,2,23,Thursday
1,9,17,26,2017,7,5,Wednseday
4,5,34,39,2017,2,9,Thursday
3,4,12,16,2018,6,30,Saturday
2,5,10,15,2017,11,12,Sunday
2,8,14,22,2017,8,2,Wednseday
3,12,13,25,2017,6,10,Saturday
7,11,13,24,2018,7,30,Monday
3,28,-2,26,2017,11,24,Friday
2,23,7,30,2017,12,11,Monday
11,24,-4,20,2017,10,28,Saturday
2,14,18,32,2018,2,4,Sunday
9,17,19,36,2018,4,29,Sunday
1,24,16,40,2018,6,3,Sunday
1,16,1,17,2018,3,12,Monday
2,17,6,23,2017,4,17,Monday
3,12,18,30,2018,1,22,Monday
4,31,-7,24,2018,3,12,Monday
4,6,12,18,2018,2,2,Friday
0,6,19,25,2018,4,12,Thursday
3,7,7,14,2018,8,1,Wednseday
2,9,24,33,2017,10,1,Sunday
3,9,11,20,2017,9,16,Saturday
2,7,15,22,2017,12,19,Tuesday
0,3,8,11,2017,6,19,Monday
2,9,14,23,2017,11,7,Tuesday
2,4,18,22,2017,7,24,Monday
3,3,11,14,2018,8,6,Monday
2,3,20,23,2018,7,1,Sunday
3,6,13,19,2017,10,21,Saturday
1,4,17,21,2018,6,25,Monday
1,11,12,23,2018,8,19,Sunday
6,10,3,13,2018,3,3,Saturday
1,7,20,27,2018,4,18,Wednseday
4,5,7,12,2018,7,22,Sunday
1,7,15,22,2018,5,16,Wednseday
1,11,14,25,2017,11,23,Thursday
4,5,5,10,2018,7,20,Friday
20,28,-3,25,2017,8,17,Thursday
2,17,18,35,2018,4,23,Monday
0,8,12,20,2018,5,4,Friday
3,8,17,25,2017,12,10,Sunday
3,8,13,21,2017,3,13,Monday
6,10,17,27,2017,10,7,Saturday
2,7,18,25,2018,1,11,Thursday
4,7,18,25,2017,3,31,Friday
4,25,23,48,2018,6,1,Friday
6,17,7,24,2017,10,14,Saturday
3,8,22,30,2017,9,24,Sunday
3,14,17,31,2017,5,12,Friday
2,5,0,5,2018,8,4,Saturday
5,17,12,29,2017,12,10,Sunday
10,10,2,12,2017,7,16,Sunday
2,4,25,29,2018,3,4,Sunday
5,16,28,44,2017,12,11,Monday
2,16,15,31,2017,6,10,Saturday
2,8,19,27,2017,1,31,Tuesday
1,6,30,36,2018,4,24,Tuesday
1,15,19,34,2018,2,7,Wednseday
7,24,9,33,2017,9,29,Friday
7,14,13,27,2018,2,16,Friday
2,47,-25,22,2018,3,21,Wednseday
3,4,10,14,2017,11,24,Friday
12,46,-25,21,2017,11,24,Friday
1,9,7,16,2018,4,2,Monday
1,13,13,26,2017,5,18,Thursday
2,16,8,24,2018,5,1,Tuesday
7,19,5,24,2017,9,9,Saturday
4,8,17,25,2018,3,2,Friday
2,17,1,18,2017,10,30,Monday
1,9,23,32,2018,7,2,Monday
2,8,20,28,2018,6,18,Monday
3,24,0,24,2017,9,19,Tuesday
3,8,20,28,2017,2,7,Tuesday
1,11,11,22,2017,3,27,Monday
8,12,7,19,2018,1,11,Thursday
3,23,21,44,2017,7,11,Tuesday
1,15,25,40,2017,3,26,Sunday
6,11,29,40,2018,3,17,Saturday
3,11,21,32,2018,5,4,Friday
2,5,13,18,2018,3,11,Sunday
2,16,17,33,2017,10,1,Sunday
3,7,21,28,2018,6,29,Friday
1,25,7,32,2018,2,4,Sunday
2,15,7,22,2017,11,14,Tuesday
7,15,12,27,2018,2,14,Wednseday
7,11,11,22,2018,4,10,Tuesday
1,5,9,14,2018,7,26,Thursday
3,8,21,29,2017,1,24,Tuesday
1,43,-20,23,2018,2,18,Sunday
4,6,7,13,2017,7,20,Thursday
5,6,6,12,2018,5,2,Wednseday
4,6,26,32,2018,4,8,Sunday
1,13,9,22,2017,7,6,Thursday
2,13,17,30,2017,4,26,Wednseday
1,8,13,21,2018,5,15,Tuesday
1,15,6,21,2017,10,9,Monday
6,21,19,40,2017,5,3,Wednseday
0,7,15,22,2017,8,9,Wednseday
1,13,10,23,2017,8,22,Tuesday
2,12,10,22,2017,7,19,Wednseday
3,12,23,35,2017,8,25,Friday
2,5,14,19,2018,5,23,Wednseday
2,11,13,24,2017,11,6,Monday
9,11,8,19,2018,7,15,Sunday
1,19,3,22,2017,6,29,Thursday
1,6,6,12,2018,8,23,Thursday
0,1,18,19,2018,4,19,Thursday
4,8,13,21,2017,11,17,Friday
0,5,7,12,2018,8,23,Thursday
5,27,9,36,2017,12,28,Thursday
3,9,20,29,2017,12,17,Sunday
12,21,14,35,2018,3,12,Monday
4,32,21,53,2018,4,7,Saturday
2,15,9,24,2017,5,29,Monday
1,6,19,25,2017,5,18,Thursday
2,10,10,20,2018,2,24,Saturday
1,13,11,24,2018,1,15,Monday
0,15,12,27,2017,8,16,Wednseday
2,13,8,21,2018,8,15,Wednseday
1,23,12,35,2017,12,27,Wednseday
1,17,13,30,2017,12,17,Sunday
6,18,17,35,2018,1,5,Friday
1,6,23,29,2018,5,8,Tuesday
1,8,14,22,2017,11,21,Tuesday
18,26,-2,24,2017,10,6,Friday
2,31,-1,30,2018,5,9,Wednseday
4,9,11,20,2018,2,17,Saturday
3,16,6,22,2017,8,14,Monday
3,22,2,24,2018,2,2,Friday
4,5,11,16,2017,11,25,Saturday
7,11,12,23,2018,4,30,Monday
1,5,7,12,2018,4,4,Wednseday
2,6,13,19,2017,3,22,Wednseday
5,13,19,32,2017,12,8,Friday
1,13,16,29,2018,4,19,Thursday
0,4,10,14,2018,4,26,Thursday
4,32,2,34,2017,6,8,Thursday
7,16,14,30,2017,4,17,Monday
1,10,6,16,2017,10,9,Monday
1,3,4,7,2018,8,6,Monday
3,6,14,20,2018,8,24,Friday
3,30,-10,20,2018,3,17,Saturday
2,4,12,16,2018,1,14,Sunday
2,5,11,16,2018,7,18,Wednseday
2,16,13,29,2017,5,29,Monday
2,6,16,22,2018,8,1,Wednseday
0,5,9,14,2018,2,9,Friday
4,10,4,14,2018,8,17,Friday
11,18,12,30,2018,2,26,Monday
7,16,7,23,2017,12,4,Monday
6,20,4,24,2017,7,8,Saturday
1,10,13,23,2018,8,5,Sunday
0,7,27,34,2018,4,26,Thursday
3,9,4,13,2018,8,11,Saturday
4,26,5,31,2018,5,11,Friday
1,3,12,15,2018,1,22,Monday
1,9,8,17,2017,5,14,Sunday
0,6,17,23,2018,8,22,Wednseday
7,14,33,47,2018,5,9,Wednseday
5,6,11,17,2017,7,29,Saturday
1,12,15,27,2017,6,7,Wednseday
4,12,16,28,2017,3,23,Thursday
6,14,16,30,2017,11,11,Saturday
1,9,8,17,2017,9,18,Monday
9,10,10,20,2017,8,12,Saturday
3,8,16,24,2018,3,9,Friday
2,9,14,23,2017,10,25,Wednseday
3,5,6,11,2018,8,3,Friday
1,15,2,17,2017,9,17,Sunday
3,4,5,9,2018,5,14,Monday
1,36,7,43,2017,3,27,Monday
4,7,0,7,2018,8,9,Thursday
7,28,5,33,2017,9,27,Wednseday
3,20,6,26,2017,11,24,Friday
5,21,15,36,2018,5,30,Wednseday
2,57,-28,29,2018,6,24,Sunday
1,6,21,27,2017,10,10,Tuesday
1,2,9,11,2018,4,1,Sunday
1,22,12,34,2018,5,16,Wednseday
4,7,14,21,2018,3,1,Thursday
1,19,18,37,2017,2,22,Wednseday
1,5,25,30,2018,4,15,Sunday
1,4,19,23,2017,7,9,Sunday
1,2,7,9,2018,7,22,Sunday
1,6,16,22,2017,5,4,Thursday
7,29,-6,23,2018,1,23,Tuesday
2,4,13,17,2017,7,10,Monday
3,6,4,10,2017,11,21,Tuesday
3,4,19,23,2017,5,6,Saturday
1,12,30,42,2017,4,27,Thursday
1,9,33,42,2017,6,19,Monday
1,4,19,23,2018,4,23,Monday
1,5,15,20,2017,12,21,Thursday
1,12,16,28,2017,10,12,Thursday
2,11,13,24,2017,7,17,Monday
1,8,9,17,2018,5,8,Tuesday
1,7,13,20,2018,6,14,Thursday
4,12,0,12,2018,8,10,Friday
4,17,11,28,2017,10,13,Friday
5,10,10,20,2017,5,12,Friday
2,10,12,22,2018,3,5,Monday
6,13,11,24,2018,2,2,Friday
3,4,16,20,2017,7,29,Saturday
10,11,10,21,2018,4,23,Monday
2,4,12,16,2018,5,14,Monday
1,12,11,23,2017,5,29,Monday
16,32,17,49,2018,1,17,Wednseday
12,40,16,56,2018,1,18,Thursday
2,7,13,20,2017,12,19,Tuesday
2,5,25,30,2018,6,23,Saturday
1,33,-6,27,2017,12,13,Wednseday
2,17,10,27,2017,3,4,Saturday
4,28,28,56,2018,4,19,Thursday
5,8,4,12,2017,10,18,Wednseday
2,5,6,11,2018,6,9,Saturday
1,6,16,22,2017,6,27,Tuesday
3,9,17,26,2017,9,22,Friday
3,4,9,13,2018,5,15,Tuesday
1,4,17,21,2018,7,16,Monday
3,21,10,31,2018,1,26,Friday
6,13,20,33,2018,6,15,Friday
2,10,23,33,2017,12,31,Sunday
5,7,7,14,2017,8,25,Friday
1,14,21,35,2017,8,7,Monday
1,5,8,13,2018,3,28,Wednseday
2,5,16,21,2017,7,24,Monday
5,14,19,33,2018,5,24,Thursday
7,20,15,35,2017,12,20,Wednseday
2,18,21,39,2017,7,2,Sunday
5,12,15,27,2017,10,5,Thursday
2,10,10,20,2018,5,8,Tuesday
4,15,17,32,2017,9,11,Monday
7,12,21,33,2018,7,11,Wednseday
4,10,20,30,2018,2,10,Saturday
2,15,7,22,2017,11,20,Monday
0,2,21,23,2018,6,27,Wednseday
2,7,15,22,2017,12,7,Thursday
4,20,7,27,2017,11,25,Saturday
3,4,9,13,2017,7,8,Saturday
4,13,20,33,2018,4,26,Thursday
1,6,23,29,2018,6,28,Thursday
3,6,14,20,2017,11,24,Friday
2,6,17,23,2017,11,4,Saturday
2,4,5,9,2018,8,11,Saturday
1,78,-50,28,2018,7,3,Tuesday
5,8,19,27,2017,2,15,Wednseday
5,15,10,25,2018,4,5,Thursday
0,13,8,21,2018,2,27,Tuesday
0,7,17,24,2018,8,17,Friday
2,10,12,22,2018,4,1,Sunday
1,4,18,22,2018,6,26,Tuesday
8,28,13,41,2017,8,15,Tuesday
1,9,10,19,2018,2,18,Sunday
6,9,7,16,2017,11,25,Saturday
3,14,24,38,2017,12,1,Friday
3,7,12,19,2018,7,6,Friday
0,6,13,19,2017,10,11,Wednseday
3,7,19,26,2018,5,25,Friday
2,10,14,24,2017,10,16,Monday
6,12,14,26,2018,8,11,Saturday
2,3,13,16,2018,4,24,Tuesday
2,13,19,32,2017,4,22,Saturday
0,3,6,9,2018,8,7,Tuesday
7,34,2,36,2017,11,30,Thursday
4,13,13,26,2017,3,24,Friday
2,11,9,20,2017,5,9,Tuesday
5,6,12,18,2018,4,12,Thursday
2,16,15,31,2018,1,20,Saturday
1,7,15,22,2018,6,21,Thursday
5,21,5,26,2018,3,7,Wednseday
1,12,11,23,2018,3,25,Sunday
2,13,11,24,2017,6,20,Tuesday
22,30,-2,28,2018,3,5,Monday
5,11,14,25,2018,4,19,Thursday
1,3,11,14,2018,7,24,Tuesday
0,8,-3,5,2018,8,10,Friday
0,7,20,27,2017,11,24,Friday
4,11,16,27,2017,11,2,Thursday
4,13,12,25,2017,5,29,Monday
2,5,11,16,2018,2,18,Sunday
3,9,14,23,2018,3,24,Saturday
2,10,8,18,2017,11,19,Sunday
7,12,17,29,2018,7,11,Wednseday
1,2,7,9,2018,8,15,Wednseday
2,3,14,17,2018,4,17,Tuesday
6,7,7,14,2018,2,22,Thursday
3,55,-23,32,2018,4,14,Saturday
1,7,18,25,2017,8,17,Thursday
0,4,16,20,2018,5,17,Thursday
3,12,13,25,2018,4,27,Friday
3,18,10,28,2017,8,28,Monday
7,12,12,24,2018,1,12,Friday
4,17,17,34,2018,5,25,Friday
5,10,15,25,2017,12,10,Sunday
16,22,21,43,2018,7,29,Sunday
4,9,7,16,2018,7,16,Monday
1,8,15,23,2017,8,13,Sunday
6,8,17,25,2017,11,23,Thursday
4,6,13,19,2018,4,19,Thursday
2,8,17,25,2017,10,29,Sunday
1,33,0,33,2017,12,21,Thursday
1,13,8,21,2017,11,8,Wednseday
1,10,14,24,2017,7,11,Tuesday
1,6,15,21,2018,4,18,Wednseday
1,15,22,37,2018,1,15,Monday
1,4,14,18,2018,5,7,Monday
1,6,11,17,2018,5,1,Tuesday
24,32,23,55,2016,10,6,Thursday
1,4,17,21,2017,3,6,Monday
1,2,29,31,2018,6,17,Sunday
4,6,19,25,2018,1,4,Thursday
9,33,-1,32,2018,2,11,Sunday
1,5,17,22,2018,6,28,Thursday
2,15,6,21,2017,8,29,Tuesday
2,10,23,33,2017,2,11,Saturday
3,9,14,23,2017,5,27,Saturday
1,6,19,25,2018,1,7,Sunday
2,3,19,22,2017,5,7,Sunday
5,29,5,34,2018,1,3,Wednseday
11,12,13,25,2018,6,22,Friday
10,14,28,42,2018,6,15,Friday
1,12,14,26,2018,2,8,Thursday
5,11,14,25,2017,12,30,Saturday
3,11,20,31,2017,10,8,Sunday
1,3,25,28,2017,10,2,Monday
10,11,0,11,2018,8,4,Saturday
0,4,20,24,2018,6,29,Friday
1,11,19,30,2018,8,6,Monday
6,9,14,23,2018,3,14,Wednseday
13,22,13,35,2018,8,2,Thursday
7,10,4,14,2017,11,3,Friday
4,24,1,25,2017,7,2,Sunday
3,6,10,16,2018,8,4,Saturday
10,17,15,32,2017,7,14,Friday
0,10,8,18,2018,6,8,Friday
6,36,-3,33,2018,3,15,Thursday
3,6,12,18,2018,8,17,Friday
1,6,21,27,2018,1,23,Tuesday
9,17,14,31,2017,9,2,Saturday
18,38,-13,25,2017,11,4,Saturday
2,8,12,20,2017,7,18,Tuesday
1,8,17,25,2017,3,2,Thursday
2,5,20,25,2017,9,11,Monday
1,2,5,7,2018,8,1,Wednseday
5,9,5,14,2018,2,22,Thursday
2,18,4,22,2018,3,25,Sunday
1,16,1,17,2018,5,22,Tuesday
1,12,9,21,2018,2,26,Monday
6,7,16,23,2017,8,2,Wednseday
1,4,19,23,2018,3,20,Tuesday
0,3,20,23,2017,10,3,Tuesday
3,10,8,18,2017,5,12,Friday
3,15,11,26,2017,11,11,Saturday
2,19,9,28,2018,5,9,Wednseday
1,4,7,11,2017,11,20,Monday
11,19,8,27,2018,4,21,Saturday
9,14,10,24,2017,7,25,Tuesday
6,15,11,26,2017,8,9,Wednseday
1,6,6,12,2018,4,5,Thursday
2,14,17,31,2018,1,16,Tuesday
3,7,24,31,2017,7,25,Tuesday
3,9,7,16,2018,3,13,Tuesday
4,16,22,38,2017,9,24,Sunday
3,10,15,25,2017,12,17,Sunday
4,6,6,12,2017,9,16,Saturday
1,6,11,17,2017,9,19,Tuesday
1,8,31,39,2017,2,9,Thursday
1,14,12,26,2017,11,22,Wednseday
12,15,11,26,2017,1,25,Wednseday
2,3,7,10,2017,9,12,Tuesday
5,8,25,33,2017,11,1,Wednseday
4,21,-4,17,2018,7,20,Friday
6,14,6,20,2018,2,21,Wednseday
2,9,8,17,2017,9,10,Sunday
1,7,11,18,2018,7,19,Thursday
5,17,17,34,2018,8,3,Friday
15,18,12,30,2018,7,22,Sunday
1,9,13,22,2017,7,12,Wednseday
5,11,8,19,2018,3,29,Thursday
6,14,11,25,2018,7,12,Thursday
2,13,14,27,2018,1,24,Wednseday
2,7,21,28,2018,3,1,Thursday
1,7,28,35,2017,2,23,Thursday
1,2,7,9,2018,7,9,Monday
3,12,9,21,2018,7,20,Friday
5,13,8,21,2018,3,8,Thursday
9,21,11,32,2018,5,21,Monday
3,21,10,31,2017,5,2,Tuesday
2,13,1,14,2018,7,11,Wednseday
4,17,18,35,2017,5,22,Monday
0,5,7,12,2018,3,2,Friday
6,14,10,24,2017,12,12,Tuesday
2,37,-3,34,2018,3,10,Saturday
4,11,15,26,2018,5,10,Thursday
4,11,13,24,2017,3,27,Monday
1,4,17,21,2018,1,25,Thursday
0,5,15,20,2018,5,18,Friday
1,6,9,15,2018,8,14,Tuesday
3,8,1,9,2018,8,6,Monday
1,3,21,24,2017,12,26,Tuesday
2,15,21,36,2017,11,29,Wednseday
1,4,17,21,2017,6,15,Thursday
7,14,7,21,2017,6,9,Friday
1,10,8,18,2018,8,2,Thursday
2,5,24,29,2018,6,17,Sunday
1,15,20,35,2018,2,6,Tuesday
1,6,10,16,2017,9,12,Tuesday
2,5,25,30,2017,4,15,Saturday
5,19,16,35,2017,7,6,Thursday
5,13,13,26,2017,11,4,Saturday
1,5,26,31,2018,7,9,Monday
3,9,16,25,2018,1,20,Saturday
1,5,9,14,2018,6,21,Thursday
3,10,11,21,2018,1,16,Tuesday
3,15,14,29,2018,1,21,Sunday
1,8,15,23,2018,7,4,Wednseday
5,21,13,34,2017,7,6,Thursday
10,38,-7,31,2018,2,19,Monday
1,15,8,23,2017,7,25,Tuesday
1,11,15,26,2017,7,27,Thursday
4,11,13,24,2018,3,9,Friday
11,16,-8,8,2018,8,2,Thursday
1,33,-6,27,2017,11,30,Thursday
5,28,-2,26,2018,1,24,Wednseday
2,10,13,23,2018,2,17,Saturday
2,12,27,39,2017,2,11,Saturday
1,27,2,29,2018,2,15,Thursday
2,35,-5,30,2018,2,27,Tuesday
1,4,10,14,2017,11,23,Thursday
0,16,8,24,2018,1,29,Monday
2,6,17,23,2018,5,12,Saturday
4,13,16,29,2018,2,15,Thursday
1,9,13,22,2017,6,29,Thursday
1,4,16,20,2018,4,12,Thursday
3,23,9,32,2018,1,22,Monday
4,18,17,35,2018,4,19,Thursday
5,10,10,20,2017,9,6,Wednseday
2,6,17,23,2018,7,22,Sunday
1,7,23,30,2018,5,8,Tuesday
4,10,20,30,2017,9,4,Monday
3,16,23,39,2018,8,4,Saturday
3,18,6,24,2017,6,4,Sunday
1,8,21,29,2017,4,26,Wednseday
3,10,15,25,2017,12,4,Monday
1,16,12,28,2018,1,8,Monday
1,8,20,28,2018,6,21,Thursday
1,16,4,20,2018,2,28,Wednseday
1,5,25,30,2018,1,21,Sunday
1,14,15,29,2017,8,30,Wednseday
3,6,15,21,2017,11,10,Friday
2,18,5,23,2018,5,19,Saturday
4,27,8,35,2017,8,24,Thursday
9,37,-6,31,2017,12,4,Monday
3,7,20,27,2017,2,10,Friday
1,2,1,3,2018,7,31,Tuesday
5,8,12,20,2017,7,6,Thursday
5,19,20,39,2018,4,5,Thursday
4,17,16,33,2018,1,19,Friday
2,2,1,3,2018,8,7,Tuesday
6,19,4,23,2018,5,19,Saturday
0,5,9,14,2018,7,20,Friday
0,2,8,10,2018,8,7,Tuesday
3,17,20,37,2018,1,14,Sunday
3,10,14,24,2017,7,22,Saturday
3,14,12,26,2017,12,15,Friday
1,21,11,32,2017,5,11,Thursday
1,5,18,23,2017,10,8,Sunday
2,7,7,14,2018,8,13,Monday
1,7,15,22,2017,6,29,Thursday
1,7,27,34,2017,8,16,Wednseday
1,8,13,21,2017,10,10,Tuesday
2,11,12,23,2017,12,4,Monday
6,8,11,19,2017,5,10,Wednseday
2,8,14,22,2018,6,24,Sunday
11,15,16,31,2017,4,24,Monday
9,10,17,27,2017,2,11,Saturday
7,22,6,28,2018,3,21,Wednseday
7,17,11,28,2017,11,28,Tuesday
1,7,17,24,2018,4,10,Tuesday
2,41,-17,24,2017,3,25,Saturday
1,20,19,39,2017,3,9,Thursday
4,10,15,25,2017,12,29,Friday
1,8,16,24,2018,7,2,Monday
1,2,4,6,2018,8,8,Wednseday
3,8,13,21,2018,5,1,Tuesday
8,29,-6,23,2018,2,21,Wednseday
0,8,18,26,2017,9,29,Friday
2,3,21,24,2018,6,5,Tuesday
5,29,-4,25,2018,2,15,Thursday
3,6,11,17,2018,5,18,Friday
4,15,27,42,2018,3,5,Monday
0,18,9,27,2018,3,23,Friday
2,6,10,16,2018,7,25,Wednseday
1,10,30,40,2017,6,7,Wednseday
0,5,21,26,2017,6,9,Friday
1,11,19,30,2017,4,18,Tuesday
1,2,1,3,2018,8,28,Tuesday
3,14,12,26,2017,10,6,Friday
2,3,8,11,2017,9,10,Sunday
1,5,26,31,2018,6,17,Sunday
7,23,4,27,2018,5,1,Tuesday
3,24,10,34,2018,4,20,Friday
8,12,10,22,2018,2,12,Monday
1,14,4,18,2018,1,4,Thursday
2,26,1,27,2018,1,27,Saturday
5,14,11,25,2017,6,2,Friday
2,13,17,30,2018,3,20,Tuesday
6,21,13,34,2017,4,13,Thursday
0,6,16,22,2017,6,20,Tuesday
0,9,14,23,2017,4,26,Wednseday
13,26,-2,24,2017,3,14,Tuesday
1,32,-2,30,2017,12,3,Sunday
2,10,19,29,2017,12,11,Monday
1,3,7,10,2018,6,19,Tuesday
1,3,12,15,2018,8,20,Monday
2,13,17,30,2018,4,17,Tuesday
2,3,7,10,2018,6,10,Sunday
2,8,24,32,2018,6,24,Sunday
5,31,-11,20,2017,10,14,Saturday
3,16,6,22,2018,7,22,Sunday
3,12,13,25,2018,3,24,Saturday
0,11,20,31,2017,12,8,Friday
2,12,12,24,2018,7,22,Sunday
1,2,14,16,2018,6,17,Sunday
1,8,21,29,2018,6,17,Sunday
1,9,27,36,2018,5,15,Tuesday
3,28,26,54,2017,12,15,Friday
1,11,8,19,2018,4,1,Sunday
3,20,2,22,2018,4,4,Wednseday
1,13,7,20,2017,9,13,Wednseday
1,29,10,39,2018,1,28,Sunday
3,5,8,13,2017,7,7,Friday
4,17,8,25,2017,12,17,Sunday
7,12,-5,7,2018,8,9,Thursday
6,13,25,38,2018,2,10,Saturday
11,4,21,25,2017,5,29,Monday
3,5,23,28,2018,2,21,Wednseday
1,8,13,21,2017,9,11,Monday
4,28,6,34,2018,6,7,Thursday
3,4,13,17,2018,1,19,Friday
6,10,12,22,2017,8,15,Tuesday
2,5,14,19,2017,10,4,Wednseday
4,11,16,27,2017,9,2,Saturday
2,17,14,31,2017,2,27,Monday
12,14,-1,13,2018,4,26,Thursday
1,6,15,21,2018,1,18,Thursday
19,23,-4,19,2018,5,16,Wednseday
3,9,14,23,2018,1,10,Wednseday
1,7,10,17,2017,10,9,Monday
13,22,13,35,2017,8,17,Thursday
2,12,28,40,2018,4,5,Thursday
12,17,10,27,2018,7,21,Saturday
4,5,16,21,2017,6,8,Thursday
1,6,11,17,2017,5,14,Sunday
13,32,-3,29,2017,12,7,Thursday
6,7,3,10,2017,10,17,Tuesday
2,11,11,22,2018,1,16,Tuesday
2,7,18,25,2018,3,3,Saturday
0,12,10,22,2017,9,14,Thursday
7,14,8,22,2017,4,18,Tuesday
2,8,22,30,2018,7,4,Wednseday
2,26,18,44,2018,4,14,Saturday
2,9,29,38,2018,4,21,Saturday
5,12,1,13,2018,5,4,Friday
15,17,5,22,2017,7,19,Wednseday
1,11,9,20,2018,2,22,Thursday
4,11,23,34,2017,1,14,Saturday
4,23,11,34,2017,12,26,Tuesday
4,16,6,22,2017,11,26,Sunday
18,22,12,34,2018,7,5,Thursday
2,5,19,24,2018,5,27,Sunday
0,10,31,41,2018,8,15,Wednseday
14,41,-3,38,2018,2,3,Saturday
1,33,-6,27,2018,4,5,Thursday
19,24,2,26,2017,11,24,Friday
3,6,2,8,2018,5,8,Tuesday
1,2,7,9,2018,7,18,Wednseday
2,4,20,24,2017,7,29,Saturday
3,11,23,34,2018,2,6,Tuesday
4,19,14,33,2018,6,16,Saturday
4,5,16,21,2018,4,20,Friday
3,13,24,37,2018,7,22,Sunday
4,8,27,35,2018,1,25,Thursday
4,8,11,19,2018,2,11,Sunday
6,28,-6,22,2018,2,20,Tuesday
1,3,12,15,2018,7,9,Monday
5,14,21,35,2017,6,14,Wednseday
4,22,15,37,2018,7,16,Monday
2,8,20,28,2018,4,10,Tuesday
0,11,13,24,2018,1,15,Monday
5,13,22,35,2017,3,1,Wednseday
4,13,14,27,2017,10,5,Thursday
7,28,0,28,2017,12,7,Thursday
3,15,12,27,2017,2,14,Tuesday
2,7,21,28,2018,8,6,Monday
12,13,4,17,2018,7,20,Friday
1,10,14,24,2017,7,31,Monday
2,7,3,10,2018,8,6,Monday
2,4,12,16,2018,4,2,Monday
4,10,11,21,2018,4,23,Monday
9,23,0,23,2017,11,25,Saturday
2,3,8,11,2018,8,12,Sunday
10,17,11,28,2017,7,28,Friday
0,5,16,21,2018,8,8,Wednseday
5,7,2,9,2018,7,25,Wednseday
1,2,16,18,2018,2,5,Monday
4,14,11,25,2018,2,23,Friday
4,7,14,21,2018,1,12,Friday
3,4,6,10,2018,4,2,Monday
2,31,-8,23,2018,3,4,Sunday
1,13,3,16,2018,5,22,Tuesday
3,13,10,23,2017,8,22,Tuesday
3,4,8,12,2018,4,14,Saturday
4,9,7,16,2018,2,10,Saturday
0,8,21,29,2018,6,13,Wednseday
2,13,10,23,2018,4,25,Wednseday
1,14,6,20,2018,8,9,Thursday
1,2,19,21,2017,8,21,Monday
6,10,10,20,2017,10,10,Tuesday
3,6,13,19,2018,5,11,Friday
3,10,15,25,2018,1,13,Saturday
2,43,-12,31,2017,7,16,Sunday
1,7,15,22,2017,5,31,Wednseday
3,9,16,25,2018,2,12,Monday
1,4,8,12,2018,3,1,Thursday
0,9,18,27,2017,11,24,Friday
4,21,14,35,2017,5,29,Monday
2,23,2,25,2017,11,25,Saturday
1,8,9,17,2018,6,11,Monday
0,32,3,35,2018,3,2,Friday
3,20,3,23,2017,11,25,Saturday
3,5,18,23,2017,6,3,Saturday
0,7,11,18,2017,6,19,Monday
1,29,-12,17,2018,3,6,Tuesday
5,6,3,9,2018,8,4,Saturday
0,1,14,15,2018,6,19,Tuesday
1,8,17,25,2017,3,9,Thursday
4,8,17,25,2018,1,4,Thursday
15,22,12,34,2018,3,21,Wednseday
9,15,17,32,2018,7,15,Sunday
2,15,22,37,2018,6,6,Wednseday
5,11,22,33,2017,5,4,Thursday
6,15,6,21,2018,8,10,Friday
1,15,-3,12,2017,10,29,Sunday
1,8,11,19,2018,3,28,Wednseday
4,12,15,27,2018,7,27,Friday
13,27,12,39,2017,12,23,Saturday
3,10,10,20,2018,7,21,Saturday
1,4,14,18,2018,6,7,Thursday
1,4,26,30,2018,4,8,Sunday
2,3,11,14,2017,7,4,Tuesday
4,21,17,38,2017,12,25,Monday
4,6,11,17,2018,1,7,Sunday
6,13,32,45,2018,8,17,Friday
2,9,23,32,2017,1,30,Monday
1,21,12,33,2018,2,1,Thursday
0,1,12,13,2018,3,28,Wednseday
8,15,6,21,2017,11,2,Thursday
1,34,-7,27,2018,3,6,Tuesday
2,12,13,25,2017,11,25,Saturday
2,4,17,21,2018,7,9,Monday
2,7,9,16,2017,9,18,Monday
1,20,4,24,2018,2,13,Tuesday
16,17,-2,15,2018,1,15,Monday
7,16,30,46,2018,4,21,Saturday
1,9,14,23,2017,8,21,Monday
1,6,15,21,2018,2,13,Tuesday
2,6,20,26,2017,5,7,Sunday
14,21,3,24,2017,10,6,Friday
1,19,9,28,2017,2,23,Thursday
6,29,0,29,2018,3,6,Tuesday
10,19,7,26,2017,12,8,Friday
1,11,7,18,2017,9,11,Monday
2,15,8,23,2017,10,25,Wednseday
2,9,17,26,2017,7,2,Sunday
3,10,6,16,2017,10,31,Tuesday
3,7,11,18,2018,5,14,Monday
2,9,55,64,2017,10,25,Wednseday
2,7,7,14,2017,6,14,Wednseday
2,11,16,27,2017,9,2,Saturday
2,13,21,34,2018,4,3,Tuesday
1,10,11,21,2017,11,28,Tuesday
2,4,11,15,2018,4,22,Sunday
1,8,21,29,2018,6,18,Monday
0,5,20,25,2017,9,21,Thursday
2,16,10,26,2018,1,13,Saturday
3,30,-6,24,2018,3,12,Monday
4,17,17,34,2017,7,22,Saturday
1,17,13,30,2017,2,12,Sunday
7,22,14,36,2017,4,12,Wednseday
1,2,14,16,2018,1,30,Tuesday
5,19,8,27,2018,2,3,Saturday
2,10,22,32,2018,1,15,Monday
4,11,16,27,2018,3,30,Friday
0,7,15,22,2017,7,12,Wednseday
1,4,10,14,2018,2,22,Thursday
1,60,-28,32,2018,3,12,Monday
4,8,14,22,2018,6,25,Monday
1,5,5,10,2018,8,12,Sunday
4,12,11,23,2017,4,22,Saturday
15,28,29,57,2018,1,11,Thursday
10,36,-7,29,2018,2,26,Monday
2,22,13,35,2018,2,7,Wednseday
2,7,7,14,2018,8,20,Monday
1,22,10,32,2018,1,29,Monday
1,15,8,23,2017,9,18,Monday
1,9,19,28,2018,5,8,Tuesday
6,8,12,20,2017,12,28,Thursday
32,38,-9,29,2017,2,13,Monday
3,4,5,9,2018,7,16,Monday
2,21,1,22,2018,5,16,Wednseday
2,24,-2,22,2018,2,25,Sunday
5,6,11,17,2018,1,20,Saturday
4,10,4,14,2017,8,21,Monday
5,6,7,13,2017,11,17,Friday
16,57,-13,44,2018,3,4,Sunday
6,13,30,43,2018,5,2,Wednseday
4,18,14,32,2018,3,24,Saturday
1,10,7,17,2018,4,1,Sunday
4,8,19,27,2017,8,3,Thursday
2,4,2,6,2018,8,18,Saturday
0,2,17,19,2018,7,4,Wednseday
2,3,5,8,2018,7,29,Sunday
3,9,10,19,2018,8,18,Saturday
6,14,16,30,2018,1,3,Wednseday
1,8,16,24,2018,4,3,Tuesday
0,11,9,20,2017,9,14,Thursday
3,11,14,25,2017,7,21,Friday
4,6,7,13,2017,11,17,Friday
2,8,9,17,2018,3,4,Sunday
3,16,15,31,2017,5,14,Sunday
13,18,10,28,2018,5,1,Tuesday
1,16,15,31,2018,4,8,Sunday
2,15,7,22,2018,2,25,Sunday
2,20,17,37,2017,4,26,Wednseday
1,8,7,15,2017,9,26,Tuesday
3,9,7,16,2018,2,13,Tuesday
4,14,13,27,2017,11,24,Friday
2,7,15,22,2017,8,15,Tuesday
4,6,12,18,2018,7,19,Thursday
3,19,12,31,2017,12,16,Saturday
9,14,13,27,2017,8,22,Tuesday
8,17,8,25,2018,2,12,Monday
4,14,5,19,2018,4,19,Thursday
2,3,5,8,2018,7,23,Monday
2,11,15,26,2017,11,12,Sunday
4,20,14,34,2017,4,29,Saturday
1,15,18,33,2017,5,17,Wednseday
3,13,17,30,2017,6,6,Tuesday
1,35,-4,31,2018,2,26,Monday
3,9,22,31,2018,2,5,Monday
12,38,-6,32,2017,12,8,Friday
5,20,0,20,2018,2,21,Wednseday
1,7,33,40,2018,7,26,Thursday
3,11,20,31,2017,12,16,Saturday
2,20,0,20,2017,8,30,Wednseday
2,6,10,16,2018,4,4,Wednseday
3,6,9,15,2017,9,26,Tuesday
0,10,18,28,2017,12,1,Friday
1,8,21,29,2017,6,19,Monday
0,26,23,49,2018,6,6,Wednseday
1,9,12,21,2018,7,18,Wednseday
2,17,15,32,2017,12,9,Saturday
14,30,18,48,2018,3,6,Tuesday
2,7,16,23,2017,11,14,Tuesday
2,15,19,34,2018,2,1,Thursday
2,8,16,24,2017,8,28,Monday
2,3,2,5,2018,8,12,Sunday
2,17,19,36,2018,6,12,Tuesday
2,14,5,19,2018,3,21,Wednseday
1,6,8,14,2018,5,8,Tuesday
3,7,14,21,2017,11,24,Friday
2,4,32,36,2018,5,28,Monday
9,14,-2,12,2017,9,16,Saturday
3,7,15,22,2017,5,1,Monday
5,14,21,35,2017,6,8,Thursday
3,4,15,19,2018,4,20,Friday
1,13,8,21,2017,11,7,Tuesday
2,3,8,11,2018,8,6,Monday
1,12,8,20,2017,5,18,Thursday
5,6,0,6,2018,8,17,Friday
1,4,9,13,2018,3,22,Thursday
2,7,29,36,2017,1,30,Monday
1,11,17,28,2018,4,2,Monday
2,10,13,23,2018,4,2,Monday
1,9,22,31,2018,5,1,Tuesday
2,3,17,20,2018,5,1,Tuesday
4,25,-5,20,2017,11,23,Thursday
4,14,7,21,2017,11,24,Friday
4,5,6,11,2018,4,8,Sunday
1,6,14,20,2018,5,22,Tuesday
0,13,10,23,2018,2,27,Tuesday
1,12,9,21,2018,1,18,Thursday
5,13,17,30,2017,6,17,Saturday
0,20,8,28,2018,7,11,Wednseday
6,7,9,16,2018,4,18,Wednseday
1,7,15,22,2017,8,15,Tuesday
5,11,10,21,2017,8,24,Thursday
4,11,4,15,2017,11,12,Sunday
1,3,21,24,2018,6,24,Sunday
1,15,2,17,2018,5,22,Tuesday
2,7,9,16,2018,2,28,Wednseday
7,13,14,27,2017,8,15,Tuesday
3,7,9,16,2018,7,17,Tuesday
1,9,19,28,2017,4,6,Thursday
3,9,7,16,2018,3,13,Tuesday
3,16,21,37,2017,10,2,Monday
7,18,38,56,2018,6,1,Friday
5,13,11,24,2017,5,19,Friday
0,5,10,15,2018,8,13,Monday
1,10,13,23,2018,4,24,Tuesday
3,19,16,35,2018,2,2,Friday
3,6,17,23,2017,8,26,Saturday
3,9,15,24,2017,4,22,Saturday
1,14,14,28,2017,7,10,Monday
1,8,14,22,2017,7,11,Tuesday
2,13,15,28,2017,11,29,Wednseday
31,36,-6,30,2018,7,22,Sunday
0,20,13,33,2017,12,28,Thursday
1,4,10,14,2018,4,26,Thursday
1,20,7,27,2017,11,23,Thursday
0,3,22,25,2018,6,18,Monday
1,17,5,22,2018,5,22,Tuesday
3,6,9,15,2018,4,4,Wednseday
4,12,19,31,2017,5,7,Sunday
1,6,16,22,2017,10,17,Tuesday
5,26,2,28,2018,1,10,Wednseday
1,8,11,19,2017,3,8,Wednseday
3,43,-9,34,2018,5,11,Friday
2,10,29,39,2017,2,4,Saturday
5,11,14,25,2018,1,13,Saturday
1,15,10,25,2017,2,23,Thursday
3,11,2,13,2017,11,3,Friday
2,12,24,36,2018,6,6,Wednseday
3,7,19,26,2018,6,22,Friday
3,9,15,24,2017,4,29,Saturday
1,7,22,29,2018,7,19,Thursday
1,13,9,22,2017,9,5,Tuesday
1,7,13,20,2017,4,19,Wednseday
2,7,24,31,2017,5,22,Monday
2,3,13,16,2018,1,8,Monday
3,6,47,53,2018,5,26,Saturday
1,2,30,32,2018,5,6,Sunday
1,9,11,20,2017,9,19,Tuesday
3,11,13,24,2017,7,7,Friday
1,2,13,15,2018,6,20,Wednseday
6,25,2,27,2017,10,7,Saturday
4,36,-10,26,2017,12,8,Friday
3,13,14,27,2017,9,22,Friday
0,4,29,33,2018,7,20,Friday
3,9,-1,8,2018,8,6,Monday
1,7,22,29,2017,10,18,Wednseday
2,17,12,29,2018,2,18,Sunday
1,20,7,27,2017,11,8,Wednseday
3,6,11,17,2018,5,11,Friday
1,8,25,33,2018,6,10,Sunday
7,12,7,19,2018,5,9,Wednseday
2,16,8,24,2017,11,27,Monday
14,18,8,26,2017,4,28,Friday
1,7,13,20,2017,11,28,Tuesday
0,6,14,20,2018,2,22,Thursday
1,6,5,11,2018,8,23,Thursday
1,8,16,24,2017,6,11,Sunday
4,34,-8,26,2018,3,23,Friday
0,1,13,14,2018,6,28,Thursday
2,2,17,19,2017,8,13,Sunday
0,16,19,35,2017,3,22,Wednseday
9,18,-8,10,2018,5,15,Tuesday
1,27,2,29,2017,9,17,Sunday
1,6,28,34,2018,5,1,Tuesday
3,8,20,28,2018,2,12,Monday
2,3,10,13,2017,7,15,Saturday
5,8,32,40,2017,7,7,Friday
3,4,10,14,2017,6,23,Friday
1,10,21,31,2017,12,10,Sunday
0,7,14,21,2017,3,22,Wednseday
1,3,10,13,2018,8,7,Tuesday
6,13,14,27,2018,1,24,Wednseday
1,2,6,8,2018,7,10,Tuesday
2,13,18,31,2018,4,17,Tuesday
2,10,22,32,2017,12,16,Saturday
5,16,10,26,2018,3,21,Wednseday
4,7,15,22,2017,4,13,Thursday
1,14,14,28,2017,9,5,Tuesday
2,6,5,11,2018,8,11,Saturday
5,11,8,19,2017,3,16,Thursday
1,2,17,19,2018,6,24,Sunday
2,6,10,16,2018,5,12,Saturday
0,3,11,14,2018,7,24,Tuesday
0,17,12,29,2018,3,6,Tuesday
3,22,7,29,2017,11,22,Wednseday
4,12,13,25,2017,11,17,Friday
4,14,15,29,2018,4,16,Monday
4,6,8,14,2018,5,4,Friday
4,7,17,24,2018,6,4,Monday
0,2,10,12,2018,6,14,Thursday
1,20,12,32,2018,1,14,Sunday
4,24,10,34,2018,3,17,Saturday
3,7,31,38,2017,3,17,Friday
1,12,0,12,2018,3,14,Wednseday
0,5,7,12,2018,3,2,Friday
1,16,13,29,2017,12,20,Wednseday
13,23,1,24,2017,10,10,Tuesday
4,8,12,20,2017,6,29,Thursday
3,17,6,23,2018,3,12,Monday
0,26,3,29,2018,2,22,Thursday
2,7,19,26,2017,7,26,Wednseday
1,5,15,20,2017,3,8,Wednseday
2,8,14,22,2017,7,4,Tuesday
1,7,14,21,2018,8,23,Thursday
1,28,-9,19,2018,4,4,Wednseday
1,27,7,34,2017,11,29,Wednseday
1,5,4,9,2018,8,13,Monday
4,6,21,27,2017,2,11,Saturday
1,9,21,30,2017,5,31,Wednseday
2,12,15,27,2018,1,13,Saturday
1,6,20,26,2017,4,6,Thursday
2,39,-7,32,2018,3,18,Sunday
7,8,25,33,2018,8,9,Thursday
0,14,13,27,2018,3,21,Wednseday
2,3,16,19,2017,11,5,Sunday
1,15,16,31,2017,9,25,Monday
5,11,15,26,2017,9,1,Friday
3,4,5,9,2018,8,18,Saturday
1,9,25,34,2017,2,22,Wednseday
1,2,15,17,2018,4,17,Tuesday
2,16,20,36,2018,2,4,Sunday
6,17,8,25,2017,11,11,Saturday
3,10,29,39,2018,5,26,Saturday
0,35,-13,22,2018,6,11,Monday
3,5,8,13,2017,8,18,Friday
3,11,25,36,2018,1,14,Sunday
4,11,26,37,2018,1,20,Saturday
1,5,11,16,2018,7,18,Wednseday
0,3,6,9,2018,8,6,Monday
3,13,4,17,2018,3,20,Tuesday
4,13,18,31,2017,9,29,Friday
3,4,10,14,2018,5,18,Friday
5,7,2,9,2018,8,8,Wednseday
3,6,21,27,2017,2,18,Saturday
1,2,13,15,2017,6,4,Sunday
1,14,14,28,2017,11,22,Wednseday
2,10,2,12,2018,8,18,Saturday
2,8,11,19,2018,5,6,Sunday
3,9,14,23,2018,5,5,Saturday
1,16,5,21,2018,5,16,Wednseday
9,14,30,44,2018,6,6,Wednseday
7,22,4,26,2018,1,25,Thursday
3,14,2,16,2018,2,6,Tuesday
3,9,6,15,2017,9,18,Monday
3,4,13,17,2018,5,4,Friday
0,18,3,21,2018,3,8,Thursday
21,22,-6,16,2018,4,18,Wednseday
3,17,0,17,2018,4,1,Sunday
1,2,11,13,2017,6,21,Wednseday
5,14,23,37,2018,5,23,Wednseday
6,29,-4,25,2018,3,4,Sunday
2,4,25,29,2018,6,4,Monday
1,2,8,10,2017,9,18,Monday
4,11,10,21,2017,6,1,Thursday
0,3,26,29,2018,8,13,Monday
1,6,19,25,2017,10,19,Thursday
1,15,10,25,2017,9,14,Thursday
9,22,10,32,2017,5,1,Monday
6,13,7,20,2018,3,2,Friday
1,11,3,14,2018,8,16,Thursday
2,8,28,36,2018,6,6,Wednseday
4,7,13,20,2018,6,29,Friday
4,11,28,39,2017,2,4,Saturday
2,8,7,15,2018,7,15,Sunday
1,6,15,21,2018,2,21,Wednseday
0,4,14,18,2017,11,23,Thursday
0,12,11,23,2018,4,25,Wednseday
4,5,14,19,2017,10,5,Thursday
3,7,13,20,2017,9,1,Friday
2,10,9,19,2017,4,22,Saturday
1,11,11,22,2017,9,28,Thursday
1,7,16,23,2017,6,7,Wednseday
0,22,7,29,2017,10,25,Wednseday
3,13,19,32,2018,1,6,Saturday
0,14,5,19,2018,8,10,Friday
2,12,13,25,2018,7,1,Sunday
2,9,25,34,2018,3,20,Tuesday
2,6,13,19,2017,12,9,Saturday
2,5,14,19,2018,6,24,Sunday
4,7,20,27,2017,12,14,Thursday
8,12,14,26,2017,12,27,Wednseday
1,15,16,31,2018,6,10,Sunday
10,18,11,29,2017,6,19,Monday
8,21,8,29,2018,5,1,Tuesday
5,10,14,24,2018,2,12,Monday
3,11,14,25,2017,3,18,Saturday
1,11,9,20,2018,3,22,Thursday
1,11,15,26,2017,6,1,Thursday
6,36,4,40,2017,10,12,Thursday
5,10,16,26,2018,1,20,Saturday
2,10,15,25,2017,7,8,Saturday
1,7,33,40,2018,4,26,Thursday
4,10,13,23,2018,2,18,Sunday
1,7,25,32,2018,6,14,Thursday
39,43,13,56,2017,12,19,Tuesday
2,6,14,20,2018,2,22,Thursday
1,31,-3,28,2018,3,7,Wednseday
1,8,14,22,2017,11,5,Sunday
1,7,34,41,2018,8,21,Tuesday
1,12,7,19,2018,3,28,Wednseday
3,5,9,14,2018,5,4,Friday
3,11,22,33,2017,4,7,Friday
0,14,21,35,2017,8,15,Tuesday
25,29,42,71,2017,4,27,Thursday
2,19,9,28,2018,2,1,Thursday
3,16,8,24,2017,3,25,Saturday
2,14,19,33,2017,12,13,Wednseday
4,10,15,25,2018,8,11,Saturday
1,8,15,23,2018,2,21,Wednseday
3,22,1,23,2017,12,4,Monday
5,8,0,8,2018,8,1,Wednseday
21,22,-6,16,2018,4,18,Wednseday
2,3,13,16,2018,7,3,Tuesday
4,9,12,21,2017,3,6,Monday
1,5,28,33,2018,8,1,Wednseday
1,2,6,8,2018,7,26,Thursday
2,8,17,25,2017,12,3,Sunday
1,2,18,20,2018,5,22,Tuesday
7,17,11,28,2017,10,9,Monday
1,7,18,25,2017,6,15,Thursday
1,7,7,14,2018,8,14,Tuesday
4,14,0,14,2017,11,24,Friday
0,3,11,14,2018,7,10,Tuesday
1,11,14,25,2018,1,29,Monday
2,6,21,27,2017,9,26,Tuesday
1,15,7,22,2018,5,21,Monday
0,3,9,12,2018,3,16,Friday
3,4,8,12,2018,3,3,Saturday
1,8,17,25,2018,6,25,Monday
2,6,10,16,2018,6,27,Wednseday
3,4,10,14,2017,11,24,Friday
3,16,5,21,2017,11,27,Monday
1,9,14,23,2017,5,8,Monday
2,6,13,19,2018,4,18,Wednseday
3,6,-3,3,2018,8,7,Tuesday
9,15,0,15,2018,8,5,Sunday
1,7,12,19,2018,5,10,Thursday
3,14,4,18,2017,3,26,Sunday
3,6,18,24,2018,6,22,Friday
4,12,13,25,2017,10,12,Thursday
1,11,12,23,2018,2,26,Monday
5,10,8,18,2017,11,19,Sunday
2,11,12,23,2017,4,22,Saturday
1,11,21,32,2018,5,27,Sunday
2,6,14,20,2018,6,26,Tuesday
2,6,16,22,2017,8,22,Tuesday
21,24,-6,18,2017,11,27,Monday
1,3,14,17,2018,1,28,Sunday
1,9,8,17,2017,9,17,Sunday
5,9,12,21,2017,6,14,Wednseday
1,6,10,16,2018,8,7,Tuesday
4,25,-4,21,2018,3,15,Thursday
4,11,16,27,2018,6,7,Thursday
1,29,-9,20,2018,3,8,Thursday
1,17,-1,16,2018,5,20,Sunday
0,4,18,22,2017,11,23,Thursday
4,5,0,5,2018,8,2,Thursday
1,9,20,29,2017,2,7,Tuesday
4,6,15,21,2017,8,18,Friday
2,4,12,16,2017,10,16,Monday
2,6,4,10,2018,7,31,Tuesday
2,8,11,19,2017,10,11,Wednseday
6,9,8,17,2017,10,17,Tuesday
1,6,12,18,2018,8,23,Thursday
5,17,10,27,2017,8,19,Saturday
1,6,24,30,2018,6,5,Tuesday
0,6,16,22,2017,10,17,Tuesday
2,22,-3,19,2018,2,25,Sunday
2,17,5,22,2017,8,15,Tuesday
5,8,7,15,2017,11,12,Sunday
1,7,11,18,2018,2,26,Monday
11,29,2,31,2018,2,9,Friday
6,13,21,34,2017,4,5,Wednseday
2,23,14,37,2017,6,10,Saturday
5,10,16,26,2018,5,4,Friday
6,11,7,18,2017,8,4,Friday
1,2,13,15,2018,1,15,Monday
1,13,9,22,2018,5,22,Tuesday
1,4,7,11,2018,5,10,Thursday
1,5,14,19,2017,8,6,Sunday
6,15,9,24,2017,12,5,Tuesday
2,8,12,20,2018,8,15,Wednseday
4,10,10,20,2017,3,31,Friday
12,46,-21,25,2017,11,25,Saturday
3,19,7,26,2017,4,29,Saturday
2,7,1,8,2018,8,8,Wednseday
0,20,3,23,2017,11,28,Tuesday
2,8,24,32,2018,6,18,Monday
0,2,18,20,2018,6,26,Tuesday
1,13,14,27,2017,9,20,Wednseday
3,6,3,9,2018,7,24,Tuesday
4,17,19,36,2017,11,27,Monday
1,6,23,29,2018,4,19,Thursday
1,7,23,30,2018,1,2,Tuesday
0,12,12,24,2017,8,11,Friday
40,49,-22,27,2017,11,25,Saturday
2,138,-104,34,2017,12,2,Saturday
1,9,12,21,2018,1,16,Tuesday
5,14,13,27,2017,6,9,Friday
5,26,9,35,2017,12,22,Friday
1,7,19,26,2017,10,19,Thursday
1,8,35,43,2017,2,7,Tuesday
3,25,-2,23,2018,3,17,Saturday
3,16,6,22,2017,4,23,Sunday
12,24,9,33,2018,2,28,Wednseday
1,9,11,20,2018,8,15,Wednseday
12,23,9,32,2017,7,30,Sunday
3,8,14,22,2018,1,29,Monday
1,10,-2,8,2018,5,9,Wednseday
5,20,12,32,2017,12,15,Friday
9,15,2,17,2017,11,13,Monday
1,6,7,13,2018,8,14,Tuesday
1,8,16,24,2018,1,22,Monday
4,7,13,20,2017,5,19,Friday
3,7,31,38,2017,8,18,Friday
2,10,26,36,2018,5,1,Tuesday
4,7,13,20,2017,12,15,Friday
2,16,14,30,2017,3,5,Sunday
4,20,8,28,2018,5,10,Thursday
2,9,20,29,2018,7,29,Sunday
1,7,15,22,2018,1,17,Wednseday
2,12,18,30,2018,7,14,Saturday
2,9,28,37,2018,7,14,Saturday
1,8,9,17,2017,10,17,Tuesday
2,13,14,27,2018,1,20,Saturday
1,6,22,28,2017,5,19,Friday
3,4,9,13,2017,10,27,Friday
1,4,10,14,2018,3,22,Thursday
1,18,17,35,2017,8,17,Thursday
4,9,13,22,2017,10,15,Sunday
2,4,17,21,2018,7,23,Monday
1,4,26,30,2017,12,18,Monday
1,18,10,28,2017,7,6,Thursday
14,20,19,39,2018,3,29,Thursday
2,7,22,29,2018,4,5,Thursday
5,26,-5,21,2018,3,7,Wednseday
0,5,17,22,2017,9,14,Thursday
1,9,15,24,2018,7,1,Sunday
5,27,7,34,2017,12,7,Thursday
2,8,6,14,2018,7,24,Tuesday
2,6,17,23,2017,6,17,Saturday
1,13,15,28,2018,3,22,Thursday
14,21,12,33,2018,6,22,Friday
5,11,8,19,2018,3,23,Friday
4,6,7,13,2018,7,6,Friday
3,19,5,24,2017,7,15,Saturday
1,8,14,22,2017,5,22,Monday
1,5,7,12,2017,8,13,Sunday
4,12,7,19,2018,8,2,Thursday
6,20,12,32,2018,4,14,Saturday
1,9,19,28,2017,4,11,Tuesday
6,20,7,27,2017,12,6,Wednseday
0,1,7,8,2018,7,12,Thursday
6,13,8,21,2017,10,10,Tuesday
2,7,16,23,2018,1,8,Monday
1,16,15,31,2017,4,16,Sunday
6,15,11,26,2017,7,19,Wednseday
3,10,8,18,2017,11,27,Monday
5,24,-4,20,2017,11,24,Friday
1,2,8,10,2018,6,10,Sunday
6,6,8,14,2018,2,21,Wednseday
2,16,11,27,2018,6,26,Tuesday
3,11,15,26,2017,6,16,Friday
2,5,12,17,2018,8,11,Saturday
20,29,8,37,2018,4,4,Wednseday
3,14,17,31,2018,1,6,Saturday
13,20,10,30,2017,5,9,Tuesday
2,21,6,27,2017,12,13,Wednseday
1,41,-13,28,2018,3,20,Tuesday
2,3,5,8,2018,5,8,Tuesday
3,6,5,11,2017,5,13,Saturday
1,6,9,15,2018,7,5,Thursday
5,6,13,19,2017,11,29,Wednseday
1,10,13,23,2018,7,1,Sunday
2,5,19,24,2017,7,29,Saturday
5,7,7,14,2018,2,9,Friday
2,11,25,36,2018,6,5,Tuesday
1,11,18,29,2017,10,3,Tuesday
6,12,18,30,2018,2,21,Wednseday
2,21,3,24,2018,4,14,Saturday
2,23,1,24,2018,2,25,Sunday
10,40,-12,28,2018,3,19,Monday
5,46,-20,26,2018,1,20,Saturday
1,14,16,30,2018,2,19,Monday
1,7,21,28,2018,6,20,Wednseday
4,7,12,19,2018,7,6,Friday
1,11,12,23,2018,4,3,Tuesday
16,23,20,43,2018,7,16,Monday
6,15,13,28,2017,12,12,Tuesday
2,5,26,31,2017,11,5,Sunday
2,16,7,23,2017,9,17,Sunday
2,3,16,19,2017,12,9,Saturday
1,12,15,27,2017,11,22,Wednseday
3,17,8,25,2018,3,25,Sunday
3,13,14,27,2017,7,18,Tuesday
1,9,9,18,2017,7,10,Monday
2,32,-12,20,2018,2,17,Saturday
7,13,7,20,2017,11,14,Tuesday
2,4,7,11,2018,6,10,Sunday
2,6,10,16,2017,6,10,Saturday
4,6,11,17,2017,12,3,Sunday
3,13,13,26,2017,7,28,Friday
1,6,8,14,2018,7,24,Tuesday
1,33,-4,29,2018,1,25,Thursday
4,32,-5,27,2018,3,9,Friday
1,6,21,27,2017,7,11,Tuesday
4,5,21,26,2018,1,28,Sunday
3,7,17,24,2017,3,17,Friday
2,6,11,17,2018,6,12,Tuesday
1,11,3,14,2018,2,9,Friday
4,18,9,27,2017,10,5,Thursday
0,4,23,27,2018,2,7,Wednseday
1,2,23,25,2017,2,13,Monday
2,7,17,24,2017,12,19,Tuesday
8,19,12,31,2018,7,8,Sunday
4,10,16,26,2018,6,29,Friday
1,4,33,37,2018,6,18,Monday
1,14,21,35,2018,2,1,Thursday
1,3,21,24,2017,8,21,Monday
6,21,10,31,2018,3,23,Friday
4,16,27,43,2017,1,22,Sunday
3,9,7,16,2018,3,5,Monday
1,2,6,8,2018,5,16,Wednseday
0,6,37,43,2018,6,6,Wednseday
4,10,2,12,2018,8,3,Friday
1,2,8,10,2018,6,19,Tuesday
2,12,27,39,2017,12,3,Sunday
1,6,14,20,2017,3,8,Wednseday
3,7,10,17,2018,8,3,Friday
1,5,27,32,2018,5,6,Sunday
6,19,15,34,2017,11,30,Thursday
3,13,22,35,2017,12,1,Friday
0,5,15,20,2017,12,14,Thursday
1,7,14,21,2018,1,18,Thursday
3,8,16,24,2018,6,10,Sunday
8,20,3,23,2018,1,17,Wednseday
3,23,0,23,2018,3,6,Tuesday
1,17,3,20,2018,5,8,Tuesday
4,8,15,23,2018,4,22,Sunday
4,5,12,17,2017,8,25,Friday
4,13,7,20,2017,5,12,Friday
2,8,25,33,2017,2,15,Wednseday
9,27,11,38,2017,10,7,Saturday
3,17,21,38,2017,8,11,Friday
1,21,7,28,2017,12,21,Thursday
5,22,18,40,2017,12,22,Friday
2,8,6,14,2018,2,19,Monday
7,13,7,20,2018,2,28,Wednseday
1,4,21,25,2017,7,17,Monday
1,30,0,30,2018,2,4,Sunday
2,10,27,37,2018,8,20,Monday
3,11,9,20,2018,3,2,Friday
4,14,20,34,2018,2,2,Friday
1,13,9,22,2018,2,13,Tuesday
4,24,1,25,2018,3,4,Sunday
2,16,10,26,2017,11,8,Wednseday
5,11,7,18,2018,4,27,Friday
5,63,-27,36,2018,4,5,Thursday
1,5,17,22,2018,6,28,Thursday
14,18,9,27,2017,11,24,Friday
2,14,5,19,2018,3,15,Thursday
14,19,22,41,2018,3,7,Wednseday
1,5,28,33,2018,8,23,Thursday
2,24,14,38,2017,12,9,Saturday
1,9,7,16,2018,3,6,Tuesday
8,9,16,25,2018,6,17,Sunday
2,23,10,33,2017,3,26,Sunday
2,10,32,42,2018,4,23,Monday
1,5,9,14,2017,11,8,Wednseday
5,10,4,14,2018,2,9,Friday
0,6,15,21,2018,1,18,Thursday
5,9,25,34,2017,3,15,Wednseday
0,9,15,24,2017,7,17,Monday
4,8,25,33,2018,7,19,Thursday
3,23,6,29,2017,2,14,Tuesday
3,9,22,31,2017,5,27,Saturday
4,19,16,35,2017,5,5,Friday
1,33,-15,18,2017,10,22,Sunday
3,11,2,13,2018,8,10,Friday
5,12,14,26,2017,7,14,Friday
1,7,23,30,2017,10,9,Monday
1,5,16,21,2018,2,28,Wednseday
2,10,4,14,2018,8,6,Monday
2,29,-5,24,2018,2,18,Sunday
2,15,9,24,2017,12,3,Sunday
1,15,7,22,2017,3,28,Tuesday
4,5,14,19,2018,1,11,Thursday
1,2,13,15,2018,5,1,Tuesday
5,17,8,25,2018,3,3,Saturday
27,38,6,44,2017,10,10,Tuesday
2,19,6,25,2017,7,29,Saturday
5,23,14,37,2018,1,3,Wednseday
3,24,8,32,2018,3,2,Friday
14,27,-4,23,2017,12,6,Wednseday
5,9,2,11,2018,8,4,Saturday
1,2,9,11,2018,3,26,Monday
2,11,13,24,2018,3,13,Tuesday
6,23,11,34,2017,9,28,Thursday
1,6,19,25,2018,4,29,Sunday
5,13,24,37,2017,2,18,Saturday
3,11,10,21,2017,10,16,Monday
1,16,22,38,2018,3,20,Tuesday
5,8,4,12,2018,3,7,Wednseday
0,14,14,28,2018,5,15,Tuesday
2,18,10,28,2018,4,23,Monday
1,20,2,22,2017,4,17,Monday
4,11,14,25,2018,6,8,Friday
2,9,21,30,2018,4,30,Monday
7,12,8,20,2018,5,4,Friday
4,6,19,25,2017,12,1,Friday
2,12,35,47,2017,2,8,Wednseday
4,14,5,19,2018,8,3,Friday
1,6,18,24,2017,6,27,Tuesday
1,18,12,30,2017,7,17,Monday
1,8,27,35,2018,3,26,Monday
2,5,19,24,2018,4,15,Sunday
2,12,14,26,2018,5,9,Wednseday
6,15,14,29,2018,4,12,Thursday
1,16,7,23,2017,6,7,Wednseday
0,12,10,22,2018,2,14,Wednseday
3,6,19,25,2017,8,25,Friday
1,13,9,22,2017,7,4,Tuesday
3,7,13,20,2017,9,16,Saturday
2,21,12,33,2018,1,31,Wednseday
4,11,17,28,2018,1,19,Friday
3,10,17,27,2017,1,20,Friday
1,4,12,16,2018,7,22,Sunday
5,27,-5,22,2018,2,21,Wednseday
0,2,11,13,2017,6,20,Tuesday
2,7,9,16,2018,5,7,Monday
2,4,12,16,2017,11,29,Wednseday
2,6,14,20,2018,5,16,Wednseday
3,22,0,22,2018,5,14,Monday
7,8,1,9,2018,8,21,Tuesday
2,15,13,28,2018,8,15,Wednseday
1,9,7,16,2018,4,3,Tuesday
4,11,21,32,2017,12,29,Friday
1,11,13,24,2017,9,4,Monday
1,4,26,30,2017,3,26,Sunday
2,4,20,24,2018,6,24,Sunday
2,17,4,21,2018,3,5,Monday
3,19,7,26,2018,5,18,Friday
2,5,8,13,2018,3,21,Wednseday
8,20,3,23,2018,1,30,Tuesday
4,15,10,25,2017,7,7,Friday
8,15,17,32,2017,10,9,Monday
13,22,7,29,2018,2,1,Thursday
1,3,13,16,2018,7,17,Tuesday
1,9,15,24,2018,7,16,Monday
2,5,4,9,2018,8,15,Wednseday
3,33,0,33,2018,1,27,Saturday
1,8,12,20,2017,8,10,Thursday
1,7,4,11,2018,3,26,Monday
2,13,16,29,2018,4,24,Tuesday
1,18,12,30,2017,12,17,Sunday
1,8,14,22,2017,8,2,Wednseday
3,4,8,12,2018,3,31,Saturday
5,20,7,27,2017,11,24,Friday
0,6,36,42,2018,8,24,Friday
1,6,19,25,2017,7,27,Thursday
5,13,13,26,2018,3,15,Thursday
3,9,3,12,2018,8,5,Sunday
5,21,7,28,2018,1,24,Wednseday
3,6,21,27,2017,8,12,Saturday
1,8,22,30,2018,6,20,Wednseday
2,15,32,47,2018,1,31,Wednseday
4,9,22,31,2017,11,12,Sunday
3,6,11,17,2017,12,11,Monday
4,9,16,25,2017,11,24,Friday
4,11,15,26,2017,9,28,Thursday
3,10,8,18,2017,12,10,Sunday
4,15,37,52,2017,10,2,Monday
0,6,19,25,2018,7,20,Friday
5,12,12,24,2017,11,17,Friday
1,9,24,33,2018,6,13,Wednseday
4,10,16,26,2017,12,24,Sunday
6,14,21,35,2018,1,5,Friday
2,6,14,20,2017,3,29,Wednseday
1,11,16,27,2018,2,8,Thursday
2,8,15,23,2018,8,12,Sunday
12,14,-1,13,2018,8,2,Thursday
4,5,14,19,2018,4,19,Thursday
2,7,9,16,2018,1,3,Wednseday
4,12,19,31,2018,4,29,Sunday
2,7,13,20,2017,12,13,Wednseday
3,7,18,25,2017,8,11,Friday
5,7,33,40,2017,1,20,Friday
4,8,25,33,2018,7,6,Friday
9,18,10,28,2017,12,5,Tuesday
5,10,10,20,2017,6,24,Saturday
2,6,10,16,2017,12,4,Monday
3,4,2,6,2018,8,4,Saturday
1,2,14,16,2018,4,3,Tuesday
6,25,8,33,2018,1,5,Friday
3,12,15,27,2018,8,10,Friday
2,11,19,30,2018,5,9,Wednseday
5,7,19,26,2018,5,30,Wednseday
1,8,10,18,2018,8,16,Thursday
2,11,17,28,2017,5,22,Monday
9,17,5,22,2017,3,19,Sunday
2,2,12,14,2018,2,19,Monday
3,21,7,28,2017,9,12,Tuesday
1,21,4,25,2017,12,18,Monday
3,14,10,24,2017,6,27,Tuesday
4,17,9,26,2018,5,18,Friday
32,46,-10,36,2018,1,29,Monday
4,15,13,28,2017,5,11,Thursday
2,5,20,25,2017,5,27,Saturday
6,13,28,41,2017,10,18,Wednseday
2,13,20,33,2018,6,23,Saturday
1,3,14,17,2018,8,13,Monday
1,19,7,26,2018,1,10,Wednseday
1,7,6,13,2018,8,15,Wednseday
5,10,9,19,2017,9,16,Saturday
4,10,15,25,2018,7,22,Sunday
4,18,19,37,2017,8,26,Saturday
0,4,14,18,2018,6,29,Friday
1,7,15,22,2017,8,1,Tuesday
0,7,2,9,2018,8,8,Wednseday
1,12,24,36,2017,5,21,Sunday
8,16,15,31,2018,7,9,Monday
2,17,12,29,2018,2,25,Sunday
2,7,16,23,2017,6,6,Tuesday
1,17,7,24,2017,12,4,Monday
2,8,17,25,2018,6,17,Sunday
2,11,12,23,2017,11,25,Saturday
1,2,8,10,2018,6,18,Monday
5,22,10,32,2018,5,17,Thursday
0,5,16,21,2018,1,12,Friday
1,4,17,21,2017,8,1,Tuesday
4,5,12,17,2018,7,1,Sunday
5,12,7,19,2018,7,18,Wednseday
1,11,15,26,2017,5,28,Sunday
3,5,11,16,2018,3,24,Saturday
14,19,6,25,2017,10,6,Friday
1,6,9,15,2018,4,24,Tuesday
3,15,19,34,2018,3,23,Friday
4,15,19,34,2017,10,19,Thursday
3,13,14,27,2017,11,14,Tuesday
1,2,19,21,2018,1,9,Tuesday
1,6,17,23,2017,10,25,Wednseday
9,34,0,34,2018,5,8,Tuesday
2,3,2,5,2018,8,4,Saturday
3,6,4,10,2018,8,10,Friday
1,8,19,27,2018,4,25,Wednseday
1,7,34,41,2018,6,5,Tuesday
1,4,16,20,2017,12,14,Thursday
1,8,13,21,2017,11,9,Thursday
1,4,6,10,2018,6,25,Monday
1,20,2,22,2017,7,11,Tuesday
2,2,9,11,2017,7,24,Monday
5,7,8,15,2018,1,18,Thursday
5,9,6,15,2018,4,4,Wednseday
2,10,19,29,2018,1,16,Tuesday
1,14,2,16,2018,4,4,Wednseday
3,8,13,21,2017,10,10,Tuesday
1,7,23,30,2018,2,7,Wednseday
2,12,17,29,2018,2,13,Tuesday
2,5,11,16,2018,4,18,Wednseday
2,10,16,26,2018,2,14,Wednseday
4,10,15,25,2017,6,2,Friday
3,8,13,21,2017,9,18,Monday
4,10,21,31,2018,1,8,Monday
0,3,15,18,2017,9,15,Friday
3,4,6,10,2018,8,3,Friday
3,16,5,21,2018,1,17,Wednseday
3,16,1,17,2017,10,23,Monday
1,17,12,29,2018,5,1,Tuesday
1,7,24,31,2018,5,7,Monday
2,10,14,24,2017,11,26,Sunday
2,145,-121,24,2017,6,3,Saturday
1,2,23,25,2017,8,21,Monday
3,3,15,18,2018,2,3,Saturday
9,10,14,24,2017,9,2,Saturday
3,16,5,21,2017,8,8,Tuesday
2,12,15,27,2018,8,15,Wednseday
2,7,28,35,2017,1,26,Thursday
2,55,-23,32,2018,2,17,Saturday
5,18,19,37,2017,4,1,Saturday
8,28,5,33,2018,2,14,Wednseday
1,2,7,9,2018,8,27,Monday
3,6,20,26,2018,6,16,Saturday
4,25,0,25,2017,12,11,Monday
14,21,10,31,2018,7,31,Tuesday
8,9,14,23,2018,4,24,Tuesday
2,11,13,24,2017,11,25,Saturday
2,3,9,12,2018,7,8,Sunday
0,5,34,39,2017,1,13,Friday
2,9,20,29,2018,6,17,Sunday
1,11,19,30,2017,9,3,Sunday
1,25,4,29,2018,2,8,Thursday
3,9,30,39,2017,1,28,Saturday
3,12,22,34,2017,3,24,Friday
2,8,15,23,2018,1,3,Wednseday
2,3,11,14,2017,11,27,Monday
6,18,2,20,2017,11,16,Thursday
2,10,12,22,2017,4,23,Sunday
2,3,9,12,2017,10,22,Sunday
2,27,10,37,2017,12,12,Tuesday
2,20,7,27,2017,5,3,Wednseday
8,18,7,25,2017,12,4,Monday
6,15,12,27,2018,5,24,Thursday
1,10,12,22,2018,4,15,Sunday
3,20,18,38,2018,2,2,Friday
4,8,17,25,2018,3,15,Thursday
3,11,8,19,2018,4,13,Friday
5,10,13,23,2017,10,4,Wednseday
4,9,14,23,2017,11,18,Saturday
2,3,20,23,2017,2,6,Monday
3,23,9,32,2018,5,5,Saturday
9,12,5,17,2017,10,22,Sunday
1,3,17,20,2017,7,25,Tuesday
3,11,20,31,2017,12,16,Saturday
8,22,1,23,2017,11,14,Tuesday
2,7,14,21,2017,12,12,Tuesday
1,7,5,12,2017,9,13,Wednseday
4,35,-1,34,2017,4,28,Friday
1,8,28,36,2018,6,6,Wednseday
1,13,27,40,2018,6,27,Wednseday
3,8,11,19,2017,7,23,Sunday
5,13,14,27,2018,2,10,Saturday
2,15,8,23,2018,1,22,Monday
0,1,21,22,2018,6,19,Tuesday
2,2,13,15,2018,3,5,Monday
4,9,13,22,2017,5,1,Monday
0,1,13,14,2018,4,9,Monday
1,8,12,20,2017,2,28,Tuesday
3,23,-2,21,2018,4,2,Monday
0,1,13,14,2018,6,28,Thursday
3,9,11,20,2018,6,30,Saturday
1,4,2,6,2018,8,16,Thursday
2,4,29,33,2018,7,1,Sunday
1,23,0,23,2018,1,29,Monday
4,49,-14,35,2018,2,2,Friday
1,2,14,16,2018,4,10,Tuesday
3,8,23,31,2018,6,10,Sunday
2,14,16,30,2018,2,24,Saturday
1,18,8,26,2017,6,18,Sunday
0,10,6,16,2018,3,5,Monday
4,9,16,25,2017,3,4,Saturday
9,32,6,38,2017,12,25,Monday
0,2,12,14,2018,2,27,Tuesday
8,15,26,41,2018,6,5,Tuesday
0,14,10,24,2017,6,26,Monday
1,3,13,16,2018,2,6,Tuesday
4,10,17,27,2017,5,6,Saturday
1,14,9,23,2018,8,7,Tuesday
3,8,7,15,2017,11,28,Tuesday
2,6,18,24,2017,5,14,Sunday
2,22,4,26,2017,12,13,Wednseday
1,29,0,29,2017,11,21,Tuesday
4,12,15,27,2017,9,28,Thursday
4,10,25,35,2018,6,29,Friday
7,10,1,11,2017,5,22,Monday
5,18,6,24,2017,5,19,Friday
1,9,17,26,2017,12,13,Wednseday
4,31,0,31,2017,12,9,Saturday
6,16,8,24,2017,8,1,Tuesday
3,14,15,29,2018,2,28,Wednseday
2,8,3,11,2017,5,13,Saturday
22,26,10,36,2018,6,6,Wednseday
3,8,17,25,2017,11,24,Friday
4,10,34,44,2018,4,1,Sunday
7,11,16,27,2018,4,13,Friday
2,3,12,15,2018,2,15,Thursday
1,7,13,20,2018,7,26,Thursday
2,4,4,8,2018,5,8,Tuesday
3,10,11,21,2017,10,27,Friday
1,8,18,26,2018,8,15,Wednseday
2,8,17,25,2017,4,10,Monday
5,14,20,34,2017,8,19,Saturday
2,10,14,24,2017,7,4,Tuesday
4,18,2,20,2018,3,2,Friday
1,11,11,22,2017,5,18,Thursday
3,6,35,41,2018,1,5,Friday
6,15,6,21,2018,3,29,Thursday
0,2,33,35,2018,5,14,Monday
2,15,10,25,2018,2,4,Sunday
2,17,3,20,2018,3,31,Saturday
1,6,1,7,2018,8,2,Thursday
3,11,21,32,2017,12,15,Friday
0,13,17,30,2017,8,16,Wednseday
2,19,10,29,2018,1,3,Wednseday
3,18,4,22,2017,9,25,Monday
1,5,14,19,2018,5,9,Wednseday
1,3,24,27,2017,8,23,Wednseday
2,7,16,23,2017,8,30,Wednseday
5,9,5,14,2018,2,22,Thursday
1,18,0,18,2018,3,19,Monday
2,4,21,25,2017,8,21,Monday
2,11,41,52,2018,5,27,Sunday
4,16,6,22,2018,8,6,Monday
1,9,32,41,2018,7,3,Tuesday
4,11,10,21,2017,11,16,Thursday
3,6,25,31,2017,4,7,Friday
1,9,27,36,2017,7,3,Monday
3,10,10,20,2017,10,14,Saturday
2,14,9,23,2017,6,7,Wednseday
8,13,9,22,2017,11,29,Wednseday
2,12,11,23,2017,4,5,Wednseday
1,6,38,44,2018,8,14,Tuesday
2,8,5,13,2018,8,1,Wednseday
2,7,8,15,2018,8,22,Wednseday
2,3,7,10,2018,7,21,Saturday
3,10,8,18,2017,7,31,Monday
1,2,3,5,2018,8,1,Wednseday
17,28,-1,27,2017,12,19,Tuesday
5,11,11,22,2018,4,5,Thursday
1,6,12,18,2018,5,17,Thursday
2,4,15,19,2018,5,5,Saturday
0,2,12,14,2018,8,7,Tuesday
1,8,15,23,2018,4,9,Monday
3,4,6,10,2018,7,28,Saturday
4,7,11,18,2017,11,27,Monday
2,5,18,23,2018,5,28,Monday
6,13,3,16,2018,3,7,Wednseday
7,14,6,20,2018,6,27,Wednseday
1,6,23,29,2017,10,19,Thursday
4,8,21,29,2018,4,15,Sunday
23,26,-3,23,2018,7,22,Sunday
0,11,10,21,2018,2,23,Friday
1,14,12,26,2018,3,22,Thursday
0,3,10,13,2017,7,7,Friday
5,14,4,18,2018,2,16,Friday
12,17,-2,15,2017,9,20,Wednseday
3,14,16,30,2017,8,1,Tuesday
5,12,10,22,2017,5,10,Wednseday
3,6,7,13,2018,8,24,Friday
10,14,16,30,2017,12,5,Tuesday
2,17,19,36,2018,1,31,Wednseday
1,7,27,34,2017,12,21,Thursday
1,18,13,31,2017,7,30,Sunday
5,12,19,31,2017,12,29,Friday
2,6,17,23,2018,6,12,Tuesday
3,15,8,23,2017,11,28,Tuesday
0,9,18,27,2017,12,12,Tuesday
6,9,16,25,2018,6,9,Saturday
1,4,12,16,2018,8,26,Sunday
1,26,-2,24,2018,1,22,Monday
1,11,24,35,2018,1,22,Monday
2,7,15,22,2018,4,23,Monday
2,4,26,30,2018,7,21,Saturday
1,11,14,25,2018,4,26,Thursday
0,2,12,14,2017,11,29,Wednseday
4,12,10,22,2018,7,9,Monday
1,17,32,49,2018,6,6,Wednseday
1,6,20,26,2018,2,8,Thursday
0,7,21,28,2018,4,9,Monday
1,8,25,33,2018,6,22,Friday
8,18,38,56,2017,1,19,Thursday
2,8,10,18,2017,5,22,Monday
4,19,36,55,2018,5,17,Thursday
2,8,21,29,2018,4,8,Sunday
3,6,23,29,2018,7,1,Sunday
3,6,15,21,2018,4,27,Friday
4,6,10,16,2018,2,24,Saturday
2,17,2,19,2018,5,6,Sunday
4,13,11,24,2017,10,13,Friday
4,12,16,28,2017,12,29,Friday
5,26,30,56,2017,5,24,Wednseday
1,7,15,22,2018,7,31,Tuesday
5,7,20,27,2017,1,11,Wednseday
3,4,16,20,2018,4,20,Friday
4,8,12,20,2018,5,3,Thursday
1,3,13,16,2018,7,10,Tuesday
9,17,14,31,2017,8,14,Monday
6,16,11,27,2017,11,25,Saturday
1,10,12,22,2018,4,23,Monday
6,13,11,24,2018,4,13,Friday
4,8,24,32,2017,10,6,Friday
2,13,14,27,2018,4,25,Wednseday
4,10,10,20,2018,7,27,Friday
1,10,12,22,2017,7,4,Tuesday
1,9,13,22,2018,5,2,Wednseday
3,4,13,17,2018,4,20,Friday
1,4,11,15,2017,11,26,Sunday
7,19,28,47,2017,4,27,Thursday
4,5,12,17,2017,9,24,Sunday
3,14,15,29,2017,12,10,Sunday
1,6,15,21,2018,4,24,Tuesday
1,9,12,21,2017,3,14,Tuesday
7,11,14,25,2017,3,3,Friday
1,19,9,28,2017,10,25,Wednseday
1,6,23,29,2018,4,10,Tuesday
1,11,23,34,2017,7,6,Thursday
0,16,12,28,2017,9,12,Tuesday
5,25,6,31,2017,12,9,Saturday
2,11,16,27,2017,3,4,Saturday
0,5,18,23,2018,6,20,Wednseday
1,5,14,19,2018,3,8,Thursday
4,12,23,35,2018,6,8,Friday
2,6,16,22,2017,9,26,Tuesday
2,9,20,29,2018,4,16,Monday
4,5,9,14,2018,3,23,Friday
5,8,18,26,2017,12,28,Thursday
3,5,20,25,2017,3,31,Friday
0,6,13,19,2017,10,19,Thursday
8,19,14,33,2017,2,15,Wednseday
16,19,8,27,2018,4,14,Saturday
2,19,1,20,2018,5,17,Thursday
2,3,3,6,2018,8,21,Tuesday
4,17,14,31,2017,8,25,Friday
8,15,19,34,2018,2,14,Wednseday
3,10,22,32,2017,11,4,Saturday
1,10,19,29,2017,8,27,Sunday
1,8,21,29,2017,2,9,Thursday
5,12,8,20,2017,11,24,Friday
2,13,27,40,2018,5,23,Wednseday
4,8,8,16,2018,2,10,Saturday
4,9,14,23,2017,4,30,Sunday
4,15,7,22,2017,10,9,Monday
8,14,7,21,2017,11,13,Monday
0,3,0,3,2018,8,21,Tuesday
2,7,9,16,2017,9,13,Wednseday
2,9,16,25,2018,4,1,Sunday
1,5,21,26,2017,10,19,Thursday
6,8,7,15,2018,7,4,Wednseday
0,5,30,35,2018,5,17,Thursday
0,6,11,17,2018,7,27,Friday
3,5,10,15,2018,5,13,Sunday
2,13,7,20,2018,8,4,Saturday
1,3,18,21,2017,4,4,Tuesday
3,10,12,22,2018,7,3,Tuesday
9,19,7,26,2018,6,17,Sunday
0,15,12,27,2018,2,14,Wednseday
0,17,9,26,2017,7,7,Friday
2,6,25,31,2017,12,16,Saturday
3,7,3,10,2018,3,5,Monday
2,19,5,24,2017,11,19,Sunday
3,11,13,24,2018,3,16,Friday
1,4,9,13,2018,3,22,Thursday
1,3,17,20,2017,12,14,Thursday
4,13,28,41,2017,1,20,Friday
1,5,9,14,2018,5,16,Wednseday
3,7,2,9,2018,7,30,Monday
5,22,0,22,2018,2,28,Wednseday
2,9,18,27,2018,5,1,Tuesday
1,17,21,38,2018,2,19,Monday
5,91,-52,39,2018,1,25,Thursday
3,10,17,27,2018,4,27,Friday
1,6,25,31,2018,8,14,Tuesday
8,18,0,18,2018,4,26,Thursday
1,8,36,44,2018,6,6,Wednseday
2,26,-7,19,2018,3,10,Saturday
1,6,9,15,2018,8,2,Thursday
1,6,15,21,2017,4,5,Wednseday
4,16,8,24,2018,2,18,Sunday
1,5,15,20,2017,5,17,Wednseday
2,4,6,10,2018,7,28,Saturday
6,21,5,26,2017,12,8,Friday
1,7,19,26,2018,6,7,Thursday
4,22,23,45,2018,6,8,Friday
2,5,6,11,2018,3,4,Sunday
2,9,20,29,2017,7,30,Sunday
1,8,35,43,2017,1,17,Tuesday
3,10,7,17,2018,4,8,Sunday
2,5,12,17,2018,3,26,Monday
2,17,10,27,2018,1,13,Saturday
7,32,-4,28,2017,11,24,Friday
5,14,20,34,2017,11,11,Saturday
1,7,25,32,2017,3,23,Thursday
2,8,6,14,2018,7,18,Wednseday
3,12,9,21,2017,11,24,Friday
5,14,14,28,2018,7,27,Friday
9,20,6,26,2017,3,29,Wednseday
1,2,11,13,2017,5,30,Tuesday
5,24,2,26,2017,11,3,Friday
3,10,14,24,2017,9,1,Friday
4,11,21,32,2017,1,14,Saturday
3,33,0,33,2017,4,16,Sunday
2,7,9,16,2017,9,11,Monday
1,13,10,23,2017,11,13,Monday
8,11,16,27,2018,3,16,Friday
1,2,11,13,2018,5,1,Tuesday
4,12,21,33,2018,1,19,Friday
7,13,8,21,2018,5,2,Wednseday
0,13,20,33,2017,2,16,Thursday
5,14,6,20,2018,4,5,Thursday
4,20,5,25,2017,11,23,Thursday
2,4,17,21,2018,5,21,Monday
2,3,10,13,2017,7,8,Saturday
2,7,14,21,2017,3,1,Wednseday
3,4,0,4,2018,8,20,Monday
3,10,18,28,2017,12,1,Friday
2,7,9,16,2018,5,7,Monday
4,9,14,23,2017,3,11,Saturday
5,14,30,44,2018,6,6,Wednseday
4,7,15,22,2017,10,19,Thursday
2,25,6,31,2018,4,8,Sunday
2,9,27,36,2018,1,14,Sunday
0,1,13,14,2018,6,28,Thursday
1,2,21,23,2017,10,1,Sunday
0,2,14,16,2018,2,7,Wednseday
8,21,4,25,2018,4,26,Thursday
1,7,13,20,2017,4,19,Wednseday
8,13,9,22,2017,7,11,Tuesday
3,8,2,10,2018,5,7,Monday
4,14,15,29,2018,1,25,Thursday
2,9,12,21,2017,3,20,Monday
1,20,5,25,2017,9,14,Thursday
1,14,2,16,2017,8,15,Tuesday
1,14,14,28,2017,12,27,Wednseday
2,11,13,24,2017,4,16,Sunday
3,13,11,24,2017,7,28,Friday
1,22,-5,17,2018,3,26,Monday
2,9,18,27,2017,8,16,Wednseday
5,13,9,22,2017,4,19,Wednseday
2,6,11,17,2018,5,8,Tuesday
3,16,15,31,2017,7,10,Monday
1,26,8,34,2018,3,15,Thursday
1,20,1,21,2017,11,28,Tuesday
1,14,39,53,2017,12,25,Monday
1,4,14,18,2018,7,22,Sunday
2,14,18,32,2017,12,3,Sunday
2,16,14,30,2018,1,20,Saturday
3,17,9,26,2018,3,24,Saturday
2,6,13,19,2017,3,15,Wednseday
3,7,17,24,2017,7,7,Friday
1,3,28,31,2018,1,30,Tuesday
1,6,16,22,2018,6,21,Thursday
3,4,8,12,2017,9,15,Friday
2,6,3,9,2018,8,8,Wednseday
2,8,14,22,2018,3,11,Sunday
2,7,3,10,2018,7,30,Monday
2,15,14,29,2018,1,8,Monday
5,13,22,35,2018,7,13,Friday
1,4,17,21,2017,8,24,Thursday
4,12,11,23,2018,7,14,Saturday
3,12,13,25,2017,11,3,Friday
3,18,5,23,2017,11,13,Monday
0,7,32,39,2018,6,29,Friday
4,19,12,31,2017,9,15,Friday
1,8,41,49,2018,8,9,Thursday
2,17,7,24,2017,6,24,Saturday
1,25,4,29,2018,4,23,Monday
1,2,9,11,2018,6,17,Sunday
3,4,12,16,2018,1,29,Monday
2,6,19,25,2018,5,26,Saturday
2,12,34,46,2018,6,4,Monday
1,6,21,27,2018,6,14,Thursday
1,9,21,30,2018,1,8,Monday
4,8,16,24,2018,6,17,Sunday
0,13,17,30,2017,7,12,Wednseday
3,4,7,11,2018,4,8,Sunday
5,15,8,23,2018,3,21,Wednseday
1,8,9,17,2017,3,14,Tuesday
2,18,19,37,2018,5,2,Wednseday
5,8,18,26,2017,10,29,Sunday
4,13,20,33,2018,6,1,Friday
2,14,58,72,2017,2,21,Tuesday
0,6,35,41,2018,6,6,Wednseday
3,33,-7,26,2018,2,17,Saturday
1,22,9,31,2017,6,12,Monday
17,27,3,30,2018,5,7,Monday
6,17,8,25,2018,5,4,Friday
2,7,17,24,2017,5,15,Monday
4,9,15,24,2018,2,10,Saturday
3,9,16,25,2017,12,30,Saturday
1,9,9,18,2017,10,9,Monday
6,11,22,33,2017,4,21,Friday
5,27,6,33,2018,4,12,Thursday
1,8,12,20,2018,5,10,Thursday
3,5,20,25,2018,5,5,Saturday
6,7,6,13,2017,5,26,Friday
5,6,13,19,2017,9,13,Wednseday
3,5,9,14,2017,8,4,Friday
4,11,15,26,2017,10,14,Saturday
2,12,9,21,2017,9,13,Wednseday
2,22,-4,18,2018,5,14,Monday
1,8,15,23,2018,3,20,Tuesday
1,7,7,14,2018,8,21,Tuesday
4,6,2,8,2018,8,16,Thursday
8,32,-6,26,2018,2,25,Sunday
1,5,25,30,2018,7,18,Wednseday
7,35,-13,22,2018,1,30,Tuesday
3,16,8,24,2017,9,2,Saturday
0,7,10,17,2018,6,11,Monday
3,10,12,22,2017,5,28,Sunday
4,10,14,24,2017,8,4,Friday
1,7,13,20,2018,7,24,Tuesday
1,33,-10,23,2018,2,14,Wednseday
3,12,14,26,2017,5,21,Sunday
1,11,11,22,2018,3,20,Tuesday
6,12,16,28,2017,4,5,Wednseday
3,14,6,20,2017,11,24,Friday
1,17,11,28,2017,5,9,Tuesday
1,11,21,32,2017,11,24,Friday
2,10,9,19,2017,11,12,Sunday
4,23,1,24,2017,6,17,Saturday
2,13,7,20,2018,5,8,Tuesday
4,32,-4,28,2018,3,15,Thursday
1,11,1,12,2018,8,9,Thursday
6,18,2,20,2017,11,23,Thursday
7,8,22,30,2018,8,7,Tuesday
0,1,16,17,2018,3,2,Friday
1,3,24,27,2018,6,7,Thursday
6,33,-9,24,2017,11,24,Friday
3,17,7,24,2017,7,28,Friday
1,13,11,24,2018,2,5,Monday
1,5,3,8,2018,7,10,Tuesday
1,14,11,25,2018,3,1,Thursday
1,12,5,17,2018,3,4,Sunday
1,7,37,44,2017,10,25,Wednseday
5,17,10,27,2017,6,9,Friday
4,11,9,20,2018,5,4,Friday
2,5,17,22,2018,2,15,Thursday
1,21,18,39,2017,10,9,Monday
7,22,42,64,2018,5,28,Monday
18,31,-6,25,2017,9,10,Sunday
3,8,41,49,2018,5,14,Monday
4,11,14,25,2017,6,8,Thursday
1,10,14,24,2018,5,6,Sunday
0,3,10,13,2018,8,21,Tuesday
1,4,18,22,2017,9,26,Tuesday
2,8,12,20,2017,12,19,Tuesday
4,5,13,18,2017,7,23,Sunday
2,35,-12,23,2018,3,10,Saturday
2,14,10,24,2018,4,3,Tuesday
3,8,11,19,2018,7,29,Sunday
3,17,11,28,2018,4,30,Monday
2,14,8,22,2017,7,5,Wednseday
1,5,18,23,2018,6,10,Sunday
3,13,31,44,2018,1,27,Saturday
2,6,9,15,2018,1,24,Wednseday
2,11,12,23,2017,4,22,Saturday
5,14,10,24,2018,3,3,Saturday
1,5,21,26,2018,8,24,Friday
1,8,55,63,2017,11,8,Wednseday
2,9,15,24,2017,3,11,Saturday
5,35,-16,19,2018,3,2,Friday
5,19,15,34,2017,4,27,Thursday
5,18,5,23,2017,6,14,Wednseday
45,63,-45,18,2017,11,6,Monday
4,8,11,19,2018,4,6,Friday
1,6,13,19,2018,5,11,Friday
3,7,23,30,2018,1,8,Monday
2,10,13,23,2018,8,19,Sunday
1,6,9,15,2018,4,11,Wednseday
19,29,-10,19,2017,11,24,Friday
3,23,-6,17,2018,3,11,Sunday
6,7,11,18,2018,4,12,Thursday
3,8,9,17,2018,8,3,Friday
2,3,15,18,2018,1,8,Monday
0,6,15,21,2018,5,11,Friday
8,22,10,32,2018,2,11,Sunday
1,8,10,18,2017,3,26,Sunday
2,7,34,41,2018,4,25,Wednseday
5,19,21,40,2017,4,27,Thursday
1,8,19,27,2018,2,15,Thursday
5,11,17,28,2017,6,22,Thursday
5,12,14,26,2017,7,19,Wednseday
1,4,25,29,2018,4,22,Sunday
2,5,21,26,2017,10,22,Sunday
3,8,19,27,2017,12,12,Tuesday
2,21,2,23,2017,11,29,Wednseday
5,10,37,47,2018,6,2,Saturday
5,18,18,36,2017,6,18,Sunday
5,24,2,26,2018,3,10,Saturday
4,5,8,13,2018,3,15,Thursday
4,26,1,27,2018,1,4,Thursday
1,3,22,25,2018,6,18,Monday
1,8,20,28,2018,7,19,Thursday
1,29,8,37,2018,1,8,Monday
1,21,10,31,2018,4,23,Monday
1,8,16,24,2017,12,18,Monday
1,18,7,25,2017,8,14,Monday
3,14,26,40,2017,10,13,Friday
3,5,20,25,2018,8,12,Sunday
1,2,20,22,2017,6,4,Sunday
5,12,4,16,2017,11,11,Saturday
1,3,5,8,2018,7,24,Tuesday
0,7,32,39,2018,6,25,Monday
5,13,18,31,2017,9,1,Friday
4,6,22,28,2018,1,19,Friday
4,11,21,32,2018,6,9,Saturday
1,11,19,30,2017,11,26,Sunday
2,7,13,20,2017,8,15,Tuesday
6,18,9,27,2017,12,22,Friday
2,8,16,24,2018,4,22,Sunday
1,7,20,27,2017,5,11,Thursday
7,20,14,34,2017,12,27,Wednseday
1,6,2,8,2018,7,31,Tuesday
2,16,20,36,2017,12,31,Sunday
4,17,28,45,2017,3,31,Friday
2,13,21,34,2017,12,16,Saturday
1,10,13,23,2017,9,13,Wednseday
1,3,14,17,2018,1,9,Tuesday
4,13,19,32,2017,7,31,Monday
7,14,13,27,2017,5,10,Wednseday
3,13,6,19,2018,3,10,Saturday
14,50,-26,24,2017,11,14,Tuesday
1,7,22,29,2017,8,22,Tuesday
1,5,10,15,2017,11,16,Thursday
3,7,15,22,2018,1,29,Monday
3,6,20,26,2018,7,22,Sunday
2,33,-1,32,2018,1,28,Sunday
3,4,7,11,2017,8,7,Monday
4,7,19,26,2018,6,21,Thursday
1,6,14,20,2018,8,9,Thursday
1,16,8,24,2017,12,19,Tuesday
29,62,-14,48,2018,3,15,Thursday
5,12,9,21,2017,3,23,Thursday
2,8,14,22,2018,1,15,Monday
1,51,-24,27,2018,3,14,Wednseday
8,16,33,49,2018,5,28,Monday
2,11,7,18,2017,9,17,Sunday
0,2,13,15,2018,2,14,Wednseday
10,37,-13,24,2017,11,14,Tuesday
3,6,7,13,2017,11,1,Wednseday
2,6,2,8,2018,8,1,Wednseday
4,8,14,22,2018,6,25,Monday
2,16,-4,12,2018,7,21,Saturday
5,15,6,21,2017,11,1,Wednseday
2,11,9,20,2018,5,12,Saturday
6,23,13,36,2017,11,28,Tuesday
5,12,13,25,2017,10,6,Friday
2,12,13,25,2017,10,29,Sunday
2,4,26,30,2018,2,4,Sunday
5,6,16,22,2017,4,13,Thursday
1,7,16,23,2018,4,10,Tuesday
1,13,8,21,2017,8,29,Tuesday
7,8,5,13,2018,8,15,Wednseday
0,12,15,27,2017,6,7,Wednseday
2,31,12,43,2017,12,17,Sunday
2,11,17,28,2018,1,8,Monday
5,6,7,13,2017,8,3,Thursday
3,8,15,23,2017,7,23,Sunday
0,4,34,38,2018,6,29,Friday
1,30,7,37,2017,11,28,Tuesday
2,8,32,40,2018,6,6,Wednseday
1,5,20,25,2017,10,5,Thursday
4,10,18,28,2018,6,15,Friday
7,12,11,23,2017,6,12,Monday
1,11,21,32,2017,3,5,Sunday
1,2,11,13,2017,8,9,Wednseday
2,6,16,22,2018,7,3,Tuesday
2,14,15,29,2017,7,4,Tuesday
2,7,10,17,2017,11,21,Tuesday
1,17,17,34,2018,2,6,Tuesday
1,18,18,36,2017,10,8,Sunday
1,13,11,24,2017,9,12,Tuesday
3,30,-1,29,2017,12,17,Sunday
13,27,-5,22,2017,11,30,Thursday
3,10,17,27,2018,1,26,Friday
3,82,-50,32,2017,6,16,Friday
2,30,4,34,2017,4,11,Tuesday
3,8,13,21,2017,6,6,Tuesday
1,18,12,30,2018,1,30,Tuesday
1,6,17,23,2017,4,5,Wednseday
1,22,1,23,2017,6,5,Monday
4,18,9,27,2017,11,23,Thursday
2,5,11,16,2018,1,17,Wednseday
4,12,10,22,2018,7,26,Thursday
2,9,16,25,2018,1,22,Monday
4,10,20,30,2018,2,13,Tuesday
1,5,33,38,2018,6,3,Sunday
3,9,10,19,2018,4,29,Sunday
5,22,4,26,2018,5,16,Wednseday
3,8,19,27,2018,3,9,Friday
1,4,16,20,2017,7,6,Thursday
2,42,-6,36,2018,3,7,Wednseday
1,2,8,10,2018,7,9,Monday
4,17,3,20,2018,2,23,Friday
2,8,10,18,2018,2,19,Monday
5,26,-1,25,2018,3,15,Thursday
1,8,8,16,2018,8,5,Sunday
5,8,47,55,2016,10,8,Saturday
2,9,15,24,2018,7,21,Saturday
2,5,11,16,2018,8,4,Saturday
2,8,7,15,2018,8,6,Monday
3,15,6,21,2017,11,6,Monday
2,7,23,30,2017,10,9,Monday
6,12,19,31,2018,2,9,Friday
11,16,6,22,2018,2,8,Thursday
1,7,6,13,2017,10,10,Tuesday
2,6,12,18,2018,1,6,Saturday
1,2,8,10,2018,8,20,Monday
1,2,18,20,2017,12,26,Tuesday
5,9,13,22,2017,11,29,Wednseday
6,19,5,24,2018,1,26,Friday
2,3,17,20,2018,7,3,Tuesday
3,6,18,24,2018,6,22,Friday
2,9,26,35,2018,3,15,Thursday
1,14,13,27,2017,9,28,Thursday
1,18,7,25,2018,4,5,Thursday
1,5,28,33,2018,5,16,Wednseday
1,3,12,15,2018,1,15,Monday
0,15,6,21,2018,3,19,Monday
3,4,14,18,2018,1,27,Saturday
5,20,7,27,2017,11,30,Thursday
0,20,14,34,2018,5,4,Friday
6,14,2,16,2017,10,31,Tuesday
2,6,17,23,2017,10,21,Saturday
1,2,10,12,2017,10,29,Sunday
1,12,22,34,2018,5,31,Thursday
2,10,23,33,2018,1,27,Saturday
5,14,14,28,2018,7,11,Wednseday
5,14,21,35,2018,7,27,Friday
3,10,36,46,2018,7,29,Sunday
2,16,6,22,2018,3,4,Sunday
3,16,12,28,2017,11,7,Tuesday
3,6,9,15,2018,1,23,Tuesday
3,18,12,30,2018,6,23,Saturday
1,14,15,29,2017,12,14,Thursday
1,12,10,22,2018,2,26,Monday
3,9,21,30,2017,4,29,Saturday
3,6,12,18,2018,4,14,Saturday
7,21,9,30,2018,2,7,Wednseday
4,13,0,13,2017,9,7,Thursday
7,14,11,25,2017,11,9,Thursday
1,10,12,22,2017,5,16,Tuesday
6,8,21,29,2017,7,11,Tuesday
3,6,21,27,2017,12,23,Saturday
3,19,11,30,2017,2,5,Sunday
0,3,11,14,2017,11,14,Tuesday
3,23,12,35,2018,5,14,Monday
4,18,2,20,2018,4,5,Thursday
4,13,9,22,2017,4,20,Thursday
3,26,12,38,2018,4,27,Friday
2,9,14,23,2017,6,25,Sunday
2,14,3,17,2018,3,19,Monday
4,28,-4,24,2018,3,17,Saturday
3,54,-27,27,2018,1,13,Saturday
5,9,21,30,2017,2,12,Sunday
0,7,14,21,2018,8,21,Tuesday
1,7,20,27,2018,1,4,Thursday
4,19,1,20,2018,3,8,Thursday
1,15,14,29,2017,5,30,Tuesday
2,8,20,28,2017,6,5,Monday
0,7,20,27,2018,6,19,Tuesday
1,3,12,15,2018,4,10,Tuesday
1,8,14,22,2018,2,8,Thursday
0,5,35,40,2018,6,1,Friday
5,8,0,8,2018,8,5,Sunday
1,7,7,14,2018,8,14,Tuesday
2,12,15,27,2018,1,24,Wednseday
0,10,23,33,2017,3,10,Friday
4,38,-14,24,2018,4,28,Saturday
2,8,10,18,2017,3,5,Sunday
8,16,9,25,2017,10,22,Sunday
0,2,12,14,2017,11,29,Wednseday
5,10,9,19,2018,7,20,Friday
1,2,13,15,2017,11,12,Sunday
2,22,7,29,2018,2,8,Thursday
1,5,28,33,2017,8,27,Sunday
5,25,6,31,2017,12,2,Saturday
3,58,-32,26,2018,2,24,Saturday
5,11,9,20,2018,7,19,Thursday
1,5,1,6,2018,8,9,Thursday
2,4,14,18,2018,4,5,Thursday
1,6,16,22,2017,11,20,Monday
2,5,17,22,2018,6,20,Wednseday
1,2,14,16,2018,4,18,Wednseday
1,24,-2,22,2017,10,3,Tuesday
2,6,11,17,2017,3,21,Tuesday
1,7,17,24,2018,6,26,Tuesday
1,5,17,22,2018,7,18,Wednseday
13,15,4,19,2018,8,1,Wednseday
1,10,14,24,2017,12,4,Monday
18,24,3,27,2018,7,20,Friday
3,31,-8,23,2017,10,1,Sunday
1,2,11,13,2017,10,24,Tuesday
9,18,20,38,2017,11,28,Tuesday
5,7,12,19,2017,8,30,Wednseday
1,7,12,19,2018,4,26,Thursday
1,11,13,24,2018,1,14,Sunday
2,8,11,19,2017,3,8,Wednseday
6,14,10,24,2017,9,22,Friday
6,20,4,24,2018,2,16,Friday
2,13,7,20,2018,2,24,Saturday
3,10,7,17,2017,9,5,Tuesday
2,18,12,30,2017,12,10,Sunday
1,2,5,7,2018,8,21,Tuesday
1,3,23,26,2018,5,31,Thursday
1,3,5,8,2018,8,5,Sunday
2,3,5,8,2018,7,31,Tuesday
5,8,34,42,2018,6,20,Wednseday
0,3,20,23,2017,9,26,Tuesday
1,5,6,11,2018,8,23,Thursday
3,22,14,36,2017,3,28,Tuesday
1,55,-29,26,2018,4,25,Wednseday
5,6,14,20,2018,1,10,Wednseday
4,7,12,19,2017,11,17,Friday
1,8,6,14,2018,8,7,Tuesday
1,3,11,14,2018,5,7,Monday
10,31,2,33,2018,3,4,Sunday
6,20,27,47,2017,3,11,Saturday
1,13,31,44,2018,6,5,Tuesday
2,10,28,38,2017,3,25,Saturday
4,9,9,18,2018,5,25,Friday
1,7,7,14,2018,2,21,Wednseday
3,8,16,24,2017,4,14,Friday
1,8,22,30,2018,1,8,Monday
3,13,25,38,2018,1,12,Friday
3,29,-10,19,2018,2,25,Sunday
1,8,24,32,2018,6,3,Sunday
2,11,13,24,2017,12,11,Monday
6,24,10,34,2018,6,23,Saturday
6,8,7,15,2018,1,18,Thursday
4,11,0,11,2018,8,5,Sunday
2,21,16,37,2017,12,18,Monday
3,7,37,44,2018,6,4,Monday
0,7,18,25,2017,10,20,Friday
3,6,8,14,2017,6,6,Tuesday
14,21,2,23,2017,5,2,Tuesday
2,13,13,26,2018,2,3,Saturday
4,14,23,37,2017,5,15,Monday
2,10,12,22,2018,4,5,Thursday
1,2,14,16,2017,9,24,Sunday
5,7,19,26,2017,12,14,Thursday
4,46,-22,24,2018,3,9,Friday
0,14,12,26,2018,3,14,Wednseday
2,12,6,18,2017,8,28,Monday
4,18,10,28,2017,7,13,Thursday
3,21,12,33,2018,2,16,Friday
2,3,17,20,2018,6,26,Tuesday
3,6,17,23,2017,10,21,Saturday
1,14,13,27,2018,1,2,Tuesday
3,23,17,40,2017,9,30,Saturday
9,14,47,61,2016,10,5,Wednseday
1,2,9,11,2017,8,21,Monday
3,10,17,27,2017,6,2,Friday
0,6,17,23,2017,9,27,Wednseday
1,3,5,8,2018,8,5,Sunday
1,11,9,20,2018,2,15,Thursday
3,10,24,34,2018,6,8,Friday
3,8,17,25,2017,12,3,Sunday
0,6,16,22,2018,4,17,Tuesday
4,16,22,38,2017,4,23,Sunday
1,166,-123,43,2017,4,6,Thursday
4,13,4,17,2018,1,19,Friday
1,7,15,22,2017,8,8,Tuesday
1,19,10,29,2017,8,16,Wednseday
2,7,10,17,2018,6,11,Monday
0,8,13,21,2017,9,18,Monday
3,10,19,29,2018,6,25,Monday
2,14,9,23,2017,10,2,Monday
2,7,16,23,2018,5,1,Tuesday
3,9,10,19,2017,7,9,Sunday
2,3,12,15,2018,6,18,Monday
2,9,23,32,2017,6,19,Monday
2,8,9,17,2017,4,24,Monday
1,4,5,9,2018,7,31,Tuesday
7,28,31,59,2018,5,29,Tuesday
3,8,13,21,2018,2,27,Tuesday
1,14,9,23,2017,6,5,Monday
1,10,6,16,2018,8,7,Tuesday
1,7,29,36,2018,8,14,Tuesday
0,5,22,27,2017,12,22,Friday
1,2,16,18,2017,7,31,Monday
0,16,6,22,2017,7,4,Tuesday
6,12,12,24,2017,7,29,Saturday
6,7,47,54,2018,6,2,Saturday
5,12,19,31,2018,1,5,Friday
1,13,20,33,2017,12,27,Wednseday
0,1,18,19,2018,1,3,Wednseday
7,12,15,27,2018,1,11,Thursday
1,13,14,27,2017,6,15,Thursday
0,8,12,20,2017,5,24,Wednseday
6,13,12,25,2018,1,6,Saturday
3,10,7,17,2018,7,13,Friday
0,7,14,21,2018,8,21,Tuesday
2,6,17,23,2018,7,14,Saturday
2,5,21,26,2017,2,12,Sunday
4,14,8,22,2018,8,6,Monday
2,6,9,15,2018,2,14,Wednseday
12,18,-4,14,2018,5,11,Friday
9,17,6,23,2017,11,13,Monday
4,5,8,13,2018,3,30,Friday
1,11,22,33,2017,7,20,Thursday
1,9,13,22,2017,5,17,Wednseday
1,27,4,31,2018,3,6,Tuesday
5,12,20,32,2017,3,31,Friday
1,9,21,30,2017,7,11,Tuesday
2,14,15,29,2018,1,21,Sunday
6,9,14,23,2018,7,17,Tuesday
4,26,0,26,2018,2,16,Friday
0,1,19,20,2018,1,4,Thursday
2,6,19,25,2017,12,11,Monday
0,20,1,21,2017,9,20,Wednseday
9,21,1,22,2017,8,29,Tuesday
2,26,4,30,2017,12,18,Monday
6,15,14,29,2017,6,27,Tuesday
5,11,21,32,2017,8,10,Thursday
4,16,2,18,2018,5,19,Saturday
1,5,9,14,2018,4,25,Wednseday
1,20,9,29,2018,4,19,Thursday
5,11,11,22,2017,5,7,Sunday
1,26,1,27,2018,3,28,Wednseday
3,4,1,5,2018,8,10,Friday
1,14,9,23,2017,8,21,Monday
8,11,7,18,2018,7,19,Thursday
2,9,9,18,2018,4,16,Monday
2,8,26,34,2018,6,9,Saturday
2,7,15,22,2018,7,9,Monday
8,13,9,22,2017,6,6,Tuesday
1,4,13,17,2018,7,22,Sunday
3,11,13,24,2017,3,24,Friday
1,26,0,26,2017,11,17,Friday
1,13,14,27,2018,2,6,Tuesday
2,19,10,29,2017,10,18,Wednseday
1,6,14,20,2017,7,27,Thursday
5,8,12,20,2017,7,20,Thursday
2,8,15,23,2017,6,25,Sunday
0,7,12,19,2018,5,3,Thursday
1,7,18,25,2018,3,22,Thursday
1,21,-1,20,2018,3,7,Wednseday
1,20,15,35,2018,4,19,Thursday
5,17,20,37,2018,6,16,Saturday
3,13,9,22,2017,10,31,Tuesday
3,11,21,32,2017,10,27,Friday
5,10,9,19,2017,10,29,Sunday
2,10,9,19,2018,6,9,Saturday
1,18,9,27,2018,2,8,Thursday
3,5,13,18,2018,1,5,Friday
16,23,22,45,2018,3,10,Saturday
1,7,15,22,2017,7,6,Thursday
2,12,7,19,2018,3,25,Sunday
1,12,20,32,2017,5,4,Thursday
3,8,-1,7,2018,8,13,Monday
0,7,16,23,2018,5,9,Wednseday
1,8,20,28,2018,6,21,Thursday
2,7,15,22,2017,7,17,Monday
1,2,14,16,2017,12,6,Wednseday
1,4,10,14,2018,7,24,Tuesday
1,9,10,19,2017,11,26,Sunday
6,13,20,33,2018,1,17,Wednseday
0,8,9,17,2017,3,14,Tuesday
2,39,17,56,2018,3,12,Monday
1,10,23,33,2018,1,28,Sunday
3,10,17,27,2017,10,7,Saturday
2,7,20,27,2017,9,13,Wednseday
4,13,9,22,2018,3,1,Thursday
1,8,8,16,2018,8,5,Sunday
2,6,30,36,2018,6,5,Tuesday
5,29,-5,24,2018,2,16,Friday
1,5,14,19,2018,1,19,Friday
1,6,6,12,2018,8,9,Thursday
3,14,11,25,2017,11,3,Friday
4,10,4,14,2018,8,17,Friday
4,17,11,28,2017,10,2,Monday
1,4,15,19,2017,10,5,Thursday
2,6,17,23,2018,4,28,Saturday
3,10,5,15,2018,8,5,Sunday
1,9,12,21,2018,7,17,Tuesday
1,5,15,20,2018,5,16,Wednseday
0,15,19,34,2018,1,19,Friday
3,14,10,24,2018,3,13,Tuesday
1,8,6,14,2018,5,15,Tuesday
4,12,16,28,2017,3,31,Friday
3,25,19,44,2017,12,17,Sunday
4,6,6,12,2017,7,30,Sunday
10,11,13,24,2018,6,22,Friday
2,10,26,36,2018,4,30,Monday
1,2,14,16,2018,4,25,Wednseday
2,12,14,26,2017,4,8,Saturday
1,3,5,8,2018,7,25,Wednseday
4,13,20,33,2017,9,28,Thursday
2,9,14,23,2017,2,27,Monday
2,5,4,9,2018,8,12,Sunday
1,7,16,23,2017,9,24,Sunday
3,18,10,28,2018,2,16,Friday
3,12,6,18,2018,3,2,Friday
6,22,11,33,2018,1,3,Wednseday
1,9,15,24,2017,5,16,Tuesday
5,24,-6,18,2017,9,8,Friday
4,9,17,26,2017,10,19,Thursday
2,4,22,26,2018,6,2,Saturday
2,15,3,18,2017,11,19,Sunday
17,30,-5,25,2017,7,22,Saturday
1,2,18,20,2017,12,27,Wednseday
10,20,41,61,2017,5,20,Saturday
6,13,12,25,2017,11,16,Thursday
1,12,14,26,2018,2,21,Wednseday
6,12,13,25,2018,8,16,Thursday
4,24,35,59,2016,10,7,Friday
1,4,2,6,2018,8,2,Thursday
3,4,14,18,2018,3,25,Sunday
1,9,13,22,2017,10,18,Wednseday
6,26,8,34,2018,1,6,Saturday
3,19,6,25,2018,7,27,Friday
2,4,18,22,2017,8,7,Monday
7,39,-1,38,2018,1,26,Friday
1,8,34,42,2017,12,13,Wednseday
6,7,-2,5,2018,8,22,Wednseday
5,6,18,24,2017,8,4,Friday
2,14,15,29,2018,4,10,Tuesday
1,2,13,15,2018,1,22,Monday
6,7,8,15,2018,1,17,Wednseday
1,9,26,35,2018,5,14,Monday
2,10,28,38,2017,12,11,Monday
0,10,15,25,2018,5,11,Friday
0,21,-12,9,2018,8,15,Wednseday
2,4,14,18,2017,12,31,Sunday
1,6,4,10,2018,7,31,Tuesday
1,5,8,13,2017,6,29,Thursday
2,26,-4,22,2018,3,25,Sunday
4,14,14,28,2018,4,30,Monday
4,20,1,21,2018,5,18,Friday
1,5,2,7,2018,8,1,Wednseday
2,8,16,24,2018,5,1,Tuesday
1,17,13,30,2018,5,21,Monday
6,8,3,11,2018,6,7,Thursday
2,8,8,16,2017,9,18,Monday
4,44,-15,29,2018,3,5,Monday
5,61,-35,26,2018,4,7,Saturday
1,3,20,23,2017,10,3,Tuesday
3,27,1,28,2018,2,23,Friday
2,15,3,18,2018,4,1,Sunday
1,10,17,27,2018,6,26,Tuesday
5,14,13,27,2018,7,13,Friday
1,6,4,10,2018,7,31,Tuesday
7,11,20,31,2017,10,16,Monday
1,12,14,26,2017,7,12,Wednseday
2,8,13,21,2018,8,1,Wednseday
3,4,15,19,2018,7,7,Saturday
3,16,15,31,2018,4,17,Tuesday
10,17,8,25,2018,1,13,Saturday
2,13,2,15,2018,3,26,Monday
4,21,4,25,2017,11,24,Friday
4,5,6,11,2018,3,4,Sunday
6,31,9,40,2017,4,29,Saturday
2,3,11,14,2018,2,19,Monday
3,8,17,25,2017,7,23,Sunday
2,15,10,25,2017,11,26,Sunday
4,29,-5,24,2018,3,10,Saturday
1,6,27,33,2017,8,2,Wednseday
6,11,24,35,2017,3,23,Thursday
1,19,7,26,2018,3,21,Wednseday
1,25,10,35,2017,8,10,Thursday
2,22,0,22,2018,2,20,Tuesday
1,9,10,19,2017,9,3,Sunday
1,9,10,19,2017,3,16,Thursday
5,8,25,33,2017,9,28,Thursday
3,7,14,21,2017,5,26,Friday
2,17,13,30,2017,11,27,Monday
3,7,17,24,2017,8,11,Friday
1,7,29,36,2017,3,27,Monday
4,12,13,25,2018,7,27,Friday
1,7,13,20,2017,3,29,Wednseday
3,4,23,27,2018,6,2,Saturday
8,9,3,12,2017,9,10,Sunday
2,12,11,23,2018,1,17,Wednseday
2,12,10,22,2017,10,25,Wednseday
1,4,7,11,2018,5,10,Thursday
3,23,-4,19,2017,11,19,Sunday
2,6,16,22,2018,1,30,Tuesday
2,7,16,23,2018,3,21,Wednseday
6,17,6,23,2018,4,1,Sunday
3,4,1,5,2018,7,28,Saturday
3,11,13,24,2017,5,20,Saturday
3,8,18,26,2018,5,6,Sunday
0,6,14,20,2018,8,16,Thursday
1,5,15,20,2017,8,4,Friday
2,16,4,20,2018,3,7,Wednseday
1,12,8,20,2017,11,9,Thursday
1,11,16,27,2018,4,10,Tuesday
3,8,16,24,2017,6,19,Monday
2,14,15,29,2017,9,4,Monday
3,4,10,14,2018,1,26,Friday
0,7,9,16,2018,7,30,Monday
1,6,8,14,2018,7,26,Thursday
3,7,27,34,2018,7,27,Friday
3,13,14,27,2018,2,2,Friday
3,12,19,31,2017,11,12,Sunday
7,16,17,33,2017,7,20,Thursday
1,13,11,24,2018,1,9,Tuesday
3,17,7,24,2017,7,29,Saturday
1,9,14,23,2017,5,31,Wednseday
8,9,11,20,2017,12,27,Wednseday
1,2,24,26,2017,1,25,Wednseday
4,13,9,22,2018,7,26,Thursday
1,9,13,22,2017,8,9,Wednseday
2,21,2,23,2018,2,18,Sunday
1,8,12,20,2018,5,16,Wednseday
1,9,31,40,2017,1,8,Sunday
1,5,9,14,2018,8,8,Wednseday
2,9,10,19,2017,10,25,Wednseday
1,8,19,27,2018,6,7,Thursday
2,3,9,12,2018,8,19,Sunday
0,8,18,26,2017,7,27,Thursday
2,9,16,25,2017,9,24,Sunday
4,18,8,26,2017,11,24,Friday
5,22,-2,20,2018,5,16,Wednseday
0,2,21,23,2017,5,24,Wednseday
1,4,11,15,2018,5,17,Thursday
4,21,16,37,2017,4,11,Tuesday
4,19,10,29,2017,10,26,Thursday
1,2,9,11,2017,9,10,Sunday
5,20,6,26,2018,7,25,Wednseday
6,8,11,19,2017,3,8,Wednseday
1,9,8,17,2018,7,31,Tuesday
2,5,13,18,2018,7,21,Saturday
7,19,7,26,2018,2,14,Wednseday
1,9,13,22,2017,9,3,Sunday
8,15,27,42,2018,6,6,Wednseday
1,13,11,24,2017,12,26,Tuesday
1,9,14,23,2018,2,14,Wednseday
0,4,15,19,2017,11,24,Friday
2,7,18,25,2018,5,5,Saturday
4,13,13,26,2017,8,11,Friday
2,5,6,11,2018,8,4,Saturday
6,14,10,24,2017,11,24,Friday
3,13,10,23,2017,5,2,Tuesday
3,7,16,23,2018,4,30,Monday
0,15,3,18,2018,5,17,Thursday
2,15,14,29,2017,3,22,Wednseday
4,6,7,13,2018,3,22,Thursday
5,7,6,13,2018,3,22,Thursday
1,6,16,22,2018,7,4,Wednseday
9,19,2,21,2017,5,31,Wednseday
4,5,11,16,2017,11,25,Saturday
1,13,19,32,2018,4,6,Friday
1,8,32,40,2018,6,7,Thursday
3,9,15,24,2017,9,9,Saturday
2,7,11,18,2018,3,26,Monday
2,9,13,22,2018,5,1,Tuesday
11,12,1,13,2018,4,13,Friday
3,18,0,18,2017,11,13,Monday
1,11,10,21,2017,11,23,Thursday
0,2,10,12,2017,11,1,Wednseday
5,27,15,42,2018,1,5,Friday
1,2,9,11,2018,6,17,Sunday
17,20,35,55,2016,10,4,Tuesday
1,12,17,29,2018,3,11,Sunday
5,6,10,16,2017,10,14,Saturday
4,5,22,27,2017,2,17,Friday
3,11,20,31,2018,6,30,Saturday
1,3,28,31,2017,3,28,Tuesday
4,5,10,15,2017,5,11,Thursday
1,17,16,33,2017,12,6,Wednseday
1,5,19,24,2018,1,7,Sunday
1,14,9,23,2017,11,28,Tuesday
2,3,10,13,2017,5,27,Saturday
4,14,2,16,2018,2,10,Saturday
4,10,7,17,2018,8,13,Monday
1,16,18,34,2018,6,26,Tuesday
0,22,6,28,2017,12,18,Monday
20,20,-1,19,2017,10,11,Wednseday
2,7,11,18,2018,2,26,Monday
3,7,16,23,2017,7,4,Tuesday
1,18,21,39,2017,6,5,Monday
1,3,6,9,2018,5,13,Sunday
1,13,9,22,2017,8,29,Tuesday
0,10,12,22,2017,8,29,Tuesday
4,8,11,19,2017,9,14,Thursday
2,20,2,22,2017,3,21,Tuesday
3,7,21,28,2018,7,20,Friday
7,14,12,26,2017,7,6,Thursday
12,22,9,31,2017,11,26,Sunday
3,48,-16,32,2018,1,20,Saturday
4,4,24,28,2018,4,9,Monday
3,12,12,24,2017,6,30,Friday
4,7,4,11,2018,5,7,Monday
2,3,11,14,2018,2,20,Tuesday
4,6,16,22,2017,12,14,Thursday
3,12,33,45,2018,6,15,Friday
0,6,28,34,2018,7,3,Tuesday
2,6,20,26,2017,12,3,Sunday
2,6,13,19,2018,7,14,Saturday
2,23,23,46,2017,11,4,Saturday
7,17,5,22,2017,8,15,Tuesday
3,11,12,23,2017,11,19,Sunday
6,15,14,29,2018,1,9,Tuesday
0,5,17,22,2017,7,12,Wednseday
6,8,18,26,2017,4,12,Wednseday
1,9,4,13,2018,4,26,Thursday
4,5,8,13,2018,3,30,Friday
0,7,20,27,2018,5,15,Tuesday
2,11,13,24,2018,3,25,Sunday
3,10,23,33,2018,6,30,Saturday
18,36,-6,30,2017,11,28,Tuesday
1,28,6,34,2018,3,14,Wednseday
6,14,6,20,2018,3,15,Thursday
5,12,9,21,2018,3,22,Thursday
13,42,-15,27,2018,1,13,Saturday
2,10,25,35,2018,6,25,Monday
0,7,17,24,2018,7,27,Friday
3,20,2,22,2018,3,6,Tuesday
0,7,22,29,2017,2,14,Tuesday
3,5,18,23,2017,3,25,Saturday
3,16,21,37,2017,9,30,Saturday
3,4,-1,3,2018,8,20,Monday
6,13,13,26,2018,3,22,Thursday
10,11,20,31,2017,11,11,Saturday
1,14,8,22,2017,8,10,Thursday
11,29,5,34,2017,7,7,Friday
6,11,8,19,2018,5,10,Thursday
0,3,16,19,2018,4,13,Friday
0,7,35,42,2018,6,6,Wednseday
1,11,29,40,2017,8,17,Thursday
2,3,14,17,2018,4,21,Saturday
13,14,9,23,2018,4,4,Wednseday
4,7,21,28,2017,8,24,Thursday
3,16,13,29,2018,4,16,Monday
0,4,1,5,2018,8,23,Thursday
2,12,26,38,2018,4,9,Monday
1,8,12,20,2017,5,23,Tuesday
3,10,5,15,2018,8,14,Tuesday
1,7,22,29,2018,1,22,Monday
3,6,14,20,2017,12,16,Saturday
0,1,9,10,2017,9,19,Tuesday
3,17,10,27,2017,11,24,Friday
3,17,0,17,2018,3,20,Tuesday
4,5,7,12,2018,3,2,Friday
2,12,18,30,2018,2,17,Saturday
3,10,16,26,2017,8,4,Friday
1,7,25,32,2018,6,11,Monday
5,17,3,20,2017,6,23,Friday
3,20,9,29,2017,12,31,Sunday
1,10,14,24,2018,2,6,Tuesday
2,11,8,19,2017,11,26,Sunday
2,3,6,9,2018,7,9,Monday
3,16,2,18,2017,4,23,Sunday
1,9,20,29,2017,10,8,Sunday
1,12,41,53,2018,4,9,Monday
1,31,4,35,2017,6,12,Monday
2,13,16,29,2017,5,2,Tuesday
5,7,15,22,2017,11,29,Wednseday
3,15,9,24,2017,7,11,Tuesday
1,11,23,34,2018,6,7,Thursday
1,8,11,19,2018,8,8,Wednseday
4,18,8,26,2017,12,10,Sunday
1,6,16,22,2017,11,7,Tuesday
6,15,12,27,2017,11,30,Thursday
2,13,21,34,2017,12,2,Saturday
1,6,13,19,2018,8,12,Sunday
1,3,16,19,2017,12,7,Thursday
2,6,14,20,2018,2,20,Tuesday
6,7,5,12,2018,3,15,Thursday
0,19,11,30,2018,5,2,Wednseday
1,8,15,23,2018,5,29,Tuesday
1,12,18,30,2018,1,24,Wednseday
3,11,14,25,2017,8,14,Monday
1,7,18,25,2018,1,1,Monday
5,15,11,26,2017,8,11,Friday
4,6,7,13,2018,3,24,Saturday
1,2,13,15,2018,7,4,Wednseday
4,27,13,40,2018,6,7,Thursday
10,17,36,53,2018,2,10,Saturday
1,6,15,21,2017,11,2,Thursday
2,6,14,20,2017,3,29,Wednseday
3,11,15,26,2018,1,6,Saturday
4,8,26,34,2018,5,31,Thursday
8,17,8,25,2017,11,6,Monday
4,12,13,25,2018,7,13,Friday
3,14,10,24,2018,2,20,Tuesday
8,27,8,35,2017,5,16,Tuesday
1,5,16,21,2018,1,18,Thursday
1,7,22,29,2017,2,8,Wednseday
1,6,20,26,2018,2,14,Wednseday
2,7,18,25,2018,4,28,Saturday
2,6,11,17,2017,12,3,Sunday
2,9,7,16,2018,5,5,Saturday
5,15,38,53,2018,1,18,Thursday
2,15,26,41,2018,5,2,Wednseday
3,5,27,32,2017,12,8,Friday
1,12,11,23,2017,6,7,Wednseday
4,18,4,22,2018,2,26,Monday
1,31,6,37,2017,4,4,Tuesday
5,28,-7,21,2018,2,22,Thursday
0,8,10,18,2018,3,8,Thursday
1,7,7,14,2018,7,19,Thursday
0,6,14,20,2017,5,24,Wednseday
0,8,19,27,2017,11,9,Thursday
1,8,23,31,2017,12,5,Tuesday
0,9,16,25,2018,5,3,Thursday
4,20,7,27,2017,7,28,Friday
3,4,12,16,2018,4,16,Monday
0,12,16,28,2017,11,24,Friday
2,10,10,20,2018,2,27,Tuesday
4,6,14,20,2018,2,22,Thursday
3,4,9,13,2017,10,27,Friday
6,7,12,19,2017,3,3,Friday
2,8,18,26,2017,4,30,Sunday
1,41,-4,37,2017,4,11,Tuesday
3,15,11,26,2017,9,15,Friday
6,19,15,34,2018,1,13,Saturday
2,30,-8,22,2017,10,17,Tuesday
1,6,12,18,2017,5,11,Thursday
3,5,5,10,2018,8,18,Saturday
1,3,22,25,2017,12,4,Monday
2,6,12,18,2018,5,12,Saturday
1,11,48,59,2018,3,11,Sunday
0,3,15,18,2017,8,14,Monday
4,12,13,25,2017,2,25,Saturday
7,19,14,33,2018,1,12,Friday
3,11,22,33,2018,6,9,Saturday
7,10,4,14,2017,11,24,Friday
3,11,9,20,2018,3,16,Friday
1,12,20,32,2018,8,16,Thursday
1,12,13,25,2018,4,12,Thursday
1,3,10,13,2017,6,29,Thursday
9,24,22,46,2018,5,26,Saturday
4,19,12,31,2017,12,22,Friday
1,3,15,18,2017,10,5,Thursday
1,4,10,14,2017,11,9,Thursday
2,9,13,22,2018,3,26,Monday
4,7,14,21,2017,10,13,Friday
1,13,4,17,2018,3,27,Tuesday
1,9,17,26,2018,2,8,Thursday
4,17,10,27,2018,4,21,Saturday
4,12,8,20,2018,6,8,Friday
1,9,16,25,2017,10,30,Monday
17,23,9,32,2018,1,22,Monday
3,11,23,34,2018,1,26,Friday
3,8,12,20,2017,11,24,Friday
6,22,5,27,2018,3,16,Friday
1,5,18,23,2018,6,24,Sunday
7,25,-2,23,2018,2,27,Tuesday
1,3,14,17,2018,1,28,Sunday
1,6,23,29,2018,6,28,Thursday
1,2,13,15,2017,5,28,Sunday
4,9,6,15,2018,5,10,Thursday
1,14,8,22,2017,10,23,Monday
2,7,15,22,2018,3,13,Tuesday
4,5,8,13,2017,6,1,Thursday
8,46,-8,38,2017,11,27,Monday
8,10,8,18,2017,10,9,Monday
5,30,4,34,2018,4,12,Thursday
1,2,14,16,2017,11,29,Wednseday
1,9,18,27,2018,5,9,Wednseday
3,14,34,48,2018,6,1,Friday
4,25,-6,19,2017,11,23,Thursday
5,7,4,11,2018,8,16,Thursday
2,4,8,12,2018,3,25,Sunday
1,8,21,29,2018,7,30,Monday
4,11,12,23,2017,8,26,Saturday
35,43,-2,41,2017,1,12,Thursday
1,8,20,28,2018,7,18,Wednseday
6,14,6,20,2017,11,25,Saturday
1,3,13,16,2018,2,5,Monday
3,22,13,35,2018,4,4,Wednseday
1,15,13,28,2018,4,5,Thursday
2,6,14,20,2017,3,28,Tuesday
7,13,13,26,2018,4,12,Thursday
2,21,8,29,2018,2,12,Monday
1,9,14,23,2017,5,29,Monday
3,36,-13,23,2017,9,12,Tuesday
2,14,17,31,2018,3,13,Tuesday
3,9,24,33,2018,6,16,Saturday
4,5,21,26,2017,9,7,Thursday
3,14,10,24,2017,11,11,Saturday
1,9,13,22,2017,3,29,Wednseday
1,7,10,17,2017,3,27,Monday
1,13,10,23,2017,10,4,Wednseday
1,8,24,32,2018,1,28,Sunday
1,7,15,22,2018,7,5,Thursday
1,3,23,26,2018,6,17,Sunday
4,32,5,37,2018,4,14,Saturday
8,15,9,24,2018,4,29,Sunday
12,19,4,23,2017,6,18,Sunday
2,5,11,16,2017,11,12,Sunday
0,7,15,22,2018,6,19,Tuesday
2,20,8,28,2018,4,25,Wednseday
1,15,13,28,2017,7,20,Thursday
4,6,14,20,2017,8,11,Friday
1,14,2,16,2017,9,18,Monday
1,44,-10,34,2018,5,2,Wednseday
0,11,16,27,2018,6,14,Thursday
1,16,12,28,2018,2,19,Monday
12,30,7,37,2017,4,12,Wednseday
5,6,-1,5,2018,8,3,Friday
3,17,11,28,2018,4,6,Friday
5,11,10,21,2017,6,2,Friday
1,8,13,21,2017,9,5,Tuesday
3,12,7,19,2018,8,3,Friday
2,14,7,21,2017,11,14,Tuesday
1,11,38,49,2017,2,6,Monday
0,3,9,12,2017,9,15,Friday
3,7,15,22,2018,4,18,Wednseday
8,15,-2,13,2017,8,31,Thursday
4,14,13,27,2017,11,10,Friday
2,14,17,31,2017,6,5,Monday
2,8,35,43,2017,2,6,Monday
0,9,16,25,2018,1,15,Monday
3,10,9,19,2017,3,10,Friday
0,13,23,36,2018,2,8,Thursday
5,17,13,30,2017,4,22,Saturday
7,8,1,9,2018,8,21,Tuesday
2,9,8,17,2017,8,22,Tuesday
1,8,18,26,2017,4,19,Wednseday
10,25,26,51,2018,1,27,Saturday
2,4,12,16,2018,5,20,Sunday
0,1,10,11,2017,8,21,Monday
5,14,11,25,2018,1,25,Thursday
2,17,10,27,2018,3,20,Tuesday
3,8,6,14,2018,7,31,Tuesday
2,72,-60,12,2017,9,13,Wednseday
8,23,0,23,2018,2,21,Wednseday
9,26,6,32,2017,12,25,Monday
7,44,-17,27,2018,2,20,Tuesday
5,13,9,22,2017,9,13,Wednseday
3,14,8,22,2017,8,8,Tuesday
3,47,-28,19,2017,11,18,Saturday
0,5,20,25,2018,7,20,Friday
1,12,32,44,2017,2,12,Sunday
1,12,13,25,2017,12,3,Sunday
6,16,10,26,2018,8,1,Wednseday
3,9,16,25,2017,10,1,Sunday
6,19,7,26,2018,2,8,Thursday
6,11,8,19,2017,9,1,Friday
2,9,21,30,2018,6,25,Monday
2,7,15,22,2018,4,5,Thursday
1,18,10,28,2017,9,21,Thursday
3,10,15,25,2017,11,18,Saturday
7,8,4,12,2017,10,18,Wednseday
5,12,14,26,2017,7,12,Wednseday
2,5,11,16,2018,5,23,Wednseday
2,18,7,25,2017,8,19,Saturday
5,7,7,14,2017,6,9,Friday
2,11,15,26,2018,1,13,Saturday
2,10,13,23,2018,1,30,Tuesday
2,7,21,28,2018,3,27,Tuesday
4,38,-2,36,2017,8,6,Sunday
7,25,3,28,2018,3,22,Thursday
1,11,14,25,2017,6,15,Thursday
2,6,8,14,2018,2,19,Monday
2,7,20,27,2017,9,26,Tuesday
1,2,8,10,2018,6,19,Tuesday
2,8,5,13,2018,3,21,Wednseday
1,8,21,29,2017,12,13,Wednseday
1,11,12,23,2017,6,5,Monday
3,17,9,26,2017,8,27,Sunday
5,11,23,34,2018,6,22,Friday
2,9,17,26,2018,4,18,Wednseday
1,17,14,31,2018,6,4,Monday
2,6,18,24,2018,8,18,Saturday
0,1,11,12,2018,3,14,Wednseday
1,11,33,44,2017,12,17,Sunday
3,5,12,17,2018,8,24,Friday
2,11,21,32,2017,12,16,Saturday
2,12,9,21,2018,2,28,Wednseday
4,12,15,27,2017,5,12,Friday
5,12,7,19,2018,5,3,Thursday
2,6,15,21,2018,6,27,Wednseday
7,13,16,29,2017,12,13,Wednseday
6,11,16,27,2018,6,22,Friday
0,13,6,19,2017,3,9,Thursday
14,31,6,37,2018,3,28,Wednseday
1,5,19,24,2017,3,5,Sunday
1,4,13,17,2017,12,11,Monday
3,10,18,28,2017,2,3,Friday
5,29,0,29,2017,11,2,Thursday
1,6,8,14,2018,8,9,Thursday
4,5,8,13,2017,7,28,Friday
1,13,10,23,2017,9,12,Tuesday
3,9,19,28,2017,12,12,Tuesday
2,14,10,24,2017,6,19,Monday
18,27,12,39,2018,1,13,Saturday
2,10,15,25,2018,7,28,Saturday
1,2,5,7,2018,7,30,Monday
1,10,16,26,2018,2,4,Sunday
2,37,-3,34,2018,1,20,Saturday
3,10,18,28,2018,1,19,Friday
2,10,26,36,2018,4,30,Monday
3,4,7,11,2018,3,4,Sunday
2,13,10,23,2017,6,27,Tuesday
1,9,17,26,2017,9,20,Wednseday
0,12,16,28,2017,10,19,Thursday
2,11,8,19,2018,4,5,Thursday
1,3,24,27,2017,7,11,Tuesday
22,26,24,50,2018,6,13,Wednseday
1,2,17,19,2018,6,27,Wednseday
2,11,21,32,2017,8,20,Sunday
1,10,6,16,2018,5,8,Tuesday
3,18,6,24,2018,3,30,Friday
1,2,2,4,2018,8,5,Sunday
6,13,8,21,2017,3,14,Tuesday
1,2,3,5,2018,8,8,Wednseday
5,11,24,35,2017,5,18,Thursday
5,98,-73,25,2017,11,17,Friday
4,26,-11,15,2018,1,22,Monday
4,24,29,53,2018,2,3,Saturday
2,16,12,28,2018,1,9,Tuesday
2,3,7,10,2018,6,19,Tuesday
3,6,12,18,2018,5,18,Friday
0,11,7,18,2017,10,13,Friday
5,11,17,28,2017,11,30,Thursday
3,13,15,28,2018,1,19,Friday
4,11,11,22,2017,7,6,Thursday
1,7,15,22,2017,11,23,Thursday
9,12,11,23,2018,7,15,Sunday
2,3,5,8,2018,8,5,Sunday
1,3,14,17,2018,3,11,Sunday
4,21,14,35,2017,10,6,Friday
1,10,7,17,2018,4,24,Tuesday
1,2,11,13,2018,2,28,Wednseday
1,8,18,26,2018,6,7,Thursday
5,14,32,46,2017,8,31,Thursday
5,12,14,26,2017,10,6,Friday
3,32,-12,20,2018,3,3,Saturday
5,26,12,38,2017,12,15,Friday
7,14,12,26,2018,1,10,Wednseday
5,12,15,27,2017,10,26,Thursday
5,8,19,27,2017,7,13,Thursday
2,24,2,26,2018,1,24,Wednseday
1,6,15,21,2018,8,16,Thursday
1,8,13,21,2017,3,13,Monday
1,19,7,26,2018,2,18,Sunday
0,11,32,43,2017,2,2,Thursday
5,6,16,22,2017,5,25,Thursday
1,6,14,20,2017,8,17,Thursday
4,12,15,27,2018,5,3,Thursday
4,10,14,24,2018,7,13,Friday
4,8,28,36,2017,12,7,Thursday
2,7,22,29,2017,3,14,Tuesday
1,9,14,23,2018,5,13,Sunday
3,11,10,21,2017,9,18,Monday
6,18,18,36,2017,10,5,Thursday
3,8,13,21,2018,3,20,Tuesday
2,4,8,12,2017,10,15,Sunday
2,8,8,16,2018,7,31,Tuesday
3,12,18,30,2017,5,28,Sunday
5,15,19,34,2018,3,21,Wednseday
4,6,7,13,2018,3,15,Thursday
3,11,22,33,2017,9,16,Saturday
0,5,8,13,2018,8,3,Friday
1,23,10,33,2017,7,16,Sunday
3,19,16,35,2018,4,23,Monday
4,13,7,20,2018,4,28,Saturday
8,17,20,37,2017,12,3,Sunday
5,30,-11,19,2018,3,4,Sunday
2,18,13,31,2017,8,6,Sunday
1,17,12,29,2018,6,14,Thursday
2,8,15,23,2018,8,6,Monday
4,17,13,30,2017,10,9,Monday
2,42,-19,23,2018,7,28,Saturday
0,10,0,10,2018,3,19,Monday
1,3,20,23,2017,5,8,Monday
7,13,11,24,2017,6,27,Tuesday
1,15,9,24,2018,3,20,Tuesday
13,26,6,32,2018,3,31,Saturday
4,6,14,20,2017,4,21,Friday
0,22,2,24,2018,6,19,Tuesday
1,30,13,43,2018,6,11,Monday
28,34,0,34,2017,11,30,Thursday
2,15,12,27,2017,2,1,Wednseday
1,14,4,18,2017,9,4,Monday
2,12,7,19,2017,11,12,Sunday
1,26,-3,23,2018,1,30,Tuesday
2,9,10,19,2017,10,18,Wednseday
2,3,13,16,2018,1,14,Sunday
1,6,14,20,2017,12,28,Thursday
2,17,2,19,2018,3,10,Saturday
6,16,17,33,2017,4,27,Thursday
2,3,10,13,2017,11,4,Saturday
4,10,9,19,2018,3,30,Friday
0,7,20,27,2017,2,1,Wednseday
25,34,-11,23,2018,2,13,Tuesday
1,13,10,23,2017,10,18,Wednseday
4,12,9,21,2018,6,8,Friday
1,15,19,34,2017,5,25,Thursday
8,14,21,35,2018,5,3,Thursday
1,5,14,19,2018,7,18,Wednseday
4,25,3,28,2017,11,23,Thursday
1,16,14,30,2018,2,20,Tuesday
1,19,11,30,2018,2,21,Wednseday
1,8,17,25,2017,9,21,Thursday
1,2,3,5,2018,8,2,Thursday
1,12,16,28,2017,5,11,Thursday
3,17,8,25,2017,8,19,Saturday
1,6,14,20,2017,11,21,Tuesday
1,7,12,19,2017,11,22,Wednseday
2,11,5,16,2018,7,10,Tuesday
1,4,25,29,2017,10,1,Sunday
1,7,20,27,2018,7,4,Wednseday
5,6,20,26,2018,5,30,Wednseday
2,10,18,28,2017,4,10,Monday
2,18,-6,12,2018,3,10,Saturday
1,7,18,25,2018,3,30,Friday
3,20,18,38,2017,3,31,Friday
5,6,6,12,2017,11,19,Sunday
3,9,13,22,2017,11,7,Tuesday
1,17,6,23,2017,6,18,Sunday
6,15,6,21,2018,3,13,Tuesday
1,2,9,11,2017,8,28,Monday
2,10,9,19,2017,7,30,Sunday
1,4,10,14,2017,11,9,Thursday
5,7,6,13,2018,7,5,Thursday
2,7,17,24,2017,7,15,Saturday
3,9,9,18,2017,7,24,Monday
4,19,15,34,2017,6,22,Thursday
18,31,-1,30,2018,7,22,Sunday
2,11,27,38,2018,8,11,Saturday
2,7,19,26,2017,5,24,Wednseday
3,9,24,33,2018,8,18,Saturday
5,14,20,34,2017,7,13,Thursday
4,13,13,26,2017,4,28,Friday
2,10,18,28,2017,10,30,Monday
2,15,7,22,2017,3,5,Sunday
2,3,12,15,2017,9,25,Monday
2,4,13,17,2018,7,8,Sunday
8,14,7,21,2017,5,3,Wednseday
1,9,16,25,2017,8,20,Sunday
4,10,18,28,2018,1,22,Monday
6,14,12,26,2017,11,10,Friday
11,17,3,20,2017,10,27,Friday
4,31,-5,26,2018,3,15,Thursday
1,6,7,13,2018,8,16,Thursday
6,10,24,34,2017,2,7,Tuesday
1,5,6,11,2018,8,5,Sunday
1,6,7,13,2018,3,28,Wednseday
2,7,16,23,2018,7,25,Wednseday
2,12,18,30,2018,7,15,Sunday
0,2,13,15,2017,7,20,Thursday
1,3,11,14,2017,11,13,Monday
2,18,4,22,2017,7,3,Monday
6,23,12,35,2017,10,17,Tuesday
0,8,13,21,2018,4,17,Tuesday
4,12,15,27,2017,10,20,Friday
1,13,14,27,2018,1,19,Friday
7,12,8,20,2017,9,27,Wednseday
4,15,11,26,2018,4,12,Thursday
1,10,3,13,2018,8,15,Wednseday
2,4,6,10,2018,6,10,Sunday
1,4,20,24,2018,7,1,Sunday
2,9,24,33,2018,7,4,Wednseday
1,7,21,28,2018,4,10,Tuesday
5,8,20,28,2018,6,21,Thursday
3,17,14,31,2018,1,23,Tuesday
3,18,13,31,2018,2,2,Friday
1,8,13,21,2018,1,18,Thursday
1,12,19,31,2017,12,4,Monday
0,3,5,8,2018,8,28,Tuesday
1,3,8,11,2018,4,2,Monday
2,18,2,20,2017,11,21,Tuesday
2,14,8,22,2018,2,20,Tuesday
2,5,21,26,2018,3,31,Saturday
3,14,9,23,2018,1,15,Monday
1,6,7,13,2017,8,16,Wednseday
1,11,12,23,2018,4,2,Monday
2,8,15,23,2017,11,5,Sunday
3,13,22,35,2017,8,25,Friday
2,6,18,24,2018,6,23,Saturday
2,6,6,12,2018,3,10,Saturday
14,66,-14,52,2018,1,26,Friday
0,25,7,32,2018,2,16,Friday
2,22,2,24,2017,9,16,Saturday
3,10,14,24,2017,7,14,Friday
5,8,10,18,2017,12,31,Sunday
2,12,2,14,2018,8,8,Wednseday
2,8,38,46,2018,6,10,Sunday
2,7,13,20,2018,5,9,Wednseday
1,7,28,35,2018,6,12,Tuesday
13,29,14,43,2018,8,1,Wednseday
1,12,22,34,2018,3,15,Thursday
1,12,21,33,2017,10,5,Thursday
2,10,7,17,2018,8,18,Saturday
1,7,19,26,2017,3,9,Thursday
4,18,14,32,2017,11,26,Sunday
1,3,26,29,2017,2,20,Monday
4,48,-15,33,2018,3,9,Friday
0,6,21,27,2018,5,8,Tuesday
1,9,13,22,2017,11,27,Monday
5,6,7,13,2018,6,22,Friday
2,9,8,17,2018,4,30,Monday
2,22,13,35,2017,5,31,Wednseday
1,7,27,34,2018,6,14,Thursday
1,8,18,26,2017,11,8,Wednseday
1,4,14,18,2017,5,22,Monday
1,5,17,22,2017,6,28,Wednseday
4,18,27,45,2018,4,20,Friday
1,3,0,3,2018,8,20,Monday
5,10,3,13,2018,8,3,Friday
2,13,19,32,2017,11,25,Saturday
2,11,20,31,2018,5,6,Sunday
6,19,9,28,2018,3,23,Friday
1,8,19,27,2018,6,14,Thursday
0,5,31,36,2018,6,21,Thursday
6,15,5,20,2017,7,4,Tuesday
0,3,7,10,2018,7,13,Friday
4,5,17,22,2018,5,10,Thursday
2,7,20,27,2017,10,3,Tuesday
2,11,22,33,2018,7,29,Sunday
3,11,15,26,2018,6,8,Friday
5,6,7,13,2018,7,7,Saturday
1,7,14,21,2017,3,20,Monday
1,14,17,31,2018,1,23,Tuesday
4,11,14,25,2018,7,13,Friday
2,16,19,35,2017,2,22,Wednseday
4,6,12,18,2017,11,30,Thursday
35,40,-19,21,2017,8,31,Thursday
3,9,24,33,2017,11,26,Sunday
3,7,13,20,2017,10,27,Friday
1,6,22,28,2017,9,13,Wednseday
1,5,3,8,2018,8,2,Thursday
1,3,4,7,2018,8,13,Monday
3,8,22,30,2017,9,23,Saturday
2,8,15,23,2017,6,14,Wednseday
4,6,20,26,2017,12,29,Friday
4,11,24,35,2018,3,30,Friday
11,24,14,38,2017,2,13,Monday
1,2,6,8,2018,5,9,Wednseday
2,2,29,31,2018,3,13,Tuesday
1,23,-2,21,2017,3,13,Monday
3,13,19,32,2018,6,23,Saturday
1,9,25,34,2017,12,26,Tuesday
2,4,9,13,2018,4,3,Tuesday
12,22,17,39,2018,4,12,Thursday
5,8,43,51,2016,10,5,Wednseday
1,3,9,12,2018,3,25,Sunday
2,6,2,8,2018,5,9,Wednseday
3,12,16,28,2018,4,20,Friday
3,10,16,26,2018,3,17,Saturday
1,21,7,28,2017,7,25,Tuesday
2,60,-27,33,2018,6,10,Sunday
3,19,9,28,2017,12,15,Friday
2,64,-35,29,2017,9,17,Sunday
3,4,10,14,2017,11,14,Tuesday
2,6,0,6,2018,8,8,Wednseday
8,12,7,19,2017,3,2,Thursday
1,16,17,33,2018,4,18,Wednseday
3,11,20,31,2017,7,23,Sunday
3,8,-1,7,2018,8,7,Tuesday
5,11,25,36,2017,12,28,Thursday
1,5,9,14,2018,7,25,Wednseday
3,13,16,29,2017,8,15,Tuesday
2,11,8,19,2018,3,17,Saturday
5,6,6,12,2018,8,8,Wednseday
2,8,8,16,2018,2,6,Tuesday
2,10,19,29,2017,8,21,Monday
0,11,5,16,2018,3,5,Monday
0,2,13,15,2018,7,11,Wednseday
6,26,-12,14,2018,2,8,Thursday
1,3,7,10,2018,7,9,Monday
2,27,8,35,2018,1,30,Tuesday
0,6,17,23,2018,5,16,Wednseday
9,15,3,18,2018,4,15,Sunday
1,14,17,31,2017,5,8,Monday
1,15,22,37,2017,6,4,Sunday
4,27,15,42,2017,2,10,Friday
6,13,12,25,2017,11,10,Friday
3,13,7,20,2017,5,16,Tuesday
2,15,6,21,2018,4,2,Monday
3,9,20,29,2018,3,25,Sunday
5,14,13,27,2017,4,5,Wednseday
1,2,11,13,2018,5,2,Wednseday
1,8,17,25,2018,4,26,Thursday
3,8,6,14,2018,3,26,Monday
2,4,13,17,2018,5,21,Monday
2,11,13,24,2017,5,20,Saturday
7,12,15,27,2017,3,29,Wednseday
7,13,10,23,2018,4,25,Wednseday
1,2,9,11,2018,3,26,Monday
4,7,31,38,2017,1,23,Monday
5,12,14,26,2017,6,28,Wednseday
4,17,4,21,2018,8,3,Friday
2,7,26,33,2017,12,10,Sunday
1,5,28,33,2017,3,30,Thursday
4,46,-27,19,2018,3,2,Friday
9,15,11,26,2017,5,21,Sunday
6,10,21,31,2017,9,23,Saturday
3,21,13,34,2018,1,19,Friday
6,12,8,20,2017,7,1,Saturday
5,12,33,45,2017,1,14,Saturday
0,5,54,59,2018,6,4,Monday
1,13,17,30,2017,10,29,Sunday
2,8,9,17,2017,10,9,Monday
3,15,10,25,2018,5,25,Friday
13,14,-2,12,2018,8,15,Wednseday
0,10,12,22,2018,4,10,Tuesday
4,8,20,28,2017,7,7,Friday
1,9,20,29,2017,10,1,Sunday
5,15,16,31,2018,2,11,Sunday
1,2,15,17,2018,4,16,Monday
4,17,10,27,2017,11,24,Friday
3,5,23,28,2017,10,20,Friday
2,16,13,29,2018,8,12,Sunday
2,14,21,35,2018,6,26,Tuesday
6,9,4,13,2017,7,22,Saturday
2,4,19,23,2017,8,26,Saturday
8,9,3,12,2017,5,28,Sunday
4,9,6,15,2017,9,21,Thursday
1,9,14,23,2017,7,30,Sunday
4,7,8,15,2018,6,18,Monday
1,7,16,23,2017,8,16,Wednseday
0,7,22,29,2018,7,17,Tuesday
1,5,38,43,2018,4,4,Wednseday
1,4,4,8,2018,5,3,Thursday
9,17,21,38,2017,4,18,Tuesday
2,24,11,35,2018,2,5,Monday
6,20,17,37,2017,8,12,Saturday
1,15,31,46,2018,6,3,Sunday
2,8,22,30,2017,8,16,Wednseday
1,11,12,23,2017,11,13,Monday
2,10,6,16,2018,4,2,Monday
2,11,15,26,2018,6,16,Saturday
4,19,10,29,2017,11,27,Monday
1,8,2,10,2018,8,19,Sunday
2,20,9,29,2018,1,31,Wednseday
1,10,19,29,2017,12,18,Monday
2,7,15,22,2017,9,26,Tuesday
3,9,0,9,2018,8,4,Saturday
1,7,21,28,2018,1,23,Tuesday
1,16,3,19,2018,5,17,Thursday
1,3,5,8,2018,7,23,Monday
3,27,1,28,2018,1,26,Friday
7,14,9,23,2017,6,5,Monday
6,17,4,21,2017,11,24,Friday
3,11,22,33,2017,8,18,Friday
0,1,14,15,2018,4,23,Monday
2,3,18,21,2018,4,23,Monday
1,3,17,20,2017,11,3,Friday
0,3,11,14,2018,7,24,Tuesday
4,11,16,27,2018,3,31,Saturday
5,10,17,27,2017,5,24,Wednseday
1,4,31,35,2018,8,20,Monday
2,4,9,13,2017,7,29,Saturday
1,13,15,28,2018,4,4,Wednseday
2,21,-3,18,2017,11,27,Monday
5,17,9,26,2018,3,3,Saturday
7,20,20,40,2018,6,15,Friday
2,13,18,31,2018,4,21,Saturday
1,10,15,25,2017,12,10,Sunday
3,5,13,18,2018,4,23,Monday
15,25,30,55,2016,10,6,Thursday
0,6,20,26,2018,4,11,Wednseday
3,8,17,25,2017,11,25,Saturday
1,7,12,19,2017,3,2,Thursday
0,7,15,22,2017,10,16,Monday
2,18,0,18,2018,3,4,Sunday
8,13,1,14,2017,6,15,Thursday
0,6,7,13,2018,3,23,Friday
1,6,14,20,2017,7,4,Tuesday
2,5,8,13,2018,3,21,Wednseday
1,9,14,23,2017,8,22,Tuesday
2,8,16,24,2017,10,29,Sunday
2,9,12,21,2017,3,13,Monday
3,14,13,27,2018,1,26,Friday
2,12,41,53,2018,6,2,Saturday
1,7,18,25,2017,2,6,Monday
5,10,20,30,2017,8,27,Sunday
1,8,13,21,2018,8,2,Thursday
1,3,11,14,2018,5,7,Monday
2,8,8,16,2018,3,21,Wednseday
5,6,10,16,2018,2,10,Saturday
1,8,12,20,2017,11,9,Thursday
1,6,14,20,2017,7,18,Tuesday
4,6,20,26,2017,4,22,Saturday
4,5,14,19,2018,1,11,Thursday
0,2,1,3,2018,8,14,Tuesday
4,5,20,25,2017,12,15,Friday
3,20,19,39,2017,6,2,Friday
6,9,4,13,2018,4,7,Saturday
2,6,17,23,2017,8,1,Tuesday
2,11,12,23,2017,9,26,Tuesday
8,17,15,32,2018,2,18,Sunday
2,6,5,11,2018,5,10,Thursday
1,6,7,13,2018,7,5,Thursday
4,17,11,28,2018,3,30,Friday
4,7,18,25,2018,6,28,Thursday
2,25,-4,21,2018,3,26,Monday
1,12,17,29,2018,5,31,Thursday
3,4,1,5,2018,8,17,Friday
1,12,10,22,2017,7,17,Monday
0,4,19,23,2017,8,21,Monday
4,16,28,44,2017,1,15,Sunday
2,6,15,21,2018,6,12,Tuesday
1,5,12,17,2017,3,14,Tuesday
2,8,15,23,2018,1,23,Tuesday
3,16,7,23,2018,3,4,Sunday
2,15,24,39,2017,5,28,Sunday
2,10,14,24,2018,4,23,Monday
1,6,20,26,2018,6,21,Thursday
2,4,15,19,2017,10,21,Saturday
1,4,10,14,2017,6,12,Monday
2,12,28,40,2017,6,7,Wednseday
1,8,14,22,2017,8,3,Thursday
2,5,12,17,2018,8,5,Sunday
0,6,8,14,2018,7,17,Tuesday
0,5,25,30,2018,6,25,Monday
23,25,-16,9,2018,7,29,Sunday
3,5,7,12,2018,3,16,Friday
1,9,38,47,2018,6,7,Thursday
1,2,14,16,2018,1,14,Sunday
3,10,10,20,2017,9,1,Friday
4,15,20,35,2018,1,4,Thursday
1,8,14,22,2018,7,16,Monday
2,9,12,21,2018,5,2,Wednseday
3,4,14,18,2017,12,1,Friday
3,12,13,25,2017,9,22,Friday
1,44,-19,25,2017,1,26,Thursday
18,45,-4,41,2017,11,23,Thursday
8,10,6,16,2017,12,4,Monday
1,8,21,29,2018,8,13,Monday
6,64,-42,22,2017,7,18,Tuesday
4,14,16,30,2017,11,27,Monday
1,19,4,23,2017,11,8,Wednseday
3,7,14,21,2018,6,29,Friday
5,10,14,24,2018,3,17,Saturday
5,32,-6,26,2017,12,15,Friday
2,7,11,18,2017,5,15,Monday
1,18,2,20,2018,2,21,Wednseday
1,7,9,16,2018,5,16,Wednseday
0,8,20,28,2018,8,16,Thursday
2,11,12,23,2018,4,7,Saturday
1,3,20,23,2017,10,3,Tuesday
1,16,16,32,2018,4,8,Sunday
4,8,19,27,2017,9,7,Thursday
1,5,10,15,2018,7,18,Wednseday
1,10,14,24,2018,1,8,Monday
5,8,4,12,2018,8,17,Friday
8,20,6,26,2018,3,1,Thursday
1,7,8,15,2018,4,25,Wednseday
1,13,22,35,2018,1,16,Tuesday
6,28,1,29,2018,1,31,Wednseday
6,11,2,13,2018,3,29,Thursday
2,5,26,31,2018,8,5,Sunday
3,7,14,21,2018,5,1,Tuesday
3,13,28,41,2017,1,17,Tuesday
3,10,18,28,2017,12,1,Friday
0,5,14,19,2018,7,25,Wednseday
0,30,-2,28,2018,6,6,Wednseday
7,23,0,23,2017,10,9,Monday
2,22,8,30,2018,4,22,Sunday
2,26,5,31,2018,7,8,Sunday
1,9,8,17,2017,10,9,Monday
1,7,16,23,2017,6,12,Monday
1,4,13,17,2018,8,26,Sunday
0,3,32,35,2018,7,2,Monday
1,6,30,36,2018,6,10,Sunday
7,10,9,19,2018,4,20,Friday
3,12,28,40,2017,9,24,Sunday
1,6,17,23,2017,6,18,Sunday
2,4,10,14,2017,6,14,Wednseday
17,27,7,34,2017,3,21,Tuesday
1,6,14,20,2017,3,30,Thursday
0,28,4,32,2017,12,11,Monday
5,6,7,13,2017,6,23,Friday
2,8,3,11,2018,8,19,Sunday
1,12,18,30,2018,1,3,Wednseday
2,6,10,16,2018,2,24,Saturday
1,51,-28,23,2017,7,19,Wednseday
7,13,3,16,2018,8,7,Tuesday
9,37,-13,24,2018,5,5,Saturday
1,14,22,36,2018,3,6,Tuesday
9,16,19,35,2017,2,13,Monday
1,15,12,27,2018,5,10,Thursday
6,8,4,12,2018,3,8,Thursday
4,12,13,25,2018,3,9,Friday
3,29,31,60,2018,3,12,Monday
4,11,2,13,2018,3,29,Thursday
13,22,5,27,2018,2,20,Tuesday
1,19,14,33,2018,5,20,Sunday
4,14,21,35,2017,8,10,Thursday
5,21,5,26,2018,5,18,Friday
4,19,7,26,2018,3,30,Friday
1,8,20,28,2017,4,10,Monday
1,8,19,27,2017,12,19,Tuesday
1,8,14,22,2018,3,19,Monday
6,9,18,27,2017,5,31,Wednseday
3,8,12,20,2017,8,11,Friday
1,15,8,23,2017,11,29,Wednseday
0,6,8,14,2018,7,27,Friday
10,41,-3,38,2018,1,19,Friday
1,5,36,41,2018,7,4,Wednseday
2,9,15,24,2017,10,16,Monday
3,5,0,5,2018,8,3,Friday
1,4,14,18,2018,8,9,Thursday
1,3,20,23,2018,1,24,Wednseday
2,16,13,29,2017,11,2,Thursday
2,3,10,13,2018,6,16,Saturday
6,17,17,34,2018,1,31,Wednseday
4,11,20,31,2017,7,30,Sunday
1,5,18,23,2017,8,16,Wednseday
3,20,14,34,2017,7,8,Saturday
1,11,21,32,2017,12,3,Sunday
6,14,21,35,2017,4,28,Friday
6,7,5,12,2018,7,26,Thursday
0,6,19,25,2018,4,19,Thursday
3,25,8,33,2018,3,17,Saturday
0,1,14,15,2017,9,20,Wednseday
2,12,26,38,2018,4,7,Saturday
7,12,17,29,2018,6,27,Wednseday
2,9,14,23,2017,10,14,Saturday
2,14,9,23,2017,6,7,Wednseday
4,7,18,25,2017,7,7,Friday
7,16,20,36,2018,5,28,Monday
1,6,14,20,2018,7,4,Wednseday
3,7,17,24,2017,8,4,Friday
4,22,10,32,2017,7,24,Monday
4,11,22,33,2018,6,2,Saturday
3,4,14,18,2017,10,6,Friday
1,18,11,29,2018,1,22,Monday
2,17,10,27,2018,6,27,Wednseday
7,13,5,18,2018,2,2,Friday
1,4,5,9,2018,7,29,Sunday
2,19,19,38,2017,11,5,Sunday
4,5,1,6,2018,8,23,Thursday
2,6,6,12,2018,6,13,Wednseday
2,29,-14,15,2018,1,22,Monday
2,12,26,38,2017,4,25,Tuesday
5,17,6,23,2017,11,25,Saturday
1,23,5,28,2018,2,6,Tuesday
2,9,13,22,2017,6,28,Wednseday
0,1,7,8,2018,5,10,Thursday
1,24,6,30,2017,9,20,Wednseday
1,7,27,34,2018,6,21,Thursday
0,10,31,41,2018,6,6,Wednseday
4,13,13,26,2017,10,26,Thursday
2,11,14,25,2017,6,26,Monday
2,8,13,21,2017,6,14,Wednseday
1,2,11,13,2018,3,21,Wednseday
1,15,2,17,2018,5,7,Monday
3,24,12,36,2018,1,16,Tuesday
2,3,21,24,2018,1,8,Monday
1,11,15,26,2017,9,14,Thursday
1,9,10,19,2018,8,2,Thursday
1,52,-27,25,2017,12,11,Monday
1,7,15,22,2017,8,2,Wednseday
3,4,13,17,2018,5,5,Saturday
0,14,14,28,2017,6,28,Wednseday
3,5,10,15,2018,7,1,Sunday
2,8,38,46,2017,7,3,Monday
2,11,28,39,2018,1,7,Sunday
3,6,14,20,2018,6,15,Friday
2,11,17,28,2017,11,28,Tuesday
6,13,22,35,2017,8,11,Friday
1,4,11,15,2018,8,7,Tuesday
1,6,5,11,2018,8,2,Thursday
2,7,14,21,2018,2,14,Wednseday
18,23,31,54,2016,10,9,Sunday
2,11,13,24,2017,11,12,Sunday
2,5,11,16,2018,8,18,Saturday
4,11,14,25,2017,8,24,Thursday
1,9,10,19,2018,4,29,Sunday
7,26,1,27,2017,4,18,Tuesday
1,23,-3,20,2018,7,17,Tuesday
3,35,-13,22,2017,5,15,Monday
2,10,15,25,2018,7,2,Monday
4,33,1,34,2018,3,15,Thursday
1,11,8,19,2017,9,14,Thursday
3,5,16,21,2018,5,4,Friday
1,5,25,30,2018,4,22,Sunday
1,4,9,13,2017,8,31,Thursday
2,5,13,18,2017,8,27,Sunday
1,7,20,27,2017,2,22,Wednseday
4,21,4,25,2018,2,16,Friday
4,88,-67,21,2018,1,18,Thursday
2,20,6,26,2018,4,25,Wednseday
4,16,3,19,2018,5,6,Sunday
4,18,13,31,2017,11,3,Friday
3,17,10,27,2018,1,13,Saturday
3,6,10,16,2018,7,21,Saturday
4,13,8,21,2018,3,30,Friday
3,7,18,25,2018,7,20,Friday
1,10,17,27,2018,4,6,Friday
1,2,7,9,2018,7,9,Monday
2,5,8,13,2017,11,1,Wednseday
1,9,18,27,2018,6,27,Wednseday
5,12,12,24,2017,10,8,Sunday
2,20,9,29,2018,1,17,Wednseday
1,18,2,20,2017,11,24,Friday
1,7,12,19,2018,5,2,Wednseday
8,22,2,24,2018,1,15,Monday
1,6,7,13,2017,7,27,Thursday
10,16,15,31,2017,4,1,Saturday
2,14,6,20,2017,7,13,Thursday
3,25,0,25,2017,11,27,Monday
2,17,7,24,2017,2,5,Sunday
2,17,16,33,2017,11,5,Sunday
2,14,11,25,2018,2,26,Monday
2,40,-15,25,2018,1,13,Saturday
6,22,5,27,2017,11,22,Wednseday
2,5,3,8,2018,5,16,Wednseday
4,7,21,28,2018,6,29,Friday
2,7,7,14,2017,11,28,Tuesday
1,7,27,34,2018,2,20,Tuesday
9,13,10,23,2018,4,3,Tuesday
2,5,23,28,2018,6,6,Wednseday
2,6,6,12,2018,8,19,Sunday
2,6,18,24,2017,7,11,Tuesday
1,17,9,26,2017,8,30,Wednseday
7,14,16,30,2017,5,2,Tuesday
2,5,10,15,2018,1,22,Monday
1,8,12,20,2018,2,15,Thursday
3,12,14,26,2017,8,4,Friday
1,9,22,31,2017,10,23,Monday
7,14,12,26,2017,6,9,Friday
3,14,13,27,2017,6,10,Saturday
2,7,15,22,2018,6,26,Tuesday
2,14,16,30,2018,5,14,Monday
1,5,8,13,2017,8,31,Thursday
1,6,17,23,2017,6,13,Tuesday
3,6,19,25,2018,8,17,Friday
1,16,4,20,2017,11,23,Thursday
3,4,3,7,2018,8,10,Friday
1,8,13,21,2017,4,24,Monday
3,10,13,23,2017,5,6,Saturday
18,25,1,26,2018,2,23,Friday
2,13,10,23,2018,3,10,Saturday
1,6,17,23,2017,5,30,Tuesday
1,6,15,21,2017,9,12,Tuesday
5,12,11,23,2018,1,10,Wednseday
1,4,10,14,2018,7,23,Monday
4,19,10,29,2018,2,1,Thursday
1,4,15,19,2018,4,22,Sunday
1,4,23,27,2017,11,23,Thursday
2,3,8,11,2018,7,8,Sunday
4,30,-6,24,2018,3,19,Monday
3,8,31,39,2018,6,8,Friday
21,26,-1,25,2018,3,15,Thursday
3,19,11,30,2017,12,23,Saturday
5,10,15,25,2017,9,3,Sunday
2,11,11,22,2017,11,20,Monday
4,8,23,31,2018,4,16,Monday
2,9,4,13,2018,8,8,Wednseday
5,8,12,20,2018,2,21,Wednseday
13,18,9,27,2018,7,27,Friday
1,8,13,21,2018,7,17,Tuesday
4,5,12,17,2018,1,7,Sunday
1,33,-15,18,2018,3,8,Thursday
4,9,17,26,2018,4,14,Saturday
4,10,18,28,2018,5,11,Friday
2,8,12,20,2018,2,28,Wednseday
6,12,16,28,2017,11,29,Wednseday
2,3,5,8,2018,8,13,Monday
3,7,5,12,2018,8,3,Friday
3,16,24,40,2018,4,4,Wednseday
3,14,14,28,2018,7,9,Monday
1,4,18,22,2018,6,24,Sunday
0,6,7,13,2018,5,8,Tuesday
2,24,-6,18,2018,6,11,Monday
6,9,44,53,2016,10,8,Saturday
9,11,-2,9,2018,8,5,Sunday
1,4,13,17,2018,2,4,Sunday
3,27,8,35,2017,6,2,Friday
2,8,19,27,2017,11,21,Tuesday
2,3,7,10,2018,4,3,Tuesday
8,19,9,28,2017,7,13,Thursday
1,10,13,23,2018,4,1,Sunday
3,18,20,38,2018,2,3,Saturday
2,10,14,24,2017,10,28,Saturday
1,3,26,29,2018,1,22,Monday
2,7,14,21,2018,5,9,Wednseday
1,20,9,29,2017,11,29,Wednseday
8,15,20,35,2018,6,12,Tuesday
1,14,6,20,2018,2,28,Wednseday
2,2,11,13,2018,3,21,Wednseday
1,9,15,24,2018,4,23,Monday
2,7,21,28,2018,7,4,Wednseday
1,8,27,35,2017,6,15,Thursday
1,9,14,23,2018,8,1,Wednseday
1,6,22,28,2018,4,17,Tuesday
3,23,18,41,2018,6,5,Tuesday
2,6,16,22,2018,1,17,Wednseday
1,11,18,29,2017,12,11,Monday
3,6,1,7,2018,7,31,Tuesday
2,21,12,33,2018,5,16,Wednseday
1,8,12,20,2017,5,10,Wednseday
3,12,11,23,2017,4,15,Saturday
12,21,19,40,2017,4,29,Saturday
1,23,0,23,2017,12,4,Monday
5,13,14,27,2017,11,30,Thursday
4,14,21,35,2017,5,12,Friday
4,11,10,21,2018,1,19,Friday
4,5,10,15,2018,2,11,Sunday
3,7,19,26,2018,6,15,Friday
4,11,15,26,2017,7,13,Thursday
1,9,14,23,2018,1,8,Monday
2,5,29,34,2018,1,6,Saturday
1,2,7,9,2018,6,12,Tuesday
2,4,6,10,2018,6,25,Monday
4,13,12,25,2017,8,18,Friday
5,11,18,29,2017,7,23,Sunday
5,12,26,38,2017,4,8,Saturday
1,8,1,9,2018,8,6,Monday
6,19,10,29,2017,5,31,Wednseday
2,4,12,16,2018,8,20,Monday
1,20,17,37,2017,12,18,Monday
1,8,15,23,2018,4,24,Tuesday
2,6,17,23,2018,1,24,Wednseday
1,4,19,23,2018,5,29,Tuesday
7,37,-8,29,2017,12,6,Wednseday
6,11,3,14,2018,5,15,Tuesday
3,11,10,21,2018,5,4,Friday
1,6,27,33,2018,6,21,Thursday
3,5,12,17,2018,5,18,Friday
1,14,15,29,2017,5,8,Monday
5,21,4,25,2017,5,4,Thursday
1,8,9,17,2017,10,9,Monday
1,8,13,21,2017,9,13,Wednseday
0,8,20,28,2018,4,11,Wednseday
4,6,7,13,2018,8,9,Thursday
10,38,0,38,2017,12,24,Sunday
4,8,20,28,2017,12,14,Thursday
1,7,10,17,2017,10,31,Tuesday
1,11,19,30,2018,4,15,Sunday
1,17,13,30,2017,3,20,Monday
1,8,11,19,2018,7,25,Wednseday
1,14,9,23,2018,1,24,Wednseday
2,12,19,31,2017,2,18,Saturday
1,9,8,17,2017,9,18,Monday
3,12,11,23,2017,11,11,Saturday
3,18,7,25,2017,11,25,Saturday
1,9,14,23,2018,3,18,Sunday
0,1,16,17,2017,12,12,Tuesday
1,6,38,44,2018,6,5,Tuesday
6,17,15,32,2017,3,17,Friday
3,10,9,19,2017,7,2,Sunday
3,19,2,21,2017,11,24,Friday
6,19,14,33,2017,11,24,Friday
1,8,13,21,2017,5,3,Wednseday
1,8,35,43,2018,1,3,Wednseday
1,2,1,3,2018,8,7,Tuesday
3,9,7,16,2018,1,8,Monday
3,39,-18,21,2018,7,20,Friday
1,2,19,21,2018,1,16,Tuesday
2,4,10,14,2018,2,22,Thursday
4,12,6,18,2018,3,1,Thursday
3,11,14,25,2018,5,5,Saturday
2,13,14,27,2018,6,26,Tuesday
1,4,14,18,2018,7,2,Monday
1,33,-11,22,2018,3,25,Sunday
1,11,18,29,2017,3,9,Thursday
0,4,19,23,2017,3,20,Monday
2,6,15,21,2018,7,17,Tuesday
4,5,8,13,2017,10,12,Thursday
1,15,6,21,2017,3,14,Tuesday
9,15,9,24,2017,12,3,Sunday
0,4,6,10,2018,8,13,Monday
1,3,12,15,2018,1,23,Tuesday
2,7,1,8,2018,8,7,Tuesday
1,8,16,24,2017,3,27,Monday
3,21,9,30,2018,3,5,Monday
2,16,19,35,2017,8,23,Wednseday
20,24,0,24,2017,4,14,Friday
6,8,10,18,2018,2,16,Friday
1,6,21,27,2018,5,1,Tuesday
0,7,3,10,2018,7,31,Tuesday
1,8,12,20,2017,10,24,Tuesday
2,10,14,24,2017,7,1,Saturday
1,6,10,16,2018,8,5,Sunday
4,12,13,25,2017,11,24,Friday
3,15,7,22,2017,11,26,Sunday
4,7,11,18,2017,9,15,Friday
1,6,10,16,2018,4,10,Tuesday
2,12,13,25,2017,8,6,Sunday
2,12,15,27,2018,1,13,Saturday
4,5,8,13,2017,8,17,Thursday
2,18,-1,17,2017,5,14,Sunday
0,15,18,33,2017,6,9,Friday
0,20,0,20,2017,11,24,Friday
5,11,16,27,2018,4,12,Thursday
1,9,15,24,2018,1,16,Tuesday
3,17,8,25,2018,3,9,Friday
3,13,10,23,2017,9,16,Saturday
4,13,14,27,2018,4,28,Saturday
2,12,22,34,2018,5,2,Wednseday
1,5,34,39,2018,6,3,Sunday
4,17,20,37,2018,2,17,Saturday
0,8,14,22,2018,4,18,Wednseday
8,24,0,24,2018,3,12,Monday
3,15,5,20,2018,5,22,Tuesday
1,10,7,17,2018,1,1,Monday
1,8,20,28,2018,1,22,Monday
6,19,6,25,2017,10,13,Friday
7,18,8,26,2017,7,21,Friday
1,11,12,23,2017,6,18,Sunday
2,12,10,22,2017,4,23,Sunday
1,14,2,16,2018,3,6,Tuesday
2,3,12,15,2017,11,26,Sunday
5,11,9,20,2017,11,25,Saturday
6,15,41,56,2017,1,24,Tuesday
2,22,-7,15,2018,5,15,Tuesday
2,9,29,38,2017,3,27,Monday
2,10,23,33,2017,6,25,Sunday
0,1,11,12,2017,10,18,Wednseday
4,5,11,16,2018,6,4,Monday
4,6,11,17,2017,11,24,Friday
6,15,5,20,2017,11,24,Friday
3,53,-28,25,2018,2,19,Monday
2,9,16,25,2017,6,10,Saturday
3,9,15,24,2018,5,1,Tuesday
2,21,14,35,2017,5,29,Monday
1,9,15,24,2018,5,6,Sunday
15,23,-1,22,2018,2,20,Tuesday
0,19,13,32,2018,4,19,Thursday
9,26,0,26,2018,1,13,Saturday
8,19,20,39,2017,2,13,Monday
1,7,14,21,2017,4,25,Tuesday
7,9,12,21,2018,5,14,Monday
4,45,-25,20,2017,11,24,Friday
3,5,9,14,2018,5,18,Friday
3,13,7,20,2017,6,20,Tuesday
5,9,7,16,2018,7,25,Wednseday
2,5,16,21,2018,7,23,Monday
0,7,25,32,2017,12,11,Monday
0,7,16,23,2017,3,27,Monday
6,14,9,23,2018,3,6,Tuesday
5,16,16,32,2018,7,15,Sunday
3,16,16,32,2018,1,13,Saturday
6,17,4,21,2017,12,22,Friday
2,9,23,32,2018,6,16,Saturday
2,3,8,11,2018,7,8,Sunday
5,12,9,21,2018,8,16,Thursday
1,8,17,25,2017,3,19,Sunday
0,10,18,28,2017,9,22,Friday
1,27,-2,25,2018,2,15,Thursday
0,6,14,20,2018,5,15,Tuesday
1,2,10,12,2017,9,13,Wednseday
2,5,14,19,2017,7,2,Sunday
0,2,14,16,2017,9,19,Tuesday
2,10,9,19,2018,7,1,Sunday
1,24,13,37,2017,12,17,Sunday
2,10,16,26,2018,7,1,Sunday
2,18,8,26,2017,11,5,Sunday
1,18,6,24,2018,1,8,Monday
5,11,20,31,2017,12,15,Friday
3,5,22,27,2018,7,6,Friday
3,14,9,23,2017,5,30,Tuesday
3,19,12,31,2018,1,5,Friday
3,31,-6,25,2018,2,11,Sunday
1,16,20,36,2017,4,16,Sunday
8,23,11,34,2018,2,6,Tuesday
4,10,15,25,2017,11,13,Monday
2,3,5,8,2018,5,21,Monday
4,17,9,26,2018,3,9,Friday
2,12,26,38,2018,4,14,Saturday
3,34,0,34,2017,7,11,Tuesday
3,16,8,24,2018,2,17,Saturday
8,13,-4,9,2018,4,25,Wednseday
0,1,19,20,2018,5,16,Wednseday
1,19,15,34,2018,6,14,Thursday
8,14,11,25,2018,4,12,Thursday
2,23,5,28,2018,5,1,Tuesday
1,4,10,14,2018,2,26,Monday
1,5,22,27,2017,8,30,Wednseday
0,2,12,14,2018,7,24,Tuesday
1,2,4,6,2018,8,28,Tuesday
5,12,22,34,2018,5,30,Wednseday
3,11,12,23,2017,4,17,Monday
2,8,15,23,2017,8,13,Sunday
1,2,6,8,2018,7,12,Thursday
6,11,-8,3,2018,8,7,Tuesday
2,17,14,31,2017,12,17,Sunday
1,12,10,22,2018,3,22,Thursday
4,6,14,20,2017,11,3,Friday
0,5,22,27,2018,4,13,Friday
1,8,21,29,2018,1,22,Monday
1,3,6,9,2018,7,9,Monday
4,10,16,26,2018,2,23,Friday
1,7,2,9,2018,8,6,Monday
4,14,13,27,2017,6,9,Friday
0,3,7,10,2018,5,4,Friday
1,7,25,32,2018,7,26,Thursday
3,42,-15,27,2017,12,16,Saturday
6,19,12,31,2018,2,10,Saturday
3,10,23,33,2018,7,13,Friday
3,6,2,8,2017,5,9,Tuesday
22,31,-5,26,2017,11,15,Wednseday
1,5,12,17,2017,9,17,Sunday
2,10,16,26,2018,4,22,Sunday
2,9,13,22,2017,5,22,Monday
1,5,9,14,2018,7,25,Wednseday
3,17,13,30,2018,1,6,Saturday
0,5,16,21,2017,8,24,Thursday
1,10,24,34,2017,7,18,Tuesday
2,5,19,24,2017,10,21,Saturday
4,12,15,27,2018,2,10,Saturday
3,18,29,47,2018,3,9,Friday
2,18,18,36,2017,11,28,Tuesday
1,14,17,31,2018,2,5,Monday
9,21,1,22,2017,5,1,Monday
4,13,14,27,2018,4,12,Thursday
1,9,17,26,2017,12,3,Sunday
4,33,-7,26,2018,4,22,Sunday
0,9,8,17,2017,4,25,Tuesday
1,2,15,17,2018,4,3,Tuesday
2,5,10,15,2018,4,25,Wednseday
1,24,12,36,2017,12,10,Sunday
2,11,4,15,2018,1,15,Monday
2,17,8,25,2017,11,27,Monday
2,5,18,23,2017,5,27,Saturday
16,20,14,34,2018,7,21,Saturday
1,12,10,22,2018,2,15,Thursday
7,14,16,30,2018,4,16,Monday
1,11,16,27,2018,5,3,Thursday
8,17,4,21,2017,11,27,Monday
5,15,11,26,2017,12,7,Thursday
5,19,19,38,2017,2,12,Sunday
3,6,16,22,2017,9,3,Sunday
1,8,27,35,2017,5,24,Wednseday
4,15,17,32,2018,4,1,Sunday
29,45,-9,36,2017,9,4,Monday
5,18,3,21,2017,11,9,Thursday
9,13,0,13,2018,4,25,Wednseday
0,22,19,41,2017,4,13,Thursday
1,2,12,14,2018,7,2,Monday
4,9,7,16,2018,8,18,Saturday
8,11,3,14,2017,11,2,Thursday
2,4,21,25,2018,1,20,Saturday
15,20,13,33,2017,4,20,Thursday
1,4,25,29,2018,4,22,Sunday
1,10,27,37,2017,6,19,Monday
2,9,12,21,2017,11,20,Monday
1,22,3,25,2017,11,23,Thursday
1,6,16,22,2017,7,18,Tuesday
1,5,2,7,2018,8,8,Wednseday
2,8,12,20,2017,9,19,Tuesday
2,10,14,24,2017,6,17,Saturday
1,13,26,39,2017,2,2,Thursday
7,8,9,17,2018,6,26,Tuesday
2,12,30,42,2018,6,6,Wednseday
4,20,1,21,2017,3,2,Thursday
1,3,12,15,2018,1,15,Monday
5,11,15,26,2017,12,1,Friday
3,18,15,33,2017,4,14,Friday
3,10,17,27,2017,9,23,Saturday
2,15,15,30,2017,11,7,Tuesday
2,7,30,37,2017,7,19,Wednseday
3,26,5,31,2017,12,8,Friday
1,4,11,15,2018,2,15,Thursday
2,10,11,21,2017,10,24,Tuesday
5,6,14,20,2017,12,9,Saturday
1,2,2,4,2018,8,27,Monday
4,13,14,27,2018,2,10,Saturday
2,14,14,28,2018,2,28,Wednseday
2,10,14,24,2017,11,25,Saturday
0,10,19,29,2018,2,27,Tuesday
3,7,9,16,2018,3,12,Monday
2,7,14,21,2017,11,2,Thursday
6,11,10,21,2018,8,16,Thursday
3,5,18,23,2017,5,14,Sunday
2,6,9,15,2018,5,8,Tuesday
1,15,20,35,2017,12,18,Monday
7,14,27,41,2017,2,10,Friday
4,13,16,29,2018,4,5,Thursday
0,6,11,17,2018,7,20,Friday
1,8,13,21,2017,3,14,Tuesday
3,11,16,27,2017,3,24,Friday
2,22,18,40,2018,4,18,Wednseday
10,17,17,34,2018,3,10,Saturday
2,9,13,22,2017,7,12,Wednseday
2,18,12,30,2018,3,18,Sunday
3,6,18,24,2017,3,24,Friday
4,25,-5,20,2017,4,21,Friday
1,5,7,12,2017,8,13,Sunday
1,2,22,24,2018,6,4,Monday
2,10,12,22,2018,3,25,Sunday
3,16,6,22,2017,3,27,Monday
1,3,12,15,2018,5,15,Tuesday
1,22,14,36,2018,5,17,Thursday
1,4,16,20,2018,4,24,Tuesday
2,7,17,24,2017,4,10,Monday
1,20,10,30,2017,4,26,Wednseday
2,8,31,39,2018,4,30,Monday
0,1,13,14,2017,11,24,Friday
1,2,9,11,2017,5,29,Monday
2,5,14,19,2018,5,30,Wednseday
1,9,16,25,2017,10,2,Monday
5,9,20,29,2017,2,8,Wednseday
5,19,8,27,2017,11,24,Friday
1,8,18,26,2018,8,2,Thursday
4,10,5,15,2017,11,12,Sunday
1,12,9,21,2017,11,22,Wednseday
1,6,17,23,2017,9,5,Tuesday
2,8,13,21,2018,7,23,Monday
3,16,7,23,2017,10,2,Monday
3,21,0,21,2018,6,12,Tuesday
2,31,-1,30,2017,12,9,Saturday
2,10,30,40,2018,3,10,Saturday
0,11,22,33,2017,6,29,Thursday
5,23,3,26,2017,12,31,Sunday
3,17,23,40,2017,5,14,Sunday
8,11,8,19,2017,11,26,Sunday
7,16,17,33,2018,3,28,Wednseday
6,12,7,19,2017,3,3,Friday
21,29,-9,20,2017,11,28,Tuesday
8,9,-1,8,2017,5,9,Tuesday
1,33,-8,25,2017,12,3,Sunday
0,2,13,15,2018,1,24,Wednseday
6,11,8,19,2018,3,17,Saturday
1,32,-11,21,2017,4,24,Monday
3,59,-18,41,2017,1,14,Saturday
2,10,7,17,2018,5,5,Saturday
5,9,17,26,2018,4,18,Wednseday
3,10,14,24,2018,7,22,Sunday
1,12,16,28,2018,6,13,Wednseday
5,9,21,30,2017,3,8,Wednseday
0,8,13,21,2018,3,1,Thursday
1,6,14,20,2018,7,19,Thursday
14,25,8,33,2017,10,6,Friday
1,26,0,26,2018,4,8,Sunday
1,4,18,22,2017,9,26,Tuesday
1,18,14,32,2018,4,12,Thursday
2,15,21,36,2017,3,13,Monday
14,20,4,24,2017,2,28,Tuesday
1,16,10,26,2018,4,22,Sunday
4,11,20,31,2018,2,3,Saturday
0,4,10,14,2018,2,23,Friday
5,12,16,28,2018,3,29,Thursday
1,11,12,23,2017,5,21,Sunday
0,12,15,27,2018,5,3,Thursday
1,6,18,24,2018,4,15,Sunday
1,7,15,22,2017,9,25,Monday
2,13,7,20,2018,8,15,Wednseday
2,6,7,13,2018,8,11,Saturday
1,14,5,19,2017,8,30,Wednseday
6,14,12,26,2018,6,8,Friday
2,4,1,5,2018,8,4,Saturday
1,7,16,23,2017,11,7,Tuesday
2,8,20,28,2017,5,24,Wednseday
2,16,10,26,2017,9,17,Sunday
4,5,2,7,2018,8,6,Monday
2,17,20,37,2017,12,9,Saturday
4,14,19,33,2018,1,12,Friday
4,6,18,24,2017,3,10,Friday
1,14,5,19,2018,3,22,Thursday
1,4,17,21,2017,5,22,Monday
2,7,18,25,2018,4,14,Saturday
1,2,7,9,2018,6,12,Tuesday
2,6,12,18,2018,7,8,Sunday
2,4,12,16,2018,4,23,Monday
0,2,24,26,2018,5,30,Wednseday
1,16,12,28,2018,1,23,Tuesday
1,2,7,9,2018,6,11,Monday
1,12,14,26,2017,7,26,Wednseday
2,13,14,27,2018,4,24,Tuesday
2,4,11,15,2018,4,23,Monday
1,16,15,31,2018,6,26,Tuesday
1,14,14,28,2018,1,3,Wednseday
4,9,23,32,2017,12,7,Thursday
7,21,7,28,2018,4,23,Monday
3,12,14,26,2017,8,5,Saturday
4,8,12,20,2017,6,29,Thursday
2,14,14,28,2018,3,27,Tuesday
6,9,18,27,2017,9,26,Tuesday
0,12,21,33,2017,8,11,Friday
1,8,14,22,2018,3,13,Tuesday
4,7,8,15,2018,8,2,Thursday
2,11,23,34,2017,2,11,Saturday
3,4,7,11,2017,9,17,Sunday
0,11,21,32,2017,7,10,Monday
1,5,21,26,2017,5,28,Sunday
7,19,6,25,2018,2,22,Thursday
5,12,9,21,2017,10,26,Thursday
2,9,23,32,2017,12,17,Sunday
1,6,23,29,2018,1,2,Tuesday
5,23,0,23,2017,11,11,Saturday
4,15,32,47,2017,8,17,Thursday
1,56,-35,21,2018,3,12,Monday
6,17,27,44,2018,5,1,Tuesday
1,7,21,28,2018,7,2,Monday
4,20,13,33,2017,6,8,Thursday
1,7,16,23,2018,3,14,Wednseday
1,20,21,41,2017,12,6,Wednseday
1,6,20,26,2017,4,12,Wednseday
2,7,14,21,2018,4,9,Monday
2,6,21,27,2018,4,14,Saturday
3,10,24,34,2018,8,17,Friday
2,5,3,8,2018,8,8,Wednseday
2,3,23,26,2018,6,2,Saturday
3,9,9,18,2018,8,12,Sunday
1,3,12,15,2018,1,15,Monday
5,7,7,14,2018,2,9,Friday
3,5,5,10,2018,7,21,Saturday
0,6,23,29,2017,2,1,Wednseday
1,3,11,14,2017,6,7,Wednseday
2,21,10,31,2018,1,29,Monday
2,7,15,22,2018,5,8,Tuesday
2,3,14,17,2018,5,1,Tuesday
2,5,14,19,2017,9,6,Wednseday
4,12,15,27,2017,11,2,Thursday
2,34,-1,33,2017,4,9,Sunday
2,15,15,30,2018,6,24,Sunday
4,8,31,39,2017,2,2,Thursday
2,8,20,28,2018,4,17,Tuesday
5,41,13,54,2017,12,28,Thursday
2,11,13,24,2018,1,14,Sunday
4,24,13,37,2017,11,26,Sunday
2,5,19,24,2018,1,28,Sunday
3,14,34,48,2018,7,27,Friday
3,7,24,31,2017,2,10,Friday
2,34,-7,27,2018,2,14,Wednseday
6,20,4,24,2018,5,19,Saturday
1,5,6,11,2018,3,11,Sunday
2,12,20,32,2017,6,10,Saturday
1,6,25,31,2018,6,12,Tuesday
3,5,5,10,2018,3,12,Monday
1,14,11,25,2017,6,8,Thursday
9,10,8,18,2018,6,11,Monday
6,7,10,17,2017,11,10,Friday
1,8,12,20,2017,7,12,Wednseday
17,18,1,19,2018,5,18,Friday
1,29,0,29,2018,1,11,Thursday
2,8,18,26,2017,11,25,Saturday
2,22,10,32,2017,11,5,Sunday
1,10,14,24,2017,4,10,Monday
6,9,11,20,2017,11,15,Wednseday
3,10,22,32,2018,6,15,Friday
1,33,-7,26,2018,3,1,Thursday
1,7,24,31,2018,5,28,Monday
5,6,14,20,2017,12,14,Thursday
5,7,7,14,2018,2,9,Friday
6,28,-4,24,2018,2,10,Saturday
0,3,17,20,2017,9,12,Tuesday
1,20,-4,16,2018,5,16,Wednseday
5,6,7,13,2017,11,17,Friday
3,4,4,8,2018,8,6,Monday
3,9,8,17,2017,3,27,Monday
2,13,16,29,2017,6,14,Wednseday
0,6,14,20,2017,7,28,Friday
3,8,9,17,2017,10,31,Tuesday
1,50,-22,28,2017,11,28,Tuesday
4,24,-1,23,2018,3,17,Saturday
5,11,10,21,2017,9,7,Thursday
1,7,10,17,2018,7,3,Tuesday
4,14,14,28,2018,2,22,Thursday
3,12,14,26,2018,3,23,Friday
1,7,10,17,2018,7,17,Tuesday
3,38,-11,27,2017,12,1,Friday
2,6,20,26,2018,7,1,Sunday
1,11,14,25,2017,8,17,Thursday
3,8,12,20,2018,3,2,Friday
2,8,18,26,2017,7,12,Wednseday
1,8,6,14,2018,6,12,Tuesday
6,12,16,28,2018,2,2,Friday
5,15,15,30,2018,2,17,Saturday
2,9,14,23,2017,7,9,Sunday
1,2,13,15,2017,8,22,Tuesday
2,14,7,21,2017,11,27,Monday
7,9,20,29,2017,7,19,Wednseday
15,20,14,34,2017,3,23,Thursday
2,5,18,23,2017,9,27,Wednseday
2,6,11,17,2018,5,6,Sunday
1,3,12,15,2018,7,2,Monday
3,10,8,18,2018,3,4,Sunday
1,7,9,16,2018,7,30,Monday
1,6,22,28,2018,5,1,Tuesday
2,9,15,24,2017,7,9,Sunday
5,15,10,25,2017,5,4,Thursday
2,3,13,16,2017,10,24,Tuesday
5,6,13,19,2018,1,13,Saturday
26,27,28,55,2016,10,4,Tuesday
5,12,12,24,2018,2,9,Friday
1,6,14,20,2018,3,27,Tuesday
16,23,71,94,2017,5,21,Sunday
1,9,18,27,2018,7,4,Wednseday
1,7,14,21,2017,6,7,Wednseday
2,4,6,10,2018,3,5,Monday
1,7,14,21,2017,5,31,Wednseday
3,5,9,14,2017,11,24,Friday
1,8,14,22,2018,2,18,Sunday
1,5,2,7,2018,8,15,Wednseday
10,18,20,38,2017,12,1,Friday
5,8,8,16,2017,12,6,Wednseday
2,24,7,31,2017,11,25,Saturday
3,7,13,20,2018,2,27,Tuesday
4,24,-1,23,2018,1,23,Tuesday
1,9,19,28,2018,8,21,Tuesday
5,14,12,26,2018,1,12,Friday
5,14,20,34,2018,6,29,Friday
2,7,16,23,2018,3,19,Monday
3,12,14,26,2018,2,11,Sunday
1,6,14,20,2018,5,1,Tuesday
1,7,15,22,2017,6,27,Tuesday
1,11,16,27,2017,10,26,Thursday
1,8,13,21,2017,5,2,Tuesday
2,6,10,16,2018,8,21,Tuesday
3,9,-1,8,2018,7,31,Tuesday
2,22,20,42,2018,5,30,Wednseday
0,1,6,7,2018,8,13,Monday
1,9,24,33,2017,10,8,Sunday
10,19,14,33,2018,2,18,Sunday
3,6,18,24,2017,9,30,Saturday
1,8,26,34,2018,2,6,Tuesday
2,4,12,16,2018,1,8,Monday
6,9,12,21,2018,4,17,Tuesday
3,14,10,24,2017,8,7,Monday
6,9,12,21,2018,7,18,Wednseday
2,8,35,43,2017,2,8,Wednseday
5,18,8,26,2017,6,30,Friday
2,4,13,17,2017,10,15,Sunday
6,12,13,25,2017,11,10,Friday
1,6,14,20,2017,7,27,Thursday
1,7,4,11,2018,5,7,Monday
1,3,23,26,2018,7,4,Wednseday
2,5,20,25,2018,8,25,Saturday
2,11,9,20,2017,9,9,Saturday
1,6,20,26,2017,9,27,Wednseday
5,11,24,35,2017,6,2,Friday
2,8,13,21,2017,9,18,Monday
6,18,6,24,2018,1,9,Tuesday
3,15,14,29,2018,3,19,Monday
0,1,18,19,2017,8,2,Wednseday
1,9,17,26,2017,10,19,Thursday
2,7,8,15,2018,5,21,Monday
12,43,-11,32,2017,7,13,Thursday
0,8,22,30,2017,9,27,Wednseday
1,3,9,12,2017,11,23,Thursday
5,21,5,26,2017,11,22,Wednseday
0,7,16,23,2018,4,11,Wednseday
2,38,-1,37,2018,4,21,Saturday
3,11,16,27,2017,12,23,Saturday
1,6,25,31,2018,7,17,Tuesday
3,10,15,25,2017,12,17,Sunday
1,5,33,38,2018,5,27,Sunday
5,22,-4,18,2018,3,1,Thursday
2,5,17,22,2017,8,14,Monday
2,16,8,24,2018,2,17,Saturday
0,9,19,28,2018,7,31,Tuesday
1,8,14,22,2017,3,29,Wednseday
2,5,19,24,2018,8,4,Saturday
5,11,16,27,2018,5,24,Thursday
1,9,15,24,2018,2,6,Tuesday
2,19,4,23,2018,1,29,Monday
3,19,7,26,2017,2,26,Sunday
1,6,20,26,2018,7,18,Wednseday
2,6,7,13,2018,8,22,Wednseday
2,15,11,26,2018,2,15,Thursday
2,8,10,18,2018,6,11,Monday
5,6,5,11,2018,8,18,Saturday
22,23,21,44,2018,6,6,Wednseday
3,9,18,27,2018,1,27,Saturday
1,14,19,33,2018,2,1,Thursday
10,20,6,26,2017,10,28,Saturday
2,12,3,15,2018,1,11,Thursday
5,6,10,16,2018,1,31,Wednseday
12,13,5,18,2018,7,14,Saturday
1,7,27,34,2018,5,31,Thursday
1,11,9,20,2018,2,21,Wednseday
1,7,15,22,2017,5,17,Wednseday
2,37,-3,34,2017,6,28,Wednseday
1,9,11,20,2017,7,19,Wednseday
1,13,15,28,2017,11,8,Wednseday
3,9,13,22,2018,1,31,Wednseday
7,16,51,67,2016,10,8,Saturday
1,24,12,36,2018,1,30,Tuesday
3,9,8,17,2017,9,12,Tuesday
0,6,21,27,2018,6,15,Friday
3,10,13,23,2018,3,20,Tuesday
2,9,9,18,2018,7,28,Saturday
1,2,3,5,2018,8,1,Wednseday
2,4,9,13,2017,11,4,Saturday
5,13,20,33,2017,8,9,Wednseday
8,9,12,21,2017,6,5,Monday
13,26,13,39,2017,8,17,Thursday
1,12,9,21,2018,2,15,Thursday
8,23,6,29,2018,1,3,Wednseday
1,17,4,21,2018,5,8,Tuesday
8,24,0,24,2018,2,12,Monday
3,23,9,32,2017,7,15,Saturday
0,1,15,16,2018,1,29,Monday
1,2,6,8,2018,8,7,Tuesday
12,17,14,31,2018,3,17,Saturday
0,13,16,29,2018,2,8,Thursday
4,26,2,28,2017,11,24,Friday
5,16,10,26,2017,12,13,Wednseday
0,13,18,31,2017,2,20,Monday
15,28,-7,21,2017,11,15,Wednseday
5,10,10,20,2018,5,5,Saturday
3,8,5,13,2017,11,3,Friday
4,11,22,33,2017,12,29,Friday
2,5,12,17,2018,8,25,Saturday
3,32,-9,23,2018,2,11,Sunday
6,15,19,34,2018,4,3,Tuesday
1,7,15,22,2018,3,27,Tuesday
2,14,13,27,2017,12,6,Wednseday
1,10,12,22,2018,4,4,Wednseday
3,29,-4,25,2017,9,1,Friday
6,39,-13,26,2018,3,30,Friday
1,8,19,27,2017,12,12,Tuesday
2,5,8,13,2017,8,2,Wednseday
3,9,15,24,2017,8,26,Saturday
2,15,21,36,2018,1,1,Monday
0,6,8,14,2018,5,15,Tuesday
2,7,13,20,2018,5,15,Tuesday
3,7,5,12,2017,6,18,Sunday
1,9,7,16,2018,3,12,Monday
1,5,13,18,2018,7,30,Monday
2,7,24,31,2018,8,14,Tuesday
1,7,18,25,2018,3,15,Thursday
4,11,22,33,2017,8,25,Friday
5,19,15,34,2018,3,9,Friday
1,23,-5,18,2018,2,19,Monday
1,6,10,16,2018,8,8,Wednseday
1,2,4,6,2018,8,9,Thursday
1,2,11,13,2018,7,4,Wednseday
3,5,11,16,2017,11,11,Saturday
1,8,24,32,2018,4,16,Monday
2,7,8,15,2018,5,15,Tuesday
2,22,-6,16,2018,3,6,Tuesday
8,15,17,32,2017,6,11,Sunday
3,5,11,16,2017,8,12,Saturday
1,6,16,22,2017,3,29,Wednseday
5,11,9,20,2018,7,13,Friday
7,11,7,18,2017,11,27,Monday
1,3,13,16,2018,2,7,Wednseday
1,11,16,27,2017,6,8,Thursday
2,9,18,27,2018,5,5,Saturday
5,6,2,8,2018,8,8,Wednseday
4,13,13,26,2017,6,22,Thursday
6,9,8,17,2018,8,11,Saturday
6,45,-10,35,2018,2,28,Wednseday
7,13,13,26,2017,3,10,Friday
0,8,13,21,2017,9,11,Monday
0,1,12,13,2018,7,5,Thursday
0,1,6,7,2018,8,10,Friday
4,37,-13,24,2017,12,4,Monday
2,6,4,10,2018,7,21,Saturday
4,7,13,20,2018,7,21,Saturday
2,15,12,27,2018,1,24,Wednseday
3,9,22,31,2018,6,25,Monday
4,5,8,13,2018,7,6,Friday
3,13,8,21,2018,1,19,Friday
1,20,-3,17,2018,3,20,Tuesday
1,8,22,30,2018,6,13,Wednseday
6,10,14,24,2017,4,18,Tuesday
1,24,6,30,2018,6,19,Tuesday
1,7,17,24,2018,5,1,Tuesday
2,13,14,27,2017,9,6,Wednseday
1,23,0,23,2017,10,8,Sunday
3,19,11,30,2017,2,19,Sunday
2,11,12,23,2018,5,13,Sunday
1,4,15,19,2017,7,16,Sunday
5,11,7,18,2017,9,14,Thursday
3,39,-5,34,2018,3,3,Saturday
3,15,25,40,2018,6,3,Sunday
2,10,12,22,2017,7,17,Monday
5,6,17,23,2017,12,23,Saturday
3,21,2,23,2018,3,3,Saturday
1,31,-12,19,2018,5,9,Wednseday
4,7,13,20,2017,8,10,Thursday
0,3,18,21,2018,1,15,Monday
8,18,7,25,2018,4,12,Thursday
1,8,15,23,2017,12,6,Wednseday
14,31,9,40,2018,1,17,Wednseday
3,10,15,25,2017,9,9,Saturday
9,11,3,14,2018,2,12,Monday
2,6,23,29,2018,5,23,Wednseday
1,7,12,19,2018,5,9,Wednseday
1,2,13,15,2017,8,1,Tuesday
5,11,23,34,2017,7,7,Friday
4,8,27,35,2017,2,6,Monday
0,2,11,13,2018,3,21,Wednseday
2,8,8,16,2018,8,7,Tuesday
0,7,11,18,2018,7,27,Friday
8,20,12,32,2017,5,4,Thursday
0,8,18,26,2018,8,9,Thursday
4,5,16,21,2018,6,28,Thursday
7,32,-12,20,2018,3,29,Thursday
2,16,9,25,2017,4,1,Saturday
1,7,20,27,2018,4,10,Tuesday
1,5,24,29,2017,12,21,Thursday
1,8,7,15,2018,5,8,Tuesday
5,21,13,34,2017,12,14,Thursday
3,4,10,14,2017,6,9,Friday
1,10,11,21,2018,7,31,Tuesday
1,7,22,29,2018,7,3,Tuesday
0,5,13,18,2017,11,16,Thursday
1,6,15,21,2018,6,12,Tuesday
3,10,21,31,2017,5,16,Tuesday
3,5,1,6,2018,8,3,Friday
0,35,-13,22,2018,2,19,Monday
2,15,6,21,2017,11,29,Wednseday
4,14,17,31,2017,8,11,Friday
1,15,19,34,2018,4,18,Wednseday
3,5,11,16,2018,1,21,Sunday
2,3,21,24,2018,6,4,Monday
1,3,9,12,2017,5,28,Sunday
2,14,9,23,2017,11,8,Wednseday
1,9,12,21,2018,5,8,Tuesday
6,23,-3,20,2018,4,10,Tuesday
0,5,5,10,2018,8,3,Friday
4,11,11,22,2017,7,6,Thursday
19,28,6,34,2017,4,26,Wednseday
7,34,-7,27,2018,2,21,Wednseday
1,15,7,22,2017,3,28,Tuesday
2,6,7,13,2017,9,19,Tuesday
3,208,-188,20,2018,2,23,Friday
1,10,6,16,2018,7,30,Monday
1,14,15,29,2018,1,31,Wednseday
0,2,11,13,2018,8,21,Tuesday
5,38,-14,24,2018,2,25,Sunday
2,9,17,26,2017,3,25,Saturday
12,83,-49,34,2017,10,13,Friday
4,10,13,23,2018,4,9,Monday
1,3,11,14,2018,2,26,Monday
4,24,-1,23,2017,11,26,Sunday
1,8,13,21,2018,5,8,Tuesday
4,13,20,33,2018,4,26,Thursday
1,10,13,23,2018,2,14,Wednseday
1,8,8,16,2018,4,29,Sunday
6,7,8,15,2018,6,19,Tuesday
10,41,-16,25,2017,11,25,Saturday
2,11,29,40,2017,1,15,Sunday
2,9,10,19,2017,8,30,Wednseday
2,7,16,23,2018,2,20,Tuesday
5,9,16,25,2017,9,28,Thursday
2,4,19,23,2018,4,16,Monday
1,11,13,24,2018,4,8,Sunday
1,22,6,28,2018,5,8,Tuesday
1,14,8,22,2018,4,3,Tuesday
0,7,17,24,2018,7,16,Monday
3,4,3,7,2018,7,30,Monday
8,18,23,41,2017,12,19,Tuesday
4,5,9,14,2017,11,2,Thursday
2,16,23,39,2018,4,14,Saturday
2,9,23,32,2017,10,8,Sunday
3,9,17,26,2018,5,6,Sunday
2,14,3,17,2018,5,21,Monday
1,23,13,36,2017,3,27,Monday
3,13,21,34,2017,5,2,Tuesday
2,11,0,11,2018,8,19,Sunday
2,7,16,23,2018,5,2,Wednseday
3,9,8,17,2018,8,4,Saturday
3,9,23,32,2017,9,30,Saturday
2,42,-10,32,2017,7,17,Monday
7,19,5,24,2018,3,2,Friday
3,15,8,23,2018,1,8,Monday
2,12,13,25,2018,1,8,Monday
2,12,20,32,2018,6,10,Sunday
0,1,17,18,2018,4,26,Thursday
0,5,16,21,2018,3,19,Monday
0,10,12,22,2017,5,22,Monday
3,29,5,34,2018,3,30,Friday
2,48,-17,31,2017,12,10,Sunday
1,7,19,26,2018,6,27,Wednseday
4,11,17,28,2018,5,10,Thursday
2,6,14,20,2018,7,14,Saturday
1,4,11,15,2018,2,15,Thursday
1,8,14,22,2017,4,12,Wednseday
1,2,9,11,2018,3,18,Sunday
4,15,11,26,2018,3,11,Sunday
4,14,15,29,2018,1,11,Thursday
8,20,0,20,2018,4,19,Thursday
6,15,12,27,2017,12,21,Thursday
3,19,13,32,2017,4,14,Friday
4,13,12,25,2018,2,24,Saturday
1,4,22,26,2018,5,31,Thursday
1,7,13,20,2017,11,21,Tuesday
4,16,3,19,2018,3,17,Saturday
0,7,25,32,2017,11,3,Friday
2,15,2,17,2018,3,26,Monday
1,13,7,20,2018,2,20,Tuesday
1,6,24,30,2017,9,26,Tuesday
1,11,25,36,2017,5,15,Monday
2,9,14,23,2018,1,13,Saturday
6,9,25,34,2017,11,22,Wednseday
1,5,18,23,2017,8,13,Sunday
2,7,14,21,2018,2,14,Wednseday
4,14,19,33,2018,8,3,Friday
1,14,21,35,2018,5,7,Monday
4,13,20,33,2018,5,4,Friday
3,7,16,23,2017,3,27,Monday
0,6,13,19,2018,5,9,Wednseday
2,4,13,17,2018,4,1,Sunday
2,13,4,17,2018,5,26,Saturday
1,5,15,20,2018,1,10,Wednseday
4,6,17,23,2017,2,25,Saturday
1,13,13,26,2018,2,8,Thursday
1,9,13,22,2017,11,21,Tuesday
0,7,6,13,2018,8,17,Friday
10,16,4,20,2018,3,24,Saturday
7,26,19,45,2017,12,8,Friday
1,6,16,22,2017,8,29,Tuesday
4,11,11,22,2017,7,13,Thursday
1,20,6,26,2018,3,28,Wednseday
2,8,15,23,2017,11,15,Wednseday
1,4,19,23,2017,11,28,Tuesday
2,8,15,23,2017,12,4,Monday
1,12,16,28,2018,1,25,Thursday
2,25,-1,24,2018,2,25,Sunday
0,13,9,22,2017,10,25,Wednseday
2,6,13,19,2017,10,18,Wednseday
5,11,15,26,2018,5,6,Sunday
2,6,12,18,2017,3,19,Sunday
4,8,18,26,2017,3,23,Thursday
3,8,8,16,2017,8,6,Sunday
1,6,10,16,2018,1,2,Tuesday
1,28,-11,17,2018,7,24,Tuesday
1,12,15,27,2018,2,15,Thursday
2,7,16,23,2017,2,6,Monday
8,22,5,27,2017,10,31,Tuesday
5,8,18,26,2018,1,24,Wednseday
9,14,22,36,2017,9,12,Tuesday
3,4,1,5,2018,8,25,Saturday
4,8,3,11,2018,8,9,Thursday
2,10,16,26,2017,12,24,Sunday
2,6,24,30,2018,6,12,Tuesday
1,4,8,12,2018,8,19,Sunday
0,1,10,11,2018,5,14,Monday
3,20,11,31,2017,4,15,Saturday
6,13,10,23,2017,11,25,Saturday
0,4,6,10,2018,5,18,Friday
5,21,4,25,2018,2,1,Thursday
4,18,15,33,2017,5,18,Thursday
2,3,2,5,2018,8,25,Saturday
2,5,32,37,2018,6,5,Tuesday
1,13,10,23,2017,5,3,Wednseday
0,7,9,16,2017,9,27,Wednseday
3,10,3,13,2018,8,10,Friday
1,12,21,33,2018,1,4,Thursday
2,7,16,23,2017,7,25,Tuesday
7,13,14,27,2017,8,2,Wednseday
2,6,16,22,2017,3,15,Wednseday
3,9,13,22,2017,12,17,Sunday
1,9,8,17,2018,3,12,Monday
4,12,9,21,2017,10,27,Friday
2,15,26,41,2018,6,5,Tuesday
2,8,13,21,2018,7,23,Monday
1,3,15,18,2018,7,2,Monday
9,16,7,23,2017,6,14,Wednseday
2,3,8,11,2018,4,1,Sunday
4,7,11,18,2018,1,22,Monday
0,13,14,27,2017,6,8,Thursday
1,7,11,18,2018,5,14,Monday
7,7,6,13,2018,3,20,Tuesday
0,1,26,27,2017,6,22,Thursday
4,5,16,21,2018,6,22,Friday
3,10,13,23,2017,12,5,Tuesday
5,12,19,31,2018,1,6,Saturday
3,8,11,19,2018,7,8,Sunday
9,15,17,32,2017,8,13,Sunday
4,14,15,29,2018,5,3,Thursday
2,8,15,23,2018,1,16,Tuesday
2,16,14,30,2018,1,31,Wednseday
1,5,5,10,2018,8,20,Monday
2,11,12,23,2018,4,10,Tuesday
2,2,12,14,2018,2,27,Tuesday
3,16,14,30,2018,2,4,Sunday
1,5,12,17,2018,7,22,Sunday
0,13,25,38,2018,6,5,Tuesday
0,8,13,21,2018,4,18,Wednseday
1,5,20,25,2018,6,17,Sunday
1,2,14,16,2018,2,6,Tuesday
2,5,4,9,2018,5,9,Wednseday
21,27,13,40,2017,11,29,Wednseday
3,11,16,27,2018,6,30,Saturday
4,8,17,25,2018,6,28,Thursday
2,10,11,21,2017,11,7,Tuesday
3,11,9,20,2017,12,15,Friday
1,7,15,22,2018,1,2,Tuesday
1,19,26,45,2018,6,3,Sunday
2,13,9,22,2017,5,10,Wednseday
3,13,15,28,2018,4,20,Friday
3,10,15,25,2018,5,4,Friday
2,12,16,28,2018,4,25,Wednseday
2,8,29,37,2017,10,3,Tuesday
1,23,-2,21,2018,4,2,Monday
1,8,26,34,2018,5,16,Wednseday
1,22,3,25,2017,9,18,Monday
4,24,6,30,2018,2,19,Monday
0,1,4,5,2018,8,3,Friday
2,6,15,21,2018,7,25,Wednseday
2,15,22,37,2017,3,12,Sunday
9,15,6,21,2017,3,22,Wednseday
5,6,6,12,2017,9,14,Thursday
2,8,15,23,2017,11,14,Tuesday
5,10,6,16,2017,11,25,Saturday
4,12,14,26,2018,1,25,Thursday
1,37,-2,35,2018,1,10,Wednseday
6,19,10,29,2018,3,29,Thursday
4,9,8,17,2018,4,28,Saturday
4,20,9,29,2018,4,12,Thursday
3,9,12,21,2017,3,13,Monday
3,11,19,30,2017,12,23,Saturday
2,8,44,52,2018,5,27,Sunday
6,15,7,22,2017,4,19,Wednseday
9,15,10,25,2018,7,30,Monday
0,11,28,39,2017,2,2,Thursday
6,26,6,32,2017,11,11,Saturday
6,10,11,21,2018,7,17,Tuesday
0,6,19,25,2017,11,24,Friday
1,11,13,24,2018,7,16,Monday
1,9,19,28,2018,5,24,Thursday
6,10,20,30,2017,9,26,Tuesday
3,8,12,20,2018,3,13,Tuesday
2,14,20,34,2017,5,16,Tuesday
1,8,15,23,2017,11,26,Sunday
2,6,9,15,2018,7,31,Tuesday
1,4,9,13,2018,3,20,Tuesday
1,7,15,22,2017,5,18,Thursday
2,7,23,30,2017,11,15,Wednseday
4,14,9,23,2017,5,29,Monday
6,13,15,28,2017,11,24,Friday
2,3,13,16,2017,11,25,Saturday
4,7,7,14,2018,7,20,Friday
1,20,15,35,2017,8,22,Tuesday
2,9,23,32,2017,10,7,Saturday
7,8,5,13,2018,4,17,Tuesday
4,11,31,42,2017,9,28,Thursday
3,12,7,19,2018,3,17,Saturday
1,17,19,36,2018,5,29,Tuesday
4,11,10,21,2017,3,17,Friday
1,6,9,15,2018,7,26,Thursday
5,8,6,14,2017,11,27,Monday
2,21,5,26,2017,11,26,Sunday
1,13,17,30,2018,2,21,Wednseday
6,17,9,26,2018,1,31,Wednseday
4,11,17,28,2018,1,5,Friday
15,29,7,36,2018,4,3,Tuesday
0,4,17,21,2017,11,27,Monday
6,12,8,20,2018,4,5,Thursday
0,3,10,13,2017,7,21,Friday
1,63,-38,25,2018,4,26,Thursday
1,8,15,23,2018,5,2,Wednseday
2,6,18,24,2018,1,28,Sunday
1,16,5,21,2018,5,7,Monday
7,32,16,48,2017,12,29,Friday
8,23,5,28,2017,11,20,Monday
5,14,6,20,2017,11,9,Thursday
2,7,3,10,2018,8,13,Monday
2,4,13,17,2017,6,5,Monday
4,18,13,31,2017,12,2,Saturday
5,22,1,23,2018,3,18,Sunday
4,9,10,19,2017,8,26,Saturday
1,9,6,15,2018,2,21,Wednseday
6,10,13,23,2017,5,30,Tuesday
1,15,7,22,2018,3,19,Monday
3,15,5,20,2017,7,28,Friday
0,7,12,19,2018,7,5,Thursday
2,4,11,15,2018,5,21,Monday
10,16,8,24,2017,5,1,Monday
2,6,2,8,2018,7,18,Wednseday
2,14,11,25,2018,1,8,Monday
3,51,-24,27,2017,4,22,Saturday
1,9,19,28,2018,5,23,Wednseday
4,5,11,16,2018,4,7,Saturday
5,26,0,26,2018,2,23,Friday
2,18,33,51,2017,1,28,Saturday
1,2,3,5,2018,8,23,Thursday
2,9,15,24,2017,8,27,Sunday
0,5,15,20,2017,7,19,Wednseday
1,2,5,7,2018,8,21,Tuesday
1,13,9,22,2018,2,14,Wednseday
1,5,24,29,2017,2,15,Wednseday
2,38,-15,23,2018,3,3,Saturday
1,28,-1,27,2017,11,30,Thursday
4,25,2,27,2017,11,24,Friday
1,3,11,14,2017,11,8,Wednseday
1,19,6,25,2018,2,8,Thursday
2,12,20,32,2017,11,4,Saturday
4,8,16,24,2017,4,2,Sunday
10,16,2,18,2017,9,10,Sunday
2,9,16,25,2018,4,21,Saturday
3,22,-1,21,2018,5,15,Tuesday
2,4,6,10,2018,8,20,Monday
1,10,17,27,2018,2,7,Wednseday
1,7,15,22,2017,8,10,Thursday
1,9,-3,6,2018,8,8,Wednseday
3,8,30,38,2017,8,22,Tuesday
1,7,6,13,2018,3,27,Tuesday
2,8,16,24,2018,2,13,Tuesday
3,8,16,24,2017,5,7,Sunday
1,10,12,22,2017,11,29,Wednseday
13,19,5,24,2017,11,3,Friday
1,12,13,25,2018,3,22,Thursday
4,8,13,21,2017,3,2,Thursday
0,8,12,20,2018,3,1,Thursday
2,10,8,18,2018,5,14,Monday
5,6,7,13,2018,3,23,Friday
3,7,24,31,2018,8,10,Friday
1,4,18,22,2017,9,25,Monday
3,4,1,5,2018,7,27,Friday
2,7,28,35,2018,1,3,Wednseday
2,31,0,31,2018,3,10,Saturday
4,10,15,25,2017,1,16,Monday
9,22,10,32,2017,12,11,Monday
3,4,6,10,2017,5,12,Friday
4,14,8,22,2018,8,9,Thursday
9,15,17,32,2018,4,15,Sunday
1,6,21,27,2018,6,28,Thursday
2,12,21,33,2017,11,18,Saturday
4,8,18,26,2017,12,29,Friday
1,5,15,20,2017,7,6,Thursday
1,14,27,41,2017,1,31,Tuesday
3,6,17,23,2017,11,4,Saturday
3,10,16,26,2018,6,8,Friday
2,8,11,19,2017,7,2,Sunday
1,4,1,5,2018,8,23,Thursday
3,17,2,19,2017,11,26,Sunday
0,5,15,20,2017,8,11,Friday
1,6,21,27,2018,3,20,Tuesday
2,7,17,24,2017,9,9,Saturday
7,12,8,20,2017,11,15,Wednseday
7,13,13,26,2017,8,9,Wednseday
10,19,1,20,2018,4,27,Friday
1,2,14,16,2018,4,11,Wednseday
3,6,17,23,2017,3,11,Saturday
2,5,15,20,2017,3,4,Saturday
1,3,12,15,2018,1,23,Tuesday
1,6,16,22,2018,7,18,Wednseday
1,9,26,35,2017,10,2,Monday
34,47,-12,35,2017,11,24,Friday
1,9,27,36,2018,2,8,Thursday
3,7,15,22,2017,3,14,Tuesday
3,41,-13,28,2017,12,1,Friday
2,17,23,40,2018,5,5,Saturday
1,7,14,21,2018,7,24,Tuesday
1,5,14,19,2017,10,15,Sunday
3,4,27,31,2018,6,11,Monday
4,12,14,26,2018,7,26,Thursday
7,14,8,22,2017,4,20,Thursday
1,2,10,12,2018,4,18,Wednseday
4,11,23,34,2018,5,31,Thursday
1,12,18,30,2017,9,24,Sunday
1,18,15,33,2017,3,1,Wednseday
1,8,20,28,2017,3,20,Monday
1,20,4,24,2017,11,27,Monday
0,4,36,40,2018,6,29,Friday
2,7,12,19,2017,3,8,Wednseday
4,17,6,23,2018,7,30,Monday
4,32,-11,21,2018,3,2,Friday
4,6,11,17,2018,2,4,Sunday
2,4,8,12,2018,8,4,Saturday
1,5,20,25,2018,7,27,Friday
4,7,19,26,2018,3,15,Thursday
4,13,10,23,2018,3,25,Sunday
2,14,8,22,2017,7,3,Monday
1,7,17,24,2017,10,10,Tuesday
3,18,8,26,2017,5,13,Saturday
2,8,15,23,2018,7,15,Sunday
3,11,14,25,2017,11,19,Sunday
3,9,9,18,2018,4,1,Sunday
32,33,15,48,2018,6,2,Saturday
2,20,4,24,2018,4,17,Tuesday
3,19,6,25,2018,3,4,Sunday
1,10,18,28,2017,10,17,Tuesday
4,10,20,30,2018,8,4,Saturday
1,12,15,27,2017,7,19,Wednseday
8,9,14,23,2018,5,29,Tuesday
2,7,17,24,2017,5,27,Saturday
2,8,15,23,2018,1,24,Wednseday
9,12,17,29,2018,7,8,Sunday
3,28,3,31,2018,3,12,Monday
3,10,26,36,2017,2,7,Tuesday
2,14,16,30,2018,4,23,Monday
5,8,14,22,2017,10,12,Thursday
1,5,10,15,2018,8,15,Wednseday
3,8,24,32,2018,5,27,Sunday
4,11,10,21,2017,8,18,Friday
5,13,54,67,2018,6,28,Thursday
1,8,1,9,2018,8,21,Tuesday
3,9,13,22,2017,7,17,Monday
5,11,17,28,2018,6,15,Friday
1,9,12,21,2018,5,8,Tuesday
3,10,25,35,2017,11,24,Friday
7,8,6,14,2018,4,27,Friday
2,5,33,38,2018,6,10,Sunday
1,6,15,21,2018,7,6,Friday
5,9,4,13,2018,8,1,Wednseday
5,15,29,44,2018,5,30,Wednseday
10,25,-1,24,2017,9,8,Friday
2,5,16,21,2017,4,5,Wednseday
5,22,7,29,2017,12,6,Wednseday
4,18,14,32,2018,2,1,Thursday
2,9,13,22,2018,2,19,Monday
3,6,12,18,2018,8,10,Friday
3,43,-19,24,2018,3,26,Monday
4,19,17,36,2017,2,13,Monday
6,7,7,14,2018,4,24,Tuesday
3,5,14,19,2017,12,9,Saturday
1,8,16,24,2018,6,18,Monday
1,4,-1,3,2018,8,20,Monday
1,5,16,21,2018,4,11,Wednseday
4,15,16,31,2017,11,12,Sunday
2,7,20,27,2018,7,3,Tuesday
1,2,9,11,2017,11,6,Monday
2,3,15,18,2018,5,5,Saturday
1,3,18,21,2018,1,18,Thursday
0,7,18,25,2017,8,18,Friday
2,12,12,24,2017,6,4,Sunday
1,4,17,21,2018,2,1,Thursday
7,35,5,40,2018,2,7,Wednseday
5,19,2,21,2018,2,9,Friday
2,16,8,24,2017,6,11,Sunday
3,4,1,5,2018,8,10,Friday
1,12,12,24,2018,2,18,Sunday
3,6,13,19,2017,12,1,Friday
6,11,9,20,2017,11,25,Saturday
2,9,8,17,2017,9,4,Monday
4,7,7,14,2018,5,4,Friday
3,4,9,13,2018,5,4,Friday
1,2,8,10,2018,4,2,Monday
3,12,17,29,2017,11,19,Sunday
1,18,13,31,2017,12,11,Monday
1,6,10,16,2018,5,9,Wednseday
0,3,18,21,2018,7,17,Tuesday
2,13,9,22,2018,3,21,Wednseday
0,10,11,21,2017,10,23,Monday
2,11,13,24,2018,7,23,Monday
4,9,26,35,2017,7,25,Tuesday
1,2,13,15,2018,5,13,Sunday
27,34,21,55,2017,12,13,Wednseday
4,13,11,24,2017,9,8,Friday
2,8,19,27,2018,7,25,Wednseday
1,9,14,23,2017,6,7,Wednseday
1,2,2,4,2018,8,27,Monday
3,12,18,30,2017,7,30,Sunday
1,9,19,28,2018,7,2,Monday
2,15,-4,11,2018,8,6,Monday
2,6,16,22,2018,6,19,Tuesday
1,9,14,23,2017,9,24,Sunday
2,19,25,44,2018,3,21,Wednseday
2,8,14,22,2018,4,24,Tuesday
2,5,10,15,2018,8,19,Sunday
7,21,9,30,2018,7,25,Wednseday
3,7,31,38,2017,12,1,Friday
5,40,0,40,2017,3,24,Friday
4,7,12,19,2018,8,3,Friday
1,7,10,17,2017,12,11,Monday
2,12,9,21,2017,11,29,Wednseday
1,3,8,11,2017,7,31,Monday
2,8,14,22,2017,8,20,Sunday
7,29,2,31,2018,2,13,Tuesday
1,6,25,31,2018,5,8,Tuesday
1,6,16,22,2017,4,6,Thursday
3,16,5,21,2017,3,20,Monday
8,14,8,22,2017,7,13,Thursday
7,9,4,13,2017,10,11,Wednseday
3,16,1,17,2017,9,10,Sunday
3,7,29,36,2017,1,24,Tuesday
1,56,-34,22,2018,3,1,Thursday
1,4,-1,3,2018,7,30,Monday
2,9,17,26,2018,1,7,Sunday
0,1,9,10,2018,8,14,Tuesday
5,11,13,24,2017,11,11,Saturday
7,29,-15,14,2018,2,22,Thursday
3,11,21,32,2017,12,30,Saturday
4,10,9,19,2018,3,17,Saturday
1,6,9,15,2018,7,24,Tuesday
1,3,24,27,2018,6,6,Wednseday
5,11,23,34,2017,12,7,Thursday
3,16,6,22,2017,11,28,Tuesday
4,5,12,17,2018,6,29,Friday
1,29,2,31,2018,2,26,Monday
1,9,25,34,2018,6,20,Wednseday
2,5,7,12,2018,8,5,Sunday
0,6,17,23,2017,7,4,Tuesday
2,8,17,25,2018,6,18,Monday
5,14,13,27,2017,11,9,Thursday
4,18,14,32,2018,2,10,Saturday
4,14,9,23,2018,3,5,Monday
1,7,13,20,2018,3,14,Wednseday
0,19,8,27,2018,5,18,Friday
6,7,10,17,2018,2,16,Friday
4,17,15,32,2017,4,30,Sunday
8,11,22,33,2017,3,10,Friday
2,11,13,24,2018,3,31,Saturday
1,13,16,29,2018,4,17,Tuesday
5,24,35,59,2016,10,4,Tuesday
2,9,1,10,2018,8,5,Sunday
1,19,6,25,2018,3,26,Monday
1,2,11,13,2017,8,16,Wednseday
2,5,3,8,2018,5,9,Wednseday
3,16,13,29,2018,5,23,Wednseday
3,4,16,20,2017,12,16,Saturday
2,2,20,22,2017,12,18,Monday
1,14,20,34,2018,2,7,Wednseday
1,7,15,22,2017,7,27,Thursday
5,11,17,28,2017,3,30,Thursday
1,14,15,29,2017,12,19,Tuesday
2,7,17,24,2017,10,3,Tuesday
1,5,10,15,2018,7,9,Monday
1,9,14,23,2017,8,21,Monday
4,26,5,31,2018,2,10,Saturday
5,20,6,26,2017,12,14,Thursday
0,8,17,25,2017,10,30,Monday
4,8,14,22,2018,2,26,Monday
4,5,13,18,2017,9,30,Saturday
4,11,2,13,2018,8,3,Friday
1,5,6,11,2018,3,18,Sunday
1,8,42,50,2018,6,5,Tuesday
11,21,4,25,2017,12,30,Saturday
2,66,-41,25,2018,2,25,Sunday
3,14,16,30,2017,11,13,Monday
3,10,29,39,2018,4,6,Friday
2,6,10,16,2017,3,18,Saturday
6,12,17,29,2018,1,4,Thursday
1,4,19,23,2018,6,18,Monday
1,6,14,20,2017,10,18,Wednseday
1,9,22,31,2017,2,7,Tuesday
1,54,-30,24,2017,11,26,Sunday
5,14,26,40,2017,8,10,Thursday
9,21,4,25,2018,1,6,Saturday
5,10,11,21,2018,5,11,Friday
0,3,15,18,2017,8,4,Friday
1,5,19,24,2018,8,5,Sunday
1,2,13,15,2018,8,12,Sunday
6,11,15,26,2017,6,3,Saturday
4,10,11,21,2018,1,19,Friday
7,14,6,20,2018,4,4,Wednseday
7,22,5,27,2018,2,14,Wednseday
1,6,23,29,2018,6,13,Wednseday
0,8,30,38,2018,6,11,Monday
1,6,23,29,2018,8,23,Thursday
7,8,7,15,2017,5,17,Wednseday
3,24,0,24,2018,3,24,Saturday
1,16,11,27,2017,2,14,Tuesday
1,27,0,27,2018,4,25,Wednseday
1,10,27,37,2017,1,31,Tuesday
7,14,15,29,2018,7,11,Wednseday
1,28,12,40,2018,1,24,Wednseday
1,41,-28,13,2017,5,18,Thursday
3,9,8,17,2018,1,9,Tuesday
2,11,13,24,2018,2,5,Monday
1,21,3,24,2018,8,7,Tuesday
3,9,13,22,2017,9,3,Sunday
5,12,10,22,2017,3,29,Wednseday
4,11,24,35,2018,1,19,Friday
0,6,23,29,2017,5,18,Thursday
2,8,20,28,2018,6,6,Wednseday
5,16,15,31,2017,10,8,Sunday
6,26,-5,21,2018,3,29,Thursday
5,12,18,30,2018,6,20,Wednseday
4,25,-5,20,2017,11,24,Friday
4,5,9,14,2018,3,19,Monday
4,9,14,23,2018,1,28,Sunday
1,4,24,28,2017,12,18,Monday
1,41,-12,29,2018,7,24,Tuesday
10,30,0,30,2017,11,12,Sunday
5,6,14,20,2018,8,16,Thursday
3,20,-8,12,2018,8,10,Friday
1,5,10,15,2017,9,20,Wednseday
3,10,10,20,2017,11,24,Friday
1,15,13,28,2018,2,6,Tuesday
1,4,15,19,2018,5,13,Sunday
3,30,-10,20,2018,3,3,Saturday
2,8,9,17,2017,11,27,Monday
2,3,1,4,2018,7,30,Monday
4,6,10,16,2018,2,10,Saturday
5,7,11,18,2017,9,30,Saturday
3,18,-1,17,2018,4,30,Monday
6,9,19,28,2017,12,20,Wednseday
5,20,11,31,2017,10,21,Saturday
7,17,9,26,2017,6,16,Friday
1,11,13,24,2017,7,10,Monday
6,21,1,22,2017,4,20,Thursday
0,14,16,30,2018,1,9,Tuesday
2,9,36,45,2018,5,27,Sunday
2,10,20,30,2017,10,7,Saturday
7,10,14,24,2018,5,1,Tuesday
2,8,13,21,2018,4,9,Monday
4,14,49,63,2017,1,16,Monday
2,8,13,21,2018,4,30,Monday
1,2,8,10,2018,6,18,Monday
5,6,27,33,2017,11,16,Thursday
5,13,9,22,2017,5,17,Wednseday
3,5,6,11,2018,6,18,Monday
2,6,13,19,2018,1,13,Saturday
2,6,19,25,2018,1,27,Saturday
2,9,11,20,2017,8,5,Saturday
3,22,24,46,2018,1,7,Sunday
1,5,16,21,2018,6,28,Thursday
2,9,14,23,2017,6,25,Sunday
1,4,20,24,2018,7,16,Monday
2,8,24,32,2017,10,2,Monday
5,18,2,20,2017,4,21,Friday
0,17,7,24,2017,12,12,Tuesday
2,7,15,22,2018,1,29,Monday
1,9,20,29,2017,2,7,Tuesday
1,11,11,22,2017,6,26,Monday
4,19,19,38,2018,5,18,Friday
3,8,13,21,2018,5,4,Friday
2,7,19,26,2017,7,8,Saturday
4,7,18,25,2017,12,1,Friday
4,14,11,25,2017,5,5,Friday
1,20,7,27,2018,5,3,Thursday
5,8,53,61,2016,10,5,Wednseday
6,21,2,23,2017,11,29,Wednseday
3,12,12,24,2018,5,6,Sunday
5,15,15,30,2017,6,28,Wednseday
1,19,8,27,2018,2,22,Thursday
1,23,-7,16,2018,5,16,Wednseday
6,16,7,23,2017,11,11,Saturday
0,6,23,29,2017,9,14,Thursday
2,3,15,18,2018,4,8,Sunday
1,6,30,36,2018,6,21,Thursday
3,5,13,18,2018,1,5,Friday
1,2,7,9,2018,7,24,Tuesday
1,6,14,20,2017,6,27,Tuesday
5,27,-7,20,2018,2,23,Friday
2,21,2,23,2018,2,19,Monday
4,6,19,25,2018,7,14,Saturday
3,20,5,25,2018,3,24,Saturday
1,35,-19,16,2018,3,5,Monday
2,5,15,20,2017,8,12,Saturday
3,6,9,15,2018,8,21,Tuesday
4,9,16,25,2017,12,2,Saturday
4,13,30,43,2018,5,31,Thursday
1,14,13,27,2018,3,7,Wednseday
3,41,-8,33,2018,3,2,Friday
3,10,13,23,2018,1,15,Monday
2,3,12,15,2018,2,25,Sunday
7,33,0,33,2017,11,18,Saturday
1,11,16,27,2018,8,16,Thursday
1,16,11,27,2018,5,16,Wednseday
0,7,14,21,2018,7,20,Friday
3,15,-10,5,2018,8,4,Saturday
1,6,12,18,2018,5,10,Thursday
3,13,14,27,2018,1,3,Wednseday
27,31,24,55,2016,10,4,Tuesday
3,10,22,32,2018,8,3,Friday
24,30,-7,23,2018,1,30,Tuesday
5,11,14,25,2018,1,5,Friday
1,5,28,33,2017,12,17,Sunday
1,20,7,27,2018,5,15,Tuesday
11,24,10,34,2017,9,15,Friday
1,5,10,15,2018,2,14,Wednseday
4,11,16,27,2018,8,17,Friday
2,19,6,25,2018,4,15,Sunday
2,8,19,27,2018,2,8,Thursday
1,11,16,27,2017,12,28,Thursday
4,15,17,32,2018,6,14,Thursday
5,9,9,18,2018,3,8,Thursday
3,27,1,28,2018,7,17,Tuesday
3,16,17,33,2017,4,2,Sunday
2,14,16,30,2017,8,7,Monday
1,6,14,20,2018,2,21,Wednseday
1,6,16,22,2018,3,13,Tuesday
0,3,27,30,2018,6,12,Tuesday
7,21,8,29,2017,11,29,Wednseday
0,6,11,17,2018,8,17,Friday
1,9,27,36,2018,6,12,Tuesday
1,15,10,25,2017,11,9,Thursday
6,11,9,20,2017,7,8,Saturday
5,10,13,23,2018,3,5,Monday
1,15,6,21,2018,5,7,Monday
3,7,18,25,2018,4,27,Friday
1,4,9,13,2018,6,21,Thursday
0,5,30,35,2018,1,11,Thursday
4,11,13,24,2018,3,5,Monday
1,9,28,37,2017,9,3,Sunday
3,12,7,19,2018,3,16,Friday
1,10,13,23,2017,9,17,Sunday
4,28,7,35,2017,12,7,Thursday
4,5,8,13,2017,10,13,Friday
1,31,-1,30,2018,4,4,Wednseday
2,6,15,21,2017,5,16,Tuesday
2,12,14,26,2018,2,17,Saturday
2,6,19,25,2018,1,7,Sunday
3,24,5,29,2017,12,4,Monday
4,11,32,43,2018,6,11,Monday
1,14,28,42,2018,6,6,Wednseday
5,11,15,26,2017,10,26,Thursday
1,11,19,30,2017,10,9,Monday
4,11,8,19,2018,3,16,Friday
1,15,1,16,2018,3,13,Tuesday
2,6,3,9,2018,8,1,Wednseday
4,24,3,27,2018,2,16,Friday
2,19,4,23,2017,9,24,Sunday
0,1,13,14,2018,7,4,Wednseday
4,11,2,13,2018,3,23,Friday
3,13,21,34,2017,12,8,Friday
5,15,10,25,2018,4,29,Sunday
0,3,15,18,2018,4,27,Friday
3,33,-5,28,2018,3,16,Friday
5,34,2,36,2018,1,17,Wednseday
0,1,13,14,2018,5,10,Thursday
8,21,-2,19,2017,9,13,Wednseday
9,22,9,31,2017,8,21,Monday
6,11,17,28,2017,11,10,Friday
4,9,4,13,2018,3,29,Thursday
3,10,14,24,2017,5,15,Monday
2,10,9,19,2018,6,9,Saturday
1,36,-12,24,2017,7,18,Tuesday
3,10,30,40,2018,6,2,Saturday
4,10,14,24,2017,4,8,Saturday
1,5,11,16,2018,8,1,Wednseday
2,7,18,25,2018,1,22,Monday
3,12,2,14,2018,3,23,Friday
4,8,17,25,2017,3,23,Thursday
10,26,1,27,2017,12,1,Friday
2,7,9,16,2018,7,23,Monday
1,6,15,21,2018,7,5,Thursday
1,7,11,18,2018,7,16,Monday
4,26,3,29,2017,11,16,Thursday
1,14,20,34,2017,11,9,Thursday
0,10,33,43,2018,1,9,Tuesday
8,12,10,22,2018,4,5,Thursday
2,9,14,23,2018,3,18,Sunday
2,25,7,32,2018,4,23,Monday
2,5,21,26,2018,1,10,Wednseday
2,8,10,18,2017,10,22,Sunday
1,7,10,17,2018,7,17,Tuesday
6,13,14,27,2018,7,27,Friday
2,19,1,20,2018,2,28,Wednseday
20,25,0,25,2017,9,30,Saturday
3,11,16,27,2017,9,23,Saturday
2,10,17,27,2018,6,19,Tuesday
1,3,15,18,2017,11,30,Thursday
1,4,6,10,2018,6,25,Monday
2,13,1,14,2017,11,8,Wednseday
1,4,22,26,2017,6,25,Sunday
0,8,5,13,2017,6,20,Tuesday
5,27,3,30,2018,3,10,Saturday
3,5,14,19,2018,1,5,Friday
1,7,13,20,2017,12,19,Tuesday
3,11,29,40,2018,6,1,Friday
3,15,10,25,2017,4,17,Monday
11,76,-43,33,2018,6,21,Thursday
7,28,16,44,2018,6,5,Tuesday
2,3,18,21,2017,6,6,Tuesday
4,14,10,24,2017,11,6,Monday
10,13,3,16,2018,7,24,Tuesday
2,11,15,26,2018,5,12,Saturday
3,9,13,22,2017,3,12,Sunday
2,12,11,23,2018,4,25,Wednseday
2,3,2,5,2018,8,8,Wednseday
6,12,13,25,2017,11,24,Friday
2,4,17,21,2018,4,16,Monday
1,13,19,32,2017,3,23,Thursday
3,7,5,12,2017,9,8,Friday
5,11,14,25,2018,4,15,Sunday
1,18,18,36,2018,2,1,Thursday
3,43,-20,23,2017,11,27,Monday
1,2,1,3,2018,8,20,Monday
3,9,15,24,2018,1,21,Sunday
1,40,-16,24,2018,2,25,Sunday
4,6,6,12,2018,5,3,Thursday
5,8,5,13,2018,8,22,Wednseday
4,19,10,29,2017,8,21,Monday
2,3,14,17,2017,10,8,Sunday
1,2,8,10,2017,9,11,Monday
3,4,24,28,2018,5,11,Friday
3,20,6,26,2017,7,8,Saturday
8,19,17,36,2017,6,19,Monday
2,3,13,16,2018,4,30,Monday
1,7,21,28,2017,10,24,Tuesday
1,9,15,24,2018,6,10,Sunday
9,14,9,23,2017,5,2,Tuesday
0,10,33,43,2018,7,31,Tuesday
1,9,27,36,2017,5,8,Monday
12,20,1,21,2017,11,24,Friday
1,26,9,35,2018,5,2,Wednseday
5,13,14,27,2018,6,22,Friday
6,18,8,26,2017,12,21,Thursday
2,11,14,25,2018,6,23,Saturday
2,25,9,34,2018,6,16,Saturday
0,8,21,29,2018,1,23,Tuesday
0,3,14,17,2018,5,4,Friday
5,8,14,22,2017,7,6,Thursday
3,17,16,33,2018,2,2,Friday
3,17,4,21,2018,3,23,Friday
4,9,10,19,2017,3,18,Saturday
6,11,20,31,2018,7,10,Tuesday
2,16,6,22,2018,1,29,Monday
6,28,-1,27,2017,9,13,Wednseday
5,26,9,35,2017,12,15,Friday
7,21,-7,14,2018,5,14,Monday
2,9,20,29,2017,2,20,Monday
8,26,-2,24,2018,3,19,Monday
10,11,5,16,2018,7,23,Monday
0,11,9,20,2017,5,11,Thursday
5,16,15,31,2018,1,8,Monday
1,2,14,16,2018,7,2,Monday
1,9,13,22,2017,7,5,Wednseday
0,12,15,27,2017,12,1,Friday
4,36,-16,20,2018,3,1,Thursday
4,10,14,24,2017,11,10,Friday
2,9,21,30,2018,7,24,Tuesday
8,18,29,47,2017,6,11,Sunday
4,6,33,39,2018,5,5,Saturday
0,32,-4,28,2018,3,16,Friday
1,2,9,11,2017,10,9,Monday
2,8,24,32,2017,7,30,Sunday
1,10,19,29,2017,9,24,Sunday
3,13,14,27,2018,2,24,Saturday
1,4,11,15,2018,5,3,Thursday
2,9,21,30,2018,7,22,Sunday
3,45,-13,32,2017,12,3,Sunday
0,1,11,12,2017,9,20,Wednseday
1,8,14,22,2017,7,18,Tuesday
1,18,15,33,2018,1,4,Thursday
3,5,14,19,2017,9,8,Friday
7,21,19,40,2018,4,7,Saturday
5,65,-35,30,2017,11,12,Sunday
2,7,13,20,2017,10,17,Tuesday
2,6,14,20,2018,5,19,Saturday
5,14,13,27,2017,11,11,Saturday
4,8,16,24,2018,4,20,Friday
1,12,22,34,2018,6,20,Wednseday
4,6,7,13,2018,7,6,Friday
3,4,9,13,2018,3,24,Saturday
3,10,4,14,2018,8,3,Friday
4,18,14,32,2017,11,26,Sunday
3,14,24,38,2018,1,8,Monday
5,14,13,27,2017,10,4,Wednseday
1,2,9,11,2017,8,28,Monday
5,19,19,38,2017,6,24,Saturday
1,8,14,22,2018,5,15,Tuesday
2,3,12,15,2017,6,11,Sunday
0,2,20,22,2018,3,27,Tuesday
3,10,14,24,2017,6,19,Monday
3,18,8,26,2018,1,28,Sunday
1,12,28,40,2018,6,3,Sunday
1,18,2,20,2018,3,15,Thursday
6,7,8,15,2018,6,14,Thursday
8,28,16,44,2017,2,13,Monday
8,12,15,27,2017,8,3,Thursday
0,14,12,26,2017,12,21,Thursday
2,24,13,37,2018,4,17,Tuesday
4,11,18,29,2018,1,11,Thursday
20,37,-4,33,2017,4,8,Saturday
1,2,6,8,2018,8,14,Tuesday
0,8,17,25,2018,6,18,Monday
1,4,8,12,2017,7,30,Sunday
2,15,12,27,2017,12,7,Thursday
4,18,16,34,2018,2,1,Thursday
2,6,25,31,2018,6,16,Saturday
2,4,14,18,2017,12,31,Sunday
1,5,30,35,2017,2,2,Thursday
4,8,4,12,2018,5,3,Thursday
6,11,7,18,2018,7,13,Friday
5,7,18,25,2018,4,19,Thursday
2,8,14,22,2017,7,24,Monday
1,8,10,18,2018,7,23,Monday
2,5,14,19,2018,1,10,Wednseday
1,7,15,22,2017,5,22,Monday
3,7,15,22,2018,6,26,Tuesday
3,9,15,24,2017,9,12,Tuesday
4,7,40,47,2017,2,3,Friday
3,17,7,24,2017,10,17,Tuesday
8,26,9,35,2017,6,8,Thursday
3,7,11,18,2017,9,15,Friday
0,7,13,20,2017,11,14,Tuesday
3,12,25,37,2017,10,7,Saturday
2,13,27,40,2018,3,21,Wednseday
1,4,25,29,2017,5,21,Sunday
1,9,11,20,2018,5,8,Tuesday
2,4,12,16,2017,11,25,Saturday
3,10,14,24,2017,7,21,Friday
2,13,11,24,2018,2,17,Saturday
3,5,12,17,2018,2,17,Saturday
1,14,-4,10,2018,3,13,Tuesday
5,26,-6,20,2017,10,19,Thursday
3,10,16,26,2018,6,22,Friday
3,10,14,24,2017,5,19,Friday
2,7,12,19,2018,8,22,Wednseday
2,8,15,23,2017,8,16,Wednseday
10,11,6,17,2017,11,6,Monday
2,14,18,32,2017,12,4,Monday
2,8,30,38,2017,9,18,Monday
3,5,19,24,2017,4,8,Saturday
4,8,14,22,2017,6,29,Thursday
1,13,16,29,2017,9,5,Tuesday
2,5,12,17,2018,8,18,Saturday
2,3,7,10,2018,3,5,Monday
1,7,26,33,2018,4,11,Wednseday
3,25,6,31,2018,2,16,Friday
4,29,-1,28,2018,3,29,Thursday
0,7,11,18,2017,7,24,Monday
2,18,13,31,2017,12,19,Tuesday
1,23,1,24,2018,3,13,Tuesday
5,12,30,42,2018,5,31,Thursday
9,21,8,29,2017,11,27,Monday
1,11,14,25,2017,10,5,Thursday
5,7,9,16,2018,1,24,Wednseday
4,8,13,21,2018,4,26,Thursday
1,10,16,26,2017,12,3,Sunday
7,26,-5,21,2017,11,9,Thursday
1,7,18,25,2018,1,15,Monday
1,12,15,27,2017,11,9,Thursday
3,4,15,19,2017,7,23,Sunday
3,13,10,23,2017,10,21,Saturday
4,27,0,27,2017,12,15,Friday
1,13,6,19,2017,11,16,Thursday
2,7,10,17,2018,4,23,Monday
1,10,20,30,2017,12,3,Sunday
0,9,19,28,2017,9,20,Wednseday
6,12,9,21,2017,4,5,Wednseday
5,11,9,20,2017,11,17,Friday
1,5,15,20,2018,6,13,Wednseday
0,6,25,31,2018,6,26,Tuesday
1,10,4,14,2017,11,15,Wednseday
4,7,19,26,2018,8,23,Thursday
1,8,18,26,2018,4,18,Wednseday
1,13,14,27,2018,3,15,Thursday
2,9,0,9,2018,5,16,Wednseday
1,2,1,3,2018,8,20,Monday
0,18,4,22,2017,11,30,Thursday
1,10,15,25,2018,4,2,Monday
3,6,20,26,2017,3,25,Saturday
2,16,12,28,2017,12,5,Tuesday
2,4,20,24,2018,1,21,Sunday
1,9,14,23,2018,5,2,Wednseday
2,13,29,42,2018,8,1,Wednseday
5,11,9,20,2018,2,23,Friday
4,5,12,17,2018,2,4,Sunday
8,10,6,16,2018,1,21,Sunday
4,23,2,25,2018,5,13,Sunday
1,3,12,15,2018,8,13,Monday
2,14,11,25,2018,4,9,Monday
1,5,9,14,2018,4,19,Thursday
1,2,18,20,2017,8,9,Wednseday
2,11,20,31,2018,4,9,Monday
1,3,6,9,2018,7,25,Wednseday
6,28,6,34,2018,1,11,Thursday
2,21,3,24,2018,3,12,Monday
2,8,13,21,2017,6,14,Wednseday
2,29,6,35,2017,12,6,Wednseday
5,15,4,19,2018,2,28,Wednseday
2,32,-4,28,2018,4,2,Monday
6,39,-9,30,2018,1,20,Saturday
1,9,34,43,2018,6,4,Monday
2,14,9,23,2017,11,15,Wednseday
1,21,16,37,2017,3,27,Monday
1,9,8,17,2018,4,9,Monday
3,14,-4,10,2018,5,19,Saturday
1,3,10,13,2018,3,20,Tuesday
2,30,1,31,2017,8,6,Sunday
10,20,7,27,2018,8,3,Friday
3,6,18,24,2018,6,19,Tuesday
1,6,10,16,2018,5,9,Wednseday
3,30,2,32,2017,11,26,Sunday
1,20,13,33,2018,2,4,Sunday
0,5,8,13,2018,8,22,Wednseday
2,11,27,38,2017,12,11,Monday
3,4,2,6,2018,8,18,Saturday
16,19,21,40,2018,6,2,Saturday
1,2,22,24,2017,12,26,Tuesday
3,4,21,25,2018,6,3,Sunday
3,18,9,27,2018,3,16,Friday
5,19,2,21,2018,1,18,Thursday
2,15,11,26,2018,1,31,Wednseday
1,4,7,11,2018,8,20,Monday
8,12,0,12,2018,5,9,Wednseday
9,18,27,45,2018,8,6,Monday
1,13,22,35,2017,5,30,Tuesday
0,5,21,26,2018,6,20,Wednseday
2,10,29,39,2018,7,2,Monday
2,8,4,12,2018,8,1,Wednseday
3,7,22,29,2017,2,6,Monday
1,5,29,34,2017,2,9,Thursday
6,10,16,26,2017,4,28,Friday
4,11,9,20,2017,5,19,Friday
5,6,10,16,2018,4,28,Saturday
3,11,17,28,2017,12,8,Friday
4,13,14,27,2017,9,22,Friday
1,8,14,22,2018,1,18,Thursday
1,34,-1,33,2018,3,11,Sunday
7,17,14,31,2017,3,6,Monday
1,3,7,10,2018,3,5,Monday
1,5,14,19,2018,7,25,Wednseday
1,3,14,17,2018,1,28,Sunday
4,10,14,24,2018,8,4,Saturday
0,6,23,29,2017,2,8,Wednseday
3,13,16,29,2017,12,10,Sunday
6,10,16,26,2018,1,11,Thursday
1,54,-28,26,2018,5,2,Wednseday
1,10,13,23,2017,11,7,Tuesday
1,5,23,28,2018,6,14,Thursday
3,7,10,17,2017,10,23,Monday
2,9,7,16,2018,3,6,Tuesday
3,17,7,24,2017,11,26,Sunday
5,10,20,30,2018,6,23,Saturday
3,9,22,31,2018,1,6,Saturday
2,59,-39,20,2018,2,24,Saturday
1,20,0,20,2018,4,4,Wednseday
4,10,14,24,2017,6,17,Saturday
6,11,17,28,2017,2,24,Friday
3,7,14,21,2017,3,6,Monday
4,15,15,30,2018,7,23,Monday
2,3,7,10,2018,7,28,Saturday
6,7,6,13,2017,8,4,Friday
1,12,3,15,2018,8,2,Thursday
1,29,-10,19,2018,3,4,Sunday
2,10,10,20,2018,3,17,Saturday
2,17,6,23,2018,2,14,Wednseday
3,24,1,25,2017,9,15,Friday
5,6,14,20,2018,3,30,Friday
2,4,20,24,2017,9,30,Saturday
1,2,9,11,2017,7,31,Monday
1,7,21,28,2018,1,29,Monday
0,16,16,32,2017,12,1,Friday
5,16,12,28,2018,6,28,Thursday
3,14,13,27,2017,6,13,Tuesday
1,6,11,17,2017,10,24,Tuesday
1,8,16,24,2018,7,22,Sunday
3,17,19,36,2017,10,2,Monday
1,4,11,15,2018,5,10,Thursday
1,18,8,26,2018,2,18,Sunday
6,11,28,39,2017,2,2,Thursday
1,31,24,55,2018,4,3,Tuesday
5,24,3,27,2017,6,14,Wednseday
1,14,8,22,2017,6,19,Monday
2,10,9,19,2017,3,4,Saturday
2,4,4,8,2018,7,23,Monday
9,18,3,21,2017,11,23,Thursday
1,7,9,16,2017,10,3,Tuesday
2,3,13,16,2018,1,29,Monday
1,4,16,20,2017,5,11,Thursday
1,63,-36,27,2018,3,1,Thursday
6,14,12,26,2017,3,15,Wednseday
4,32,2,34,2017,4,8,Saturday
3,10,59,69,2017,5,9,Tuesday
4,12,18,30,2017,6,25,Sunday
3,18,-4,14,2018,8,3,Friday
0,23,-1,22,2018,3,12,Monday
1,2,22,24,2018,6,4,Monday
2,6,17,23,2017,8,23,Wednseday
1,8,14,22,2017,11,16,Thursday
1,6,4,10,2018,5,8,Tuesday
4,28,3,31,2018,3,6,Tuesday
1,7,4,11,2017,7,10,Monday
4,5,9,14,2017,6,12,Monday
5,4,15,19,2017,7,30,Sunday
2,7,8,15,2018,1,15,Monday
1,8,13,21,2018,4,18,Wednseday
1,9,13,22,2018,8,12,Sunday
1,8,15,23,2017,3,6,Monday
1,6,16,22,2017,5,23,Tuesday
4,5,6,11,2018,4,28,Saturday
0,15,14,29,2018,2,7,Wednseday
1,14,27,41,2017,3,29,Wednseday
1,23,2,25,2017,3,13,Monday
3,4,8,12,2017,8,20,Sunday
5,115,-97,18,2017,8,25,Friday
2,9,14,23,2017,8,26,Saturday
2,7,33,40,2017,9,6,Wednseday
2,8,18,26,2018,2,7,Wednseday
2,7,10,17,2018,3,19,Monday
6,15,19,34,2018,7,20,Friday
0,16,13,29,2018,1,18,Thursday
4,5,19,24,2017,12,23,Saturday
3,26,35,61,2017,1,27,Friday
6,23,17,40,2017,12,13,Wednseday
1,3,12,15,2018,5,14,Monday
4,12,6,18,2018,3,25,Sunday
3,11,15,26,2017,8,11,Friday
2,17,13,30,2017,2,12,Sunday
2,10,36,46,2018,6,3,Sunday
1,5,23,28,2017,5,17,Wednseday
2,9,24,33,2017,8,16,Wednseday
7,11,22,33,2017,12,1,Friday
2,4,14,18,2018,7,22,Sunday
4,7,21,28,2018,5,10,Thursday
1,4,26,30,2018,7,23,Monday
1,2,14,16,2018,2,7,Wednseday
3,22,14,36,2018,2,5,Monday
12,17,51,68,2018,1,13,Saturday
3,10,17,27,2018,4,13,Friday
2,11,12,23,2018,8,13,Monday
7,24,0,24,2018,5,14,Monday
1,10,25,35,2017,12,13,Wednseday
1,14,15,29,2018,3,21,Wednseday
12,29,4,33,2018,3,23,Friday
8,13,13,26,2018,4,19,Thursday
5,12,19,31,2017,8,18,Friday
0,13,24,37,2018,6,13,Wednseday
3,15,11,26,2018,1,26,Friday
1,13,12,25,2018,2,16,Friday
4,12,20,32,2017,12,15,Friday
5,7,14,21,2017,9,6,Wednseday
1,15,13,28,2018,4,11,Wednseday
3,24,-1,23,2017,11,29,Wednseday
2,28,-2,26,2018,4,11,Wednseday
2,7,14,21,2018,4,30,Monday
6,12,14,26,2017,6,28,Wednseday
0,1,8,9,2018,8,22,Wednseday
1,24,4,28,2017,11,6,Monday
6,15,12,27,2017,12,7,Thursday
2,5,13,18,2018,4,30,Monday
1,15,8,23,2017,5,8,Monday
1,24,-7,17,2017,9,19,Tuesday
1,5,15,20,2018,7,25,Wednseday
4,5,5,10,2018,5,5,Saturday
1,6,13,19,2018,5,2,Wednseday
2,11,12,23,2017,8,6,Sunday
1,13,28,41,2018,2,14,Wednseday
0,2,10,12,2018,5,9,Wednseday
3,5,6,11,2018,7,21,Saturday
2,22,13,35,2017,8,22,Tuesday
2,9,13,22,2017,8,30,Wednseday
7,11,10,21,2017,6,12,Monday
2,15,7,22,2018,4,17,Tuesday
4,32,13,45,2018,6,2,Saturday
1,8,16,24,2018,3,19,Monday
6,19,15,34,2017,11,18,Saturday
2,8,18,26,2018,7,1,Sunday
2,15,-1,14,2018,5,21,Monday
4,7,13,20,2017,8,17,Thursday
1,10,18,28,2018,6,19,Tuesday
6,21,6,27,2017,11,3,Friday
3,9,27,36,2018,5,6,Sunday
1,8,14,22,2018,6,27,Wednseday
3,5,12,17,2018,1,28,Sunday
2,11,20,31,2017,12,2,Saturday
3,9,20,29,2018,4,29,Sunday
1,7,11,18,2017,7,17,Monday
21,27,-6,21,2018,1,10,Wednseday
1,11,10,21,2018,3,15,Thursday
1,7,15,22,2017,6,28,Wednseday
1,14,6,20,2018,8,9,Thursday
3,7,12,19,2018,6,9,Saturday
3,10,18,28,2017,8,18,Friday
3,21,6,27,2017,11,24,Friday
4,9,8,17,2018,2,17,Saturday
2,14,12,26,2017,6,17,Saturday
2,5,3,8,2018,5,9,Wednseday
12,18,-1,17,2017,8,11,Friday
17,27,-4,23,2018,2,28,Wednseday
1,18,5,23,2018,1,22,Monday
8,15,10,25,2017,11,2,Thursday
1,8,18,26,2018,6,7,Thursday
3,10,3,13,2018,8,7,Tuesday
5,6,8,14,2018,5,23,Wednseday
1,19,13,32,2017,5,28,Sunday
0,38,-11,27,2017,8,18,Friday
2,8,15,23,2017,5,31,Wednseday
1,7,5,12,2018,8,2,Thursday
4,24,15,39,2018,6,4,Monday
2,6,18,24,2017,8,5,Saturday
3,36,-13,23,2018,4,30,Monday
1,7,17,24,2018,6,18,Monday
2,3,6,9,2018,7,9,Monday
1,6,7,13,2017,6,27,Tuesday
1,2,18,20,2017,7,25,Tuesday
2,7,10,17,2018,8,20,Monday
0,1,5,6,2018,8,15,Wednseday
1,51,-20,31,2018,4,24,Tuesday
5,13,7,20,2017,11,11,Saturday
3,11,14,25,2017,11,24,Friday
2,15,11,26,2018,5,10,Thursday
2,13,15,28,2018,4,18,Wednseday
0,4,18,22,2018,4,24,Tuesday
1,15,14,29,2017,11,22,Wednseday
9,41,-20,21,2017,11,28,Tuesday
2,4,8,12,2018,3,25,Sunday
1,2,34,36,2018,6,6,Wednseday
5,7,13,20,2017,11,24,Friday
1,8,10,18,2018,7,16,Monday
4,14,18,32,2017,4,13,Thursday
6,10,18,28,2017,11,1,Wednseday
2,22,15,37,2017,5,16,Tuesday
6,8,5,13,2017,6,29,Thursday
0,3,5,8,2018,7,10,Tuesday
1,4,19,23,2017,8,14,Monday
1,10,15,25,2018,5,7,Monday
3,10,20,30,2017,8,7,Monday
2,10,13,23,2017,5,21,Sunday
7,29,10,39,2017,4,20,Thursday
6,9,7,16,2018,8,14,Tuesday
1,4,16,20,2017,11,23,Thursday
0,7,18,25,2018,4,30,Monday
1,5,19,24,2018,2,2,Friday
1,7,4,11,2018,8,16,Thursday
2,10,9,19,2017,11,22,Wednseday
1,15,8,23,2017,12,4,Monday
4,18,21,39,2017,3,4,Saturday
1,5,22,27,2017,10,4,Wednseday
2,16,13,29,2017,7,16,Sunday
3,17,8,25,2017,3,17,Friday
5,7,5,12,2018,3,16,Friday
1,6,16,22,2017,11,26,Sunday
1,4,10,14,2018,5,3,Thursday
2,12,18,30,2017,10,29,Sunday
0,7,21,28,2017,10,4,Wednseday
1,12,20,32,2018,2,4,Sunday
4,18,6,24,2017,12,4,Monday
2,13,5,18,2017,3,26,Sunday
1,5,10,15,2018,5,3,Thursday
3,25,8,33,2018,2,3,Saturday
11,14,10,24,2018,7,13,Friday
1,5,16,21,2018,6,13,Wednseday
6,12,10,22,2018,5,2,Wednseday
1,5,11,16,2017,12,6,Wednseday
1,9,11,20,2018,7,24,Tuesday
1,13,9,22,2017,7,4,Tuesday
2,6,14,20,2018,2,20,Tuesday
6,14,9,23,2017,10,3,Tuesday
0,3,14,17,2017,3,20,Monday
2,6,18,24,2017,12,3,Sunday
3,6,12,18,2018,7,7,Saturday
0,20,12,32,2017,12,1,Friday
3,6,6,12,2018,8,24,Friday
3,8,4,12,2018,2,14,Wednseday
2,3,14,17,2017,6,4,Sunday
2,5,32,37,2017,12,24,Sunday
1,9,16,25,2017,8,6,Sunday
3,8,35,43,2017,10,17,Tuesday
4,14,6,20,2018,5,17,Thursday
6,17,35,52,2017,10,28,Saturday
1,7,32,39,2017,1,12,Thursday
6,13,7,20,2018,7,10,Tuesday
2,3,12,15,2018,2,27,Tuesday
3,14,16,30,2018,3,24,Saturday
2,3,8,11,2018,4,1,Sunday
3,13,0,13,2018,3,24,Saturday
2,9,14,23,2017,7,17,Monday
4,16,12,28,2017,3,20,Monday
2,8,11,19,2018,2,28,Wednseday
1,8,12,20,2017,11,24,Friday
1,7,31,38,2018,7,2,Monday
7,12,8,20,2017,3,31,Friday
4,12,20,32,2017,12,9,Saturday
1,7,6,13,2018,8,9,Thursday
0,5,20,25,2017,8,17,Thursday
4,5,10,15,2018,1,15,Monday
4,8,12,20,2017,8,17,Thursday
2,10,16,26,2017,10,22,Sunday
1,7,15,22,2018,3,20,Tuesday
6,15,17,32,2018,1,4,Thursday
0,7,6,13,2017,5,25,Thursday
1,8,15,23,2017,9,10,Sunday
1,8,17,25,2017,10,23,Monday
2,42,-5,37,2017,1,31,Tuesday
1,2,9,11,2018,4,15,Sunday
2,11,12,23,2018,4,17,Tuesday
3,8,19,27,2017,2,7,Tuesday
2,6,24,30,2018,6,23,Saturday
2,5,8,13,2018,7,18,Wednseday
1,7,21,28,2017,8,17,Thursday
4,12,21,33,2018,4,13,Friday
2,7,13,20,2017,5,11,Thursday
3,13,13,26,2017,11,25,Saturday
4,17,11,28,2017,7,7,Friday
1,14,22,36,2017,12,5,Tuesday
2,9,10,19,2017,11,5,Sunday
1,2,13,15,2018,4,11,Wednseday
4,5,20,25,2018,6,21,Thursday
3,6,11,17,2018,8,17,Friday
2,7,28,35,2018,6,26,Tuesday
3,8,14,22,2018,1,2,Tuesday
3,12,8,20,2018,7,21,Saturday
1,38,-14,24,2017,11,28,Tuesday
2,42,-24,18,2017,11,27,Monday
1,4,11,15,2018,8,12,Sunday
10,11,3,14,2018,8,10,Friday
2,5,7,12,2017,7,2,Sunday
1,4,8,12,2018,3,1,Thursday
0,3,13,16,2018,8,14,Tuesday
7,11,15,26,2018,1,19,Friday
3,4,20,24,2018,6,4,Monday
2,8,11,19,2018,2,25,Sunday
0,7,13,20,2017,10,11,Wednseday
2,10,14,24,2017,11,26,Sunday
3,5,9,14,2018,4,27,Friday
5,9,19,28,2018,4,18,Wednseday
2,19,2,21,2017,3,22,Wednseday
3,4,8,12,2017,8,27,Sunday
1,13,16,29,2017,6,13,Tuesday
5,12,10,22,2018,3,22,Thursday
2,16,3,19,2018,4,1,Sunday
3,14,16,30,2017,11,11,Saturday
3,11,16,27,2017,12,16,Saturday
1,12,22,34,2017,7,6,Thursday
5,11,27,38,2018,8,18,Saturday
5,21,7,28,2018,1,5,Friday
2,9,21,30,2017,10,7,Saturday
1,7,7,14,2018,8,16,Thursday
0,1,20,21,2017,8,21,Monday
2,19,6,25,2018,5,19,Saturday
3,5,10,15,2017,6,11,Sunday
4,7,56,63,2016,10,4,Tuesday
1,9,11,20,2017,7,18,Tuesday
5,17,8,25,2017,11,24,Friday
5,23,12,35,2018,5,17,Thursday
2,12,19,31,2018,2,3,Saturday
8,19,20,39,2017,6,18,Sunday
2,9,7,16,2018,2,5,Monday
2,4,11,15,2017,11,26,Sunday
1,2,11,13,2017,7,5,Wednseday
1,15,22,37,2017,12,4,Monday
4,5,13,18,2018,4,12,Thursday
1,6,2,8,2018,5,22,Tuesday
1,36,-14,22,2018,2,26,Monday
3,20,-2,18,2018,3,9,Friday
7,15,8,23,2018,1,17,Wednseday
1,13,13,26,2018,2,8,Thursday
2,3,16,19,2017,6,25,Sunday
1,33,16,49,2017,1,12,Thursday
4,14,19,33,2018,3,2,Friday
3,11,20,31,2017,12,8,Friday
1,13,6,19,2017,10,25,Wednseday
6,10,10,20,2018,5,8,Tuesday
3,18,7,25,2017,5,26,Friday
1,3,12,15,2018,7,1,Sunday
2,15,21,36,2017,3,7,Tuesday
2,8,28,36,2018,6,5,Tuesday
3,6,13,19,2017,10,20,Friday
1,6,20,26,2017,11,15,Wednseday
1,7,16,23,2017,4,5,Wednseday
10,50,-8,42,2017,11,27,Monday
2,3,14,17,2017,12,12,Tuesday
2,11,20,31,2017,2,6,Monday
4,40,-9,31,2018,3,2,Friday
2,8,15,23,2018,4,9,Monday
6,24,-7,17,2017,10,17,Tuesday
0,13,21,34,2017,12,28,Thursday
2,9,18,27,2017,7,18,Tuesday
2,5,7,12,2018,7,29,Sunday
2,18,4,22,2017,11,28,Tuesday
2,9,11,20,2017,7,15,Saturday
1,2,10,12,2018,4,18,Wednseday
4,6,16,22,2017,7,20,Thursday
5,13,13,26,2018,3,30,Friday
6,9,25,34,2018,6,19,Tuesday
3,53,-33,20,2018,2,27,Tuesday
6,12,10,22,2017,7,12,Wednseday
7,8,4,12,2018,4,12,Thursday
2,4,11,15,2018,5,14,Monday
3,18,10,28,2017,11,7,Tuesday
1,10,27,37,2018,3,4,Sunday
2,3,9,12,2018,5,12,Saturday
12,34,-10,24,2018,2,18,Sunday
4,9,8,17,2017,9,10,Sunday
6,12,8,20,2017,7,15,Saturday
3,19,1,20,2018,5,18,Friday
2,10,15,25,2018,4,28,Saturday
4,13,9,22,2017,9,21,Thursday
3,8,10,18,2018,5,7,Monday
6,19,7,26,2018,2,9,Friday
1,3,11,14,2018,8,15,Wednseday
5,10,19,29,2018,3,18,Sunday
3,31,-5,26,2017,11,26,Sunday
0,5,19,24,2017,7,28,Friday
3,13,7,20,2018,8,14,Tuesday
3,4,7,11,2018,6,8,Friday
3,16,13,29,2017,12,31,Sunday
1,15,9,24,2018,7,9,Monday
14,38,-13,25,2017,11,13,Monday
3,5,5,10,2018,5,4,Friday
0,7,13,20,2018,7,17,Tuesday
4,10,15,25,2017,7,28,Friday
2,20,2,22,2017,6,27,Tuesday
1,32,3,35,2018,2,8,Thursday
2,17,13,30,2018,3,3,Saturday
4,12,11,23,2017,7,29,Saturday
2,12,15,27,2018,4,25,Wednseday
2,10,15,25,2018,2,18,Sunday
1,11,23,34,2018,4,26,Thursday
3,12,44,56,2018,3,9,Friday
1,13,15,28,2017,12,21,Thursday
2,11,29,40,2018,6,23,Saturday
1,15,42,57,2018,5,27,Sunday
1,13,9,22,2017,5,10,Wednseday
6,11,42,53,2016,10,8,Saturday
4,19,14,33,2018,3,30,Friday
1,7,43,50,2018,6,4,Monday
3,27,-1,26,2017,11,17,Friday
4,15,14,29,2017,12,4,Monday
1,14,13,27,2018,4,26,Thursday
1,5,25,30,2018,3,18,Sunday
5,5,14,19,2018,1,5,Friday
1,30,0,30,2018,3,25,Sunday
1,10,12,22,2017,3,19,Sunday
5,9,26,35,2018,6,13,Wednseday
7,35,-5,30,2017,12,6,Wednseday
2,6,11,17,2018,3,27,Tuesday
15,18,2,20,2018,8,7,Tuesday
1,2,6,8,2018,8,15,Wednseday
1,9,17,26,2017,4,26,Wednseday
14,17,18,35,2017,10,10,Tuesday
5,15,14,29,2017,11,9,Thursday
2,5,22,27,2017,12,16,Saturday
1,12,18,30,2017,9,17,Sunday
10,17,3,20,2017,6,16,Friday
2,14,8,22,2017,7,12,Wednseday
3,10,17,27,2018,2,20,Tuesday
3,4,7,11,2017,7,3,Monday
2,31,-3,28,2018,2,5,Monday
1,15,29,44,2018,5,28,Monday
2,7,3,10,2018,8,20,Monday
8,15,17,32,2017,12,7,Thursday
3,11,13,24,2017,11,24,Friday
3,12,7,19,2018,3,17,Saturday
7,22,4,26,2017,12,14,Thursday
4,6,13,19,2017,3,2,Thursday
2,7,6,13,2018,3,21,Wednseday
1,7,29,36,2017,3,29,Wednseday
1,11,12,23,2018,5,6,Sunday
0,7,6,13,2018,8,14,Tuesday
2,24,0,24,2018,2,12,Monday
1,5,7,12,2018,3,15,Thursday
1,6,9,15,2018,1,24,Wednseday
1,10,20,30,2018,6,12,Tuesday
2,13,29,42,2018,6,6,Wednseday
5,24,3,27,2017,12,23,Saturday
1,17,1,18,2018,5,20,Sunday
1,4,12,16,2018,8,26,Sunday
2,19,2,21,2017,11,14,Tuesday
3,31,-6,25,2018,3,25,Sunday
4,19,4,23,2017,4,1,Saturday
4,8,19,27,2018,6,22,Friday
1,7,25,32,2018,4,23,Monday
5,10,15,25,2018,1,12,Friday
2,10,27,37,2018,1,13,Saturday
2,11,21,32,2018,1,29,Monday
2,3,8,11,2018,7,8,Sunday
2,9,11,20,2017,8,15,Tuesday
1,4,21,25,2017,12,17,Sunday
4,5,8,13,2017,9,7,Thursday
2,3,10,13,2018,5,5,Saturday
3,4,16,20,2018,6,23,Saturday
3,20,8,28,2017,6,27,Tuesday
2,6,16,22,2018,7,31,Tuesday
1,9,28,37,2018,4,16,Monday
2,11,20,31,2017,8,6,Sunday
5,8,32,40,2018,3,8,Thursday
1,23,-2,21,2018,3,1,Thursday
4,25,-7,18,2018,3,1,Thursday
1,8,30,38,2018,5,28,Monday
6,18,14,32,2017,7,6,Thursday
2,7,7,14,2017,6,6,Tuesday
1,8,31,39,2018,6,4,Monday
0,3,16,19,2018,4,20,Friday
1,3,4,7,2018,8,21,Tuesday
1,4,10,14,2018,5,22,Tuesday
3,24,0,24,2018,3,23,Friday
4,5,5,10,2018,5,4,Friday
5,8,12,20,2017,9,14,Thursday
3,17,6,23,2018,7,17,Tuesday
4,14,19,33,2018,2,15,Thursday
4,5,8,13,2017,6,16,Friday
3,12,15,27,2018,1,19,Friday
2,34,-5,29,2018,3,18,Sunday
2,7,14,21,2017,12,12,Tuesday
5,17,9,26,2017,5,10,Wednseday
2,4,20,24,2018,1,15,Monday
1,8,14,22,2018,5,7,Monday
8,25,-6,19,2018,5,13,Sunday
6,24,3,27,2018,2,10,Saturday
1,9,14,23,2017,5,21,Sunday
3,18,0,18,2018,7,22,Sunday
4,7,15,22,2017,10,30,Monday
1,4,11,15,2018,5,3,Thursday
0,9,22,31,2018,4,23,Monday
2,28,-7,21,2018,3,6,Tuesday
3,13,18,31,2017,3,4,Saturday
0,6,7,13,2018,3,21,Wednseday
2,13,18,31,2018,1,16,Tuesday
3,18,4,22,2017,11,26,Sunday
4,8,3,11,2017,5,15,Monday
2,11,12,23,2018,2,28,Wednseday
2,8,8,16,2018,7,31,Tuesday
2,10,20,30,2018,1,22,Monday
2,11,18,29,2017,11,5,Sunday
5,10,10,20,2017,8,4,Friday
3,8,13,21,2018,5,8,Tuesday
2,22,-1,21,2018,5,16,Wednseday
1,20,1,21,2017,3,16,Thursday
1,8,15,23,2018,1,28,Sunday
4,6,7,13,2017,11,3,Friday
1,16,19,35,2018,6,11,Monday
1,11,45,56,2018,5,25,Friday
1,8,23,31,2017,5,22,Monday
5,11,8,19,2018,3,17,Saturday
2,7,12,19,2017,3,1,Wednseday
1,8,12,20,2017,8,2,Wednseday
1,9,18,27,2017,12,14,Thursday
2,12,18,30,2018,1,15,Monday
2,13,30,43,2018,5,30,Wednseday
1,12,20,32,2018,1,25,Thursday
1,7,22,29,2018,1,2,Tuesday
3,4,2,6,2018,8,4,Saturday
1,14,26,40,2018,4,12,Thursday
1,11,19,30,2017,11,13,Monday
2,7,20,27,2018,2,7,Wednseday
7,24,6,30,2018,1,10,Wednseday
10,15,13,28,2018,7,24,Tuesday
2,5,14,19,2017,8,6,Sunday
3,14,23,37,2018,1,24,Wednseday
0,3,11,14,2018,7,30,Monday
2,11,20,31,2018,6,30,Saturday
1,14,13,27,2017,6,8,Thursday
4,12,7,19,2018,7,19,Thursday
5,14,5,19,2018,5,16,Wednseday
1,13,14,27,2018,4,12,Thursday
4,8,16,24,2018,2,2,Friday
4,12,10,22,2017,10,12,Thursday
2,5,15,20,2018,4,28,Saturday
1,7,23,30,2018,4,10,Tuesday
2,4,7,11,2018,7,8,Sunday
1,6,18,24,2018,3,13,Tuesday
5,8,11,19,2017,8,31,Thursday
2,23,11,34,2017,7,4,Tuesday
4,7,52,59,2016,10,8,Saturday
4,11,14,25,2018,4,13,Friday
3,18,9,27,2017,12,1,Friday
4,16,-1,15,2018,3,12,Monday
4,7,17,24,2017,11,25,Saturday
1,6,3,9,2018,8,8,Wednseday
0,1,19,20,2017,12,20,Wednseday
2,12,17,29,2017,2,8,Wednseday
7,19,14,33,2017,12,28,Thursday
2,10,13,23,2017,9,24,Sunday
5,8,13,21,2018,7,19,Thursday
1,7,28,35,2018,7,3,Tuesday
4,6,7,13,2018,3,29,Thursday
1,12,9,21,2018,3,8,Thursday
3,34,0,34,2017,9,30,Saturday
2,7,30,37,2018,4,21,Saturday
2,13,34,47,2018,6,6,Wednseday
20,58,-29,29,2018,2,7,Wednseday
2,8,15,23,2017,5,7,Sunday
6,19,14,33,2017,11,24,Friday
3,16,7,23,2017,9,26,Tuesday
1,18,8,26,2017,8,3,Thursday
20,46,-21,25,2018,3,3,Saturday
4,17,1,18,2018,3,3,Saturday
7,22,6,28,2017,12,20,Wednseday
1,8,13,21,2017,11,13,Monday
2,26,-4,22,2018,2,13,Tuesday
0,7,6,13,2018,6,13,Wednseday
1,11,6,17,2018,4,2,Monday
0,9,20,29,2017,12,18,Monday
0,7,44,51,2018,5,30,Wednseday
5,12,3,15,2018,8,2,Thursday
4,12,15,27,2018,3,2,Friday
1,9,8,17,2017,11,20,Monday
5,6,18,24,2017,12,29,Friday
5,22,8,30,2018,1,17,Wednseday
3,13,11,24,2017,7,25,Tuesday
0,10,13,23,2017,6,13,Tuesday
26,35,9,44,2018,1,13,Saturday
12,18,6,24,2018,2,10,Saturday
2,3,11,14,2017,6,20,Tuesday
1,18,43,61,2017,10,19,Thursday
4,27,-4,23,2018,1,29,Monday
16,17,40,57,2018,1,21,Sunday
1,3,7,10,2018,7,23,Monday
0,29,-1,28,2018,4,27,Friday
1,12,4,16,2018,8,6,Monday
3,13,19,32,2018,7,20,Friday
1,15,23,38,2018,4,17,Tuesday
2,6,30,36,2017,12,31,Sunday
3,14,14,28,2017,11,20,Monday
1,2,7,9,2018,5,21,Monday
2,6,22,28,2018,8,14,Tuesday
1,6,20,26,2017,12,1,Friday
6,14,12,26,2017,7,5,Wednseday
2,7,21,28,2018,6,27,Wednseday
3,9,12,21,2017,4,24,Monday
1,4,14,18,2018,2,1,Thursday
1,11,14,25,2017,6,8,Thursday
2,15,7,22,2017,11,7,Tuesday
4,15,12,27,2018,2,2,Friday
4,5,25,30,2018,3,24,Saturday
1,7,22,29,2018,5,15,Tuesday
1,7,25,32,2018,6,28,Thursday
1,3,15,18,2017,8,27,Sunday
2,16,8,24,2018,7,16,Monday
1,2,9,11,2017,8,14,Monday
2,5,13,18,2018,7,22,Sunday
6,42,-15,27,2018,1,23,Tuesday
2,14,8,22,2017,8,30,Wednseday
1,16,3,19,2017,5,14,Sunday
2,8,18,26,2018,3,25,Sunday
3,8,16,24,2018,4,22,Sunday
1,22,3,25,2018,2,25,Sunday
5,6,8,14,2018,3,23,Friday
1,16,9,25,2018,4,29,Sunday
1,4,15,19,2017,10,15,Sunday
3,13,19,32,2017,7,7,Friday
3,10,20,30,2018,5,6,Sunday
2,9,14,23,2017,10,11,Wednseday
1,4,12,16,2018,8,20,Monday
0,1,12,13,2017,8,8,Tuesday
7,10,13,23,2018,1,16,Tuesday
6,14,20,34,2018,5,3,Thursday
0,38,-12,26,2018,3,9,Friday
2,13,9,22,2017,11,8,Wednseday
1,43,-7,36,2017,4,5,Wednseday
0,7,22,29,2017,6,29,Thursday
6,11,7,18,2018,8,16,Thursday
1,5,15,20,2017,7,7,Friday
11,16,17,33,2017,10,8,Sunday
2,8,13,21,2017,11,6,Monday
4,22,5,27,2018,2,23,Friday
2,8,16,24,2017,3,20,Monday
5,9,18,27,2017,9,20,Wednseday
1,7,3,10,2018,8,13,Monday
3,7,18,25,2018,5,4,Friday
6,12,13,25,2017,6,15,Thursday
3,17,24,41,2017,8,4,Friday
5,30,28,58,2018,6,2,Saturday
11,18,2,20,2017,11,24,Friday
4,5,3,8,2018,8,16,Thursday
0,19,40,59,2018,8,3,Friday
1,7,15,22,2017,6,29,Thursday
22,22,1,23,2018,2,13,Tuesday
1,21,12,33,2017,12,7,Thursday
1,6,22,28,2017,11,30,Thursday
4,10,14,24,2017,3,3,Friday
2,14,13,27,2017,6,14,Wednseday
4,6,19,25,2018,6,22,Friday
1,6,8,14,2018,4,25,Wednseday
3,7,10,17,2018,6,11,Monday
4,15,9,24,2017,5,1,Monday
3,4,7,11,2018,4,1,Sunday
2,8,15,23,2018,7,15,Sunday
22,28,-5,23,2018,7,10,Tuesday
2,13,15,28,2017,5,24,Wednseday
6,23,6,29,2018,1,17,Wednseday
1,30,-7,23,2018,3,6,Tuesday
3,6,12,18,2018,7,7,Saturday
4,18,16,34,2018,7,26,Thursday
8,14,14,28,2017,11,29,Wednseday
1,18,13,31,2017,11,27,Monday
6,13,8,21,2017,11,23,Thursday
3,18,8,26,2017,7,29,Saturday
3,10,17,27,2018,5,8,Tuesday
0,8,15,23,2018,7,16,Monday
1,12,31,43,2017,6,7,Wednseday
3,11,20,31,2017,9,15,Friday
1,2,4,6,2018,8,14,Tuesday
3,21,16,37,2017,11,4,Saturday
18,25,4,29,2018,7,15,Sunday
3,12,11,23,2017,10,15,Sunday
1,13,11,24,2018,3,20,Tuesday
4,27,4,31,2018,4,3,Tuesday
1,3,14,17,2018,2,4,Sunday
2,9,28,37,2018,7,22,Sunday
5,17,4,21,2017,6,2,Friday
3,27,-3,24,2018,4,24,Tuesday
1,23,13,36,2017,8,13,Sunday
1,4,13,17,2018,4,23,Monday
6,17,8,25,2017,9,2,Saturday
21,39,-5,34,2017,12,1,Friday
2,48,-16,32,2018,4,2,Monday
7,12,27,39,2017,9,28,Thursday
5,8,11,19,2018,8,2,Thursday
7,16,0,16,2018,8,7,Tuesday
2,9,21,30,2018,4,11,Wednseday
1,6,20,26,2017,6,8,Thursday
3,24,5,29,2017,2,7,Tuesday
2,5,6,11,2018,8,12,Sunday
3,22,9,31,2017,12,12,Tuesday
2,4,9,13,2017,7,22,Saturday
1,4,12,16,2018,7,9,Monday
1,11,8,19,2018,7,12,Thursday
4,5,7,12,2018,6,14,Thursday
0,13,8,21,2018,8,1,Wednseday
3,9,15,24,2017,10,16,Monday
4,29,10,39,2018,2,1,Thursday
1,8,7,15,2018,8,7,Tuesday
1,14,9,23,2017,11,6,Monday
2,7,16,23,2017,8,21,Monday
4,18,8,26,2017,7,28,Friday
5,15,21,36,2017,5,11,Thursday
1,13,15,28,2018,1,25,Thursday
2,9,34,43,2018,6,5,Tuesday
2,8,17,25,2018,5,10,Thursday
2,10,5,15,2017,11,12,Sunday
11,17,-6,11,2018,8,5,Sunday
4,24,6,30,2017,9,11,Monday
2,5,18,23,2017,9,24,Sunday
34,49,-2,47,2018,1,25,Thursday
2,10,49,59,2017,3,20,Monday
10,17,14,31,2018,6,24,Sunday
1,9,21,30,2018,6,12,Tuesday
4,10,11,21,2017,3,10,Friday
1,2,13,15,2018,6,19,Tuesday
2,9,14,23,2018,5,13,Sunday
1,11,10,21,2017,3,2,Thursday
0,12,17,29,2018,1,10,Wednseday
1,12,34,46,2018,5,31,Thursday
5,20,13,33,2017,3,2,Thursday
0,7,16,23,2017,5,24,Wednseday
5,33,-12,21,2017,3,1,Wednseday
5,22,10,32,2018,2,12,Monday
1,9,19,28,2018,1,24,Wednseday
2,8,35,43,2018,6,10,Sunday
1,13,20,33,2017,12,14,Thursday
1,4,22,26,2018,7,1,Sunday
1,7,19,26,2018,8,16,Thursday
7,15,17,32,2017,7,17,Monday
4,11,17,28,2017,5,19,Friday
1,12,18,30,2017,7,12,Wednseday
2,10,12,22,2017,7,5,Wednseday
2,29,-6,23,2018,2,26,Monday
3,4,9,13,2018,6,15,Friday
3,4,11,15,2017,11,26,Sunday
1,7,22,29,2018,2,1,Thursday
1,5,6,11,2018,8,16,Thursday
21,24,-6,18,2018,1,5,Friday
4,18,16,34,2018,1,13,Saturday
42,54,-24,30,2018,1,15,Monday
1,15,9,24,2018,5,21,Monday
2,4,20,24,2018,3,18,Sunday
1,4,12,16,2017,10,16,Monday
0,2,13,15,2018,4,30,Monday
3,29,0,29,2018,5,7,Monday
3,12,34,46,2018,6,24,Sunday
0,3,25,28,2018,7,10,Tuesday
5,40,-13,27,2017,10,20,Friday
1,4,5,9,2018,8,20,Monday
3,10,8,18,2018,1,15,Monday
2,17,18,35,2017,12,4,Monday
0,17,26,43,2018,6,4,Monday
1,38,-7,31,2017,11,26,Sunday
1,10,20,30,2017,11,13,Monday
0,9,27,36,2018,5,30,Wednseday
2,11,12,23,2017,12,6,Wednseday
3,8,14,22,2017,4,2,Sunday
1,2,8,10,2018,3,5,Monday
1,10,24,34,2017,10,10,Tuesday
4,11,22,33,2018,6,14,Thursday
1,2,18,20,2017,8,2,Wednseday
14,17,2,19,2018,8,10,Friday
1,5,11,16,2018,8,20,Monday
1,9,16,25,2018,2,15,Thursday
1,13,13,26,2017,10,19,Thursday
2,10,15,25,2017,6,3,Saturday
1,4,8,12,2017,11,23,Thursday
1,5,0,5,2018,8,16,Thursday
1,9,16,25,2017,10,16,Monday
0,2,14,16,2018,4,30,Monday
1,7,12,19,2018,2,7,Wednseday
0,5,21,26,2018,5,16,Wednseday
3,5,21,26,2017,2,5,Sunday
2,8,18,26,2018,1,25,Thursday
0,3,33,36,2017,8,8,Tuesday
6,9,11,20,2018,7,18,Wednseday
1,6,15,21,2017,3,21,Tuesday
1,6,15,21,2017,11,8,Wednseday
1,9,17,26,2017,9,20,Wednseday
2,17,4,21,2018,4,9,Monday
3,4,20,24,2018,2,17,Saturday
3,10,9,19,2017,10,13,Friday
2,10,15,25,2018,5,7,Monday
1,6,16,22,2017,11,7,Tuesday
1,14,17,31,2018,5,7,Monday
4,11,24,35,2017,8,18,Friday
1,20,-1,19,2017,10,15,Sunday
6,13,9,22,2017,7,25,Tuesday
2,7,14,21,2017,11,7,Tuesday
3,21,-2,19,2017,11,26,Sunday
5,19,14,33,2018,1,12,Friday
18,24,9,33,2018,1,21,Sunday
6,7,0,7,2018,8,3,Friday
0,29,-2,27,2017,12,13,Wednseday
2,8,30,38,2018,8,7,Tuesday
4,5,9,14,2018,2,23,Friday
2,8,7,15,2018,7,17,Tuesday
2,3,1,4,2018,7,30,Monday
5,13,17,30,2018,1,17,Wednseday
3,11,8,19,2018,4,6,Friday
4,5,6,11,2018,5,10,Thursday
1,13,13,26,2018,5,2,Wednseday
3,9,17,26,2017,8,13,Sunday
7,16,5,21,2017,5,29,Monday
8,16,14,30,2017,9,10,Sunday
1,8,11,19,2018,7,25,Wednseday
7,21,5,26,2018,2,22,Thursday
12,24,13,37,2018,4,2,Monday
2,10,10,20,2017,11,28,Tuesday
3,17,15,32,2018,2,17,Saturday
4,18,7,25,2017,8,17,Thursday
2,5,3,8,2018,7,25,Wednseday
2,10,21,31,2017,10,23,Monday
1,2,12,14,2018,3,19,Monday
1,4,12,16,2018,3,5,Monday
2,14,15,29,2017,9,18,Monday
2,12,20,32,2017,6,24,Saturday
8,20,2,22,2017,7,5,Wednseday
5,16,6,22,2017,10,16,Monday
5,13,15,28,2018,4,19,Thursday
6,17,10,27,2017,10,7,Saturday
0,6,13,19,2018,8,22,Wednseday
11,18,-4,14,2018,5,18,Friday
1,9,23,32,2018,5,13,Sunday
1,21,-7,14,2017,6,26,Monday
1,12,9,21,2018,5,9,Wednseday
7,11,9,20,2017,11,14,Tuesday
5,11,8,19,2017,10,12,Thursday
7,16,20,36,2017,7,24,Monday
5,13,17,30,2018,1,6,Saturday
0,14,15,29,2017,3,27,Monday
22,30,-10,20,2018,7,11,Wednseday
2,15,3,18,2017,4,23,Sunday
4,19,0,19,2018,5,17,Thursday
3,10,24,34,2017,7,21,Friday
14,18,20,38,2018,4,2,Monday
2,3,17,20,2017,12,13,Wednseday
6,20,14,34,2018,1,3,Wednseday
1,6,13,19,2018,7,25,Wednseday
6,9,18,27,2018,7,11,Wednseday
2,8,15,23,2018,8,19,Sunday
2,8,12,20,2017,8,8,Tuesday
4,11,4,15,2018,7,12,Thursday
2,14,6,20,2018,3,6,Tuesday
4,5,17,22,2017,3,5,Sunday
1,4,25,29,2017,2,13,Monday
0,25,3,28,2018,5,10,Thursday
6,17,5,22,2017,5,17,Wednseday
1,18,11,29,2017,12,11,Monday
3,11,14,25,2017,6,2,Friday
1,14,21,35,2018,3,21,Wednseday
5,20,1,21,2018,3,23,Friday
5,32,19,51,2018,4,28,Saturday
0,6,14,20,2018,4,18,Wednseday
1,4,-1,3,2018,8,6,Monday
2,8,4,12,2017,10,14,Saturday
2,3,0,3,2018,8,21,Tuesday
1,4,17,21,2018,7,3,Tuesday
4,48,-22,26,2018,2,22,Thursday
3,6,7,13,2017,5,16,Tuesday
1,12,13,25,2018,4,5,Thursday
10,39,-6,33,2018,5,4,Friday
1,6,8,14,2018,5,8,Tuesday
5,8,8,16,2017,11,12,Sunday
1,8,15,23,2018,4,9,Monday
2,8,18,26,2018,5,2,Wednseday
1,2,11,13,2017,8,30,Wednseday
1,2,18,20,2017,12,21,Thursday
2,22,14,36,2017,9,26,Tuesday
5,6,13,19,2018,1,11,Thursday
1,21,18,39,2017,12,25,Monday
2,8,8,16,2018,7,25,Wednseday
4,19,-4,15,2017,5,21,Sunday
1,7,14,21,2018,3,22,Thursday
2,5,13,18,2018,7,28,Saturday
4,15,6,21,2018,2,15,Thursday
1,7,16,23,2018,4,17,Tuesday
11,18,10,28,2018,2,9,Friday
1,5,18,23,2018,4,4,Wednseday
1,14,8,22,2018,7,18,Wednseday
3,14,16,30,2017,12,30,Saturday
3,8,10,18,2017,11,13,Monday
6,14,29,43,2017,1,31,Tuesday
8,21,10,31,2018,5,21,Monday
4,15,7,22,2017,10,2,Monday
2,13,10,23,2018,1,24,Wednseday
4,6,3,9,2018,7,22,Sunday
2,5,17,22,2018,6,13,Wednseday
4,23,7,30,2018,2,12,Monday
1,3,12,15,2018,4,29,Sunday
7,18,7,25,2017,6,1,Thursday
2,14,14,28,2018,1,23,Tuesday
4,11,15,26,2018,5,11,Friday
3,14,13,27,2017,11,7,Tuesday
1,21,8,29,2018,4,17,Tuesday
3,12,26,38,2017,4,7,Friday
1,3,24,27,2017,2,21,Tuesday
3,12,6,18,2018,7,20,Friday
3,8,31,39,2017,5,22,Monday
5,13,11,24,2017,7,28,Friday
2,10,17,27,2017,9,2,Saturday
5,24,16,40,2018,1,12,Friday
2,6,15,21,2018,5,8,Tuesday
5,15,5,20,2018,4,12,Thursday
2,9,15,24,2017,12,11,Monday
43,43,-22,21,2017,3,1,Wednseday
1,4,29,33,2018,2,18,Sunday
8,9,3,12,2018,4,15,Sunday
1,2,13,15,2017,9,20,Wednseday
4,12,13,25,2017,9,8,Friday
2,29,5,34,2017,12,5,Tuesday
3,34,19,53,2017,1,28,Saturday
4,9,15,24,2018,7,16,Monday
12,20,8,28,2017,7,14,Friday
3,10,12,22,2017,8,8,Tuesday
3,11,12,23,2017,11,25,Saturday
0,21,11,32,2018,1,5,Friday
1,6,16,22,2017,11,7,Tuesday
1,28,-5,23,2018,1,29,Monday
2,3,10,13,2017,10,24,Tuesday
1,6,16,22,2017,5,16,Tuesday
1,14,21,35,2018,2,7,Wednseday
1,10,13,23,2018,3,27,Tuesday
0,8,7,15,2018,1,25,Thursday
4,7,10,17,2018,1,9,Tuesday
3,4,9,13,2017,7,18,Tuesday
3,13,20,33,2018,7,27,Friday
1,81,-66,15,2018,2,15,Thursday
6,12,10,22,2018,3,15,Thursday
1,14,8,22,2018,3,21,Wednseday
4,7,12,19,2018,3,9,Friday
2,8,15,23,2017,9,10,Sunday
9,17,-7,10,2018,7,31,Tuesday
1,17,11,28,2018,2,6,Tuesday
1,16,14,30,2018,1,9,Tuesday
1,7,15,22,2017,7,3,Monday
7,8,12,20,2018,1,9,Tuesday
2,14,23,37,2018,1,8,Monday
1,12,18,30,2018,1,24,Wednseday
17,27,21,48,2018,2,14,Wednseday
1,20,9,29,2018,1,4,Thursday
1,5,14,19,2018,5,13,Sunday
2,16,21,37,2018,6,20,Wednseday
3,7,21,28,2018,7,20,Friday
1,9,12,21,2017,12,21,Thursday
2,22,5,27,2018,3,6,Tuesday
2,24,-2,22,2018,2,26,Monday
4,12,19,31,2018,8,11,Saturday
2,6,9,15,2017,8,16,Wednseday
1,7,24,31,2018,6,4,Monday
6,30,21,51,2018,1,24,Wednseday
0,5,14,19,2018,4,25,Wednseday
14,40,-15,25,2018,3,29,Thursday
2,21,15,36,2017,5,22,Monday
1,4,14,18,2018,2,1,Thursday
5,6,6,12,2018,6,8,Friday
2,3,7,10,2018,3,19,Monday
1,6,13,19,2018,7,4,Wednseday
4,8,14,22,2017,10,26,Thursday
1,7,9,16,2018,8,7,Tuesday
1,23,1,24,2017,12,19,Tuesday
1,6,7,13,2018,8,22,Wednseday
1,6,9,15,2018,7,24,Tuesday
4,55,-33,22,2017,8,15,Tuesday
4,8,14,22,2018,4,26,Thursday
7,17,10,27,2017,6,9,Friday
3,8,11,19,2017,11,5,Sunday
5,12,24,36,2018,5,9,Wednseday
2,3,9,12,2018,4,7,Saturday
3,4,1,5,2018,8,10,Friday
1,15,24,39,2017,4,16,Sunday
2,14,13,27,2017,10,11,Wednseday
1,19,-1,18,2018,5,14,Monday
1,6,14,20,2018,2,14,Wednseday
2,7,20,27,2017,5,24,Wednseday
5,11,21,32,2017,4,28,Friday
3,11,28,39,2018,5,12,Saturday
4,5,7,12,2018,5,18,Friday
2,10,1,11,2017,11,20,Monday
4,9,16,25,2017,6,3,Saturday
5,25,-1,24,2017,11,26,Sunday
8,50,-24,26,2017,12,3,Sunday
1,14,13,27,2017,4,11,Tuesday
2,7,14,21,2018,8,13,Monday
3,10,10,20,2017,11,17,Friday
1,8,11,19,2018,7,19,Thursday
4,11,12,23,2017,12,23,Saturday
2,10,17,27,2018,2,7,Wednseday
4,7,16,23,2018,4,3,Tuesday
0,8,9,17,2017,9,5,Tuesday
7,8,5,13,2017,9,5,Tuesday
2,8,13,21,2018,2,27,Tuesday
1,2,4,6,2018,8,1,Wednseday
4,27,6,33,2017,11,24,Friday
4,14,4,18,2017,9,4,Monday
2,5,10,15,2017,11,26,Sunday
0,10,14,24,2017,6,30,Friday
7,8,2,10,2017,9,19,Tuesday
2,14,21,35,2017,4,4,Tuesday
4,10,15,25,2018,1,6,Saturday
3,16,14,30,2018,4,8,Sunday
1,15,30,45,2017,1,29,Sunday
2,11,34,45,2017,12,17,Sunday
4,17,20,37,2018,5,19,Saturday
6,12,16,28,2017,11,8,Wednseday
1,8,27,35,2018,6,26,Tuesday
4,8,10,18,2018,5,3,Thursday
2,50,-25,25,2017,12,11,Monday
7,12,23,35,2017,12,6,Wednseday
9,24,7,31,2017,12,12,Tuesday
0,28,3,31,2017,2,17,Friday
4,10,14,24,2017,12,31,Sunday
5,13,8,21,2017,9,13,Wednseday
2,9,19,28,2017,11,8,Wednseday
7,17,9,26,2018,2,9,Friday
3,14,5,19,2017,9,1,Friday
4,17,7,24,2018,1,28,Sunday
3,13,19,32,2018,8,11,Saturday
2,4,22,26,2017,11,25,Saturday
1,10,15,25,2018,2,4,Sunday
0,1,10,11,2018,5,17,Thursday
1,8,14,22,2018,6,12,Tuesday
1,5,18,23,2017,11,5,Sunday
2,10,15,25,2017,3,18,Saturday
7,12,15,27,2018,4,18,Wednseday
1,7,22,29,2018,1,17,Wednseday
4,14,11,25,2017,3,16,Thursday
0,20,6,26,2017,10,27,Friday
3,9,13,22,2018,7,15,Sunday
2,20,6,26,2018,5,16,Wednseday
1,12,16,28,2017,9,26,Tuesday
4,43,-12,31,2018,2,5,Monday
4,16,9,25,2017,8,19,Saturday
4,10,14,24,2017,10,13,Friday
1,2,3,5,2018,8,16,Thursday
1,2,2,4,2018,8,13,Monday
1,13,16,29,2017,10,26,Thursday
3,11,13,24,2017,11,24,Friday
1,8,14,22,2017,4,12,Wednseday
1,6,3,9,2018,8,14,Tuesday
6,11,17,28,2018,1,25,Thursday
2,9,17,26,2018,6,9,Saturday
1,15,8,23,2017,6,12,Monday
3,7,20,27,2017,9,29,Friday
3,12,14,26,2018,7,21,Saturday
15,22,1,23,2018,2,25,Sunday
4,15,12,27,2018,5,24,Thursday
3,18,12,30,2017,7,3,Monday
4,27,4,31,2018,1,5,Friday
3,18,1,19,2018,4,6,Friday
2,9,22,31,2017,7,4,Tuesday
2,6,14,20,2018,8,1,Wednseday
3,18,4,22,2018,1,14,Sunday
12,19,-2,17,2017,10,9,Monday
3,10,12,22,2017,11,14,Tuesday
1,14,14,28,2017,11,7,Tuesday
2,11,13,24,2017,8,7,Monday
1,10,15,25,2018,4,2,Monday
3,6,10,16,2018,3,3,Saturday
0,6,7,13,2017,5,19,Friday
5,30,2,32,2017,12,30,Saturday
1,8,17,25,2018,4,26,Thursday
1,9,14,23,2017,10,31,Tuesday
2,10,18,28,2017,7,18,Tuesday
3,6,19,25,2018,6,29,Friday
5,15,17,32,2017,2,26,Sunday
1,3,21,24,2018,2,5,Monday
8,37,-6,31,2018,3,5,Monday
2,9,16,25,2017,12,17,Sunday
3,6,13,19,2017,11,18,Saturday
4,10,20,30,2018,4,28,Saturday
2,12,13,25,2017,12,17,Sunday
0,1,9,10,2017,9,19,Tuesday
4,17,7,24,2018,2,12,Monday
8,15,19,34,2017,4,4,Tuesday
0,26,13,39,2018,2,15,Thursday
1,12,9,21,2018,3,15,Thursday
4,23,0,23,2018,3,11,Sunday
1,4,19,23,2018,8,5,Sunday
5,6,13,19,2017,8,30,Wednseday
2,26,9,35,2017,5,24,Wednseday
5,7,20,27,2018,3,16,Friday
4,11,22,33,2018,1,5,Friday
1,9,14,23,2018,1,8,Monday
1,6,14,20,2017,11,28,Tuesday
4,18,13,31,2018,4,28,Saturday
0,1,13,14,2018,5,9,Wednseday
1,10,18,28,2017,11,13,Monday
0,1,9,10,2018,3,12,Monday
13,37,-16,21,2018,5,9,Wednseday
3,9,15,24,2017,6,19,Monday
6,15,23,38,2018,1,7,Sunday
2,17,11,28,2018,2,13,Tuesday
2,15,16,31,2018,7,23,Monday
1,4,19,23,2018,1,29,Monday
2,3,10,13,2018,7,24,Tuesday
1,13,19,32,2018,5,6,Sunday
1,19,8,27,2018,3,21,Wednseday
2,16,7,23,2017,9,13,Wednseday
3,7,14,21,2018,5,11,Friday
2,10,13,23,2018,4,2,Monday
1,2,14,16,2018,1,8,Monday
1,16,21,37,2018,5,27,Sunday
0,4,14,18,2018,7,23,Monday
2,8,15,23,2017,3,27,Monday
5,15,3,18,2017,11,17,Friday
0,3,5,8,2018,7,30,Monday
6,27,-1,26,2017,11,24,Friday
2,7,11,18,2018,4,2,Monday
2,28,2,30,2018,3,18,Sunday
1,14,15,29,2017,3,27,Monday
6,13,23,36,2018,5,24,Thursday
1,5,23,28,2018,6,28,Thursday
3,9,18,27,2018,7,31,Tuesday
1,7,29,36,2018,6,26,Tuesday
4,12,14,26,2017,8,25,Friday
3,20,2,22,2018,3,20,Tuesday
1,25,0,25,2018,2,1,Thursday
4,13,14,27,2017,12,2,Saturday
5,11,16,27,2018,4,19,Thursday
3,6,15,21,2018,4,6,Friday
4,14,16,30,2018,4,28,Saturday
8,23,10,33,2017,6,11,Sunday
2,9,10,19,2018,3,3,Saturday
0,2,12,14,2018,2,26,Monday
1,7,9,16,2018,8,13,Monday
6,25,18,43,2018,2,4,Sunday
7,12,-2,10,2018,3,19,Monday
2,21,8,29,2018,2,13,Tuesday
1,9,13,22,2017,6,26,Monday
2,7,18,25,2017,12,2,Saturday
10,17,7,24,2017,4,25,Tuesday
2,3,9,12,2018,7,21,Saturday
3,19,5,24,2018,3,17,Saturday
14,27,-5,22,2017,4,20,Thursday
19,26,-5,21,2017,6,7,Wednseday
1,5,15,20,2018,6,13,Wednseday
0,2,14,16,2018,8,28,Tuesday
4,11,18,29,2017,5,14,Sunday
1,57,-26,31,2018,3,6,Tuesday
3,9,17,26,2017,5,7,Sunday
1,5,23,28,2017,5,3,Wednseday
0,2,11,13,2017,5,23,Tuesday
3,18,16,34,2018,5,11,Friday
1,8,22,30,2017,4,10,Monday
8,11,8,19,2017,6,18,Sunday
5,13,8,21,2017,4,7,Friday
2,6,20,26,2018,4,21,Saturday
2,15,9,24,2017,8,8,Tuesday
2,5,20,25,2018,7,22,Sunday
1,17,5,22,2017,10,23,Monday
1,16,4,20,2018,3,20,Tuesday
1,19,15,34,2018,5,3,Thursday
4,17,1,18,2017,9,11,Monday
1,7,14,21,2018,2,20,Tuesday
4,19,3,22,2018,2,22,Thursday
1,4,11,15,2018,8,12,Sunday
2,16,17,33,2017,3,25,Saturday
2,13,13,26,2017,11,22,Wednseday
1,3,18,21,2017,7,3,Monday
0,2,10,12,2018,6,13,Wednseday
4,14,12,26,2018,2,15,Thursday
3,7,18,25,2017,5,29,Monday
0,18,1,19,2018,5,18,Friday
1,10,18,28,2018,1,23,Tuesday
1,3,10,13,2018,7,18,Wednseday
1,2,8,10,2018,4,2,Monday
0,22,7,29,2017,2,13,Monday
1,8,20,28,2018,6,19,Tuesday
0,1,13,14,2018,6,29,Friday
2,8,14,22,2018,7,31,Tuesday
5,19,7,26,2017,7,7,Friday
5,18,11,29,2017,12,28,Thursday
6,12,23,35,2018,5,10,Thursday
3,14,10,24,2018,4,9,Monday
3,13,4,17,2017,9,12,Tuesday
2,6,14,20,2017,10,14,Saturday
3,9,20,29,2018,4,29,Sunday
2,15,8,23,2017,11,6,Monday
3,17,1,18,2018,5,20,Sunday
1,12,21,33,2017,8,10,Thursday
2,10,11,21,2018,2,26,Monday
1,7,15,22,2017,11,30,Thursday
1,3,7,10,2018,4,2,Monday
2,8,30,38,2018,7,29,Sunday
3,24,1,25,2017,12,11,Monday
1,7,16,23,2018,1,3,Wednseday
3,10,10,20,2017,4,22,Saturday
3,12,14,26,2017,4,8,Saturday
0,16,6,22,2018,5,22,Tuesday
1,6,14,20,2017,10,17,Tuesday
4,6,10,16,2017,6,10,Saturday
5,12,15,27,2018,1,10,Wednseday
6,11,14,25,2018,4,5,Thursday
9,30,9,39,2017,2,20,Monday
1,16,18,34,2018,4,17,Tuesday
2,18,11,29,2018,2,4,Sunday
9,11,7,18,2017,10,30,Monday
1,11,28,39,2018,4,29,Sunday
7,9,7,16,2018,7,23,Monday
1,7,10,17,2018,7,31,Tuesday
7,11,10,21,2017,8,28,Monday
1,8,14,22,2017,3,15,Wednseday
5,7,15,22,2017,4,6,Thursday
1,6,17,23,2018,7,4,Wednseday
7,14,8,22,2017,6,27,Tuesday
2,8,21,29,2017,2,14,Tuesday
3,6,8,14,2018,5,18,Friday
2,14,21,35,2018,6,13,Wednseday
4,8,8,16,2017,11,25,Saturday
7,15,11,26,2017,12,13,Wednseday
1,7,11,18,2017,7,10,Monday
2,5,12,17,2018,5,5,Saturday
5,11,11,22,2017,2,26,Sunday
5,15,7,22,2018,3,29,Thursday
0,40,-11,29,2018,2,7,Wednseday
1,5,23,28,2017,1,25,Wednseday
2,13,10,23,2018,2,14,Wednseday
1,8,15,23,2017,10,29,Sunday
1,3,18,21,2017,5,8,Monday
6,20,22,42,2018,8,7,Tuesday
1,6,6,12,2018,8,23,Thursday
6,8,4,12,2017,11,22,Wednseday
2,10,16,26,2017,3,11,Saturday
1,2,11,13,2018,3,27,Tuesday
3,6,11,17,2018,7,21,Saturday
1,7,17,24,2017,5,8,Monday
5,6,4,10,2018,7,20,Friday
4,14,7,21,2017,9,7,Thursday
5,14,13,27,2017,6,14,Wednseday
2,43,-20,23,2018,4,3,Tuesday
2,12,19,31,2017,11,12,Sunday
1,3,9,12,2018,4,18,Wednseday
0,3,11,14,2018,7,3,Tuesday
4,11,14,25,2017,6,8,Thursday
3,10,12,22,2017,4,25,Tuesday
1,9,21,30,2017,7,19,Wednseday
3,4,6,10,2017,10,27,Friday
1,4,30,34,2018,5,11,Friday
0,3,18,21,2018,7,24,Tuesday
3,17,16,33,2017,7,9,Sunday
0,17,14,31,2018,4,17,Tuesday
1,2,21,23,2018,7,18,Wednseday
1,4,10,14,2018,8,23,Thursday
18,32,-10,22,2017,11,26,Sunday
1,18,-4,14,2018,5,15,Tuesday
1,5,14,19,2018,8,1,Wednseday
1,4,15,19,2018,5,13,Sunday
3,11,37,48,2017,1,27,Friday
1,2,9,11,2018,6,24,Sunday
1,2,12,14,2018,7,3,Tuesday
5,6,17,23,2017,12,23,Saturday
0,4,18,22,2018,2,1,Thursday
1,8,11,19,2017,7,30,Sunday
2,7,36,43,2018,2,28,Wednseday
7,18,12,30,2017,5,29,Monday
2,3,5,8,2018,8,19,Sunday
3,10,14,24,2018,4,20,Friday
3,10,8,18,2017,10,14,Saturday
2,5,8,13,2017,11,16,Thursday
1,4,11,15,2018,1,16,Tuesday
2,7,20,27,2017,7,26,Wednseday
1,8,14,22,2018,4,4,Wednseday
1,4,34,38,2018,6,3,Sunday
7,16,9,25,2018,2,12,Monday
1,11,10,21,2018,4,26,Thursday
3,13,7,20,2017,11,24,Friday
1,4,9,13,2018,5,17,Thursday
4,11,15,26,2018,1,5,Friday
7,9,6,15,2018,8,20,Monday
6,12,9,21,2017,3,15,Wednseday
10,24,11,35,2017,8,25,Friday
1,6,10,16,2018,4,11,Wednseday
4,7,25,32,2017,5,5,Friday
1,11,9,20,2018,4,3,Tuesday
2,7,16,23,2017,12,5,Tuesday
3,5,6,11,2018,8,17,Friday
10,17,11,28,2018,1,9,Tuesday
1,22,13,35,2018,4,3,Tuesday
3,4,11,15,2018,1,15,Monday
13,42,-19,23,2018,2,27,Tuesday
1,13,10,23,2018,2,26,Monday
4,11,11,22,2018,2,12,Monday
3,9,18,27,2017,3,7,Tuesday
3,18,7,25,2017,11,24,Friday
2,8,28,36,2018,6,20,Wednseday
2,3,11,14,2017,11,29,Wednseday
3,11,24,35,2018,6,15,Friday
2,3,15,18,2018,4,15,Sunday
10,18,21,39,2018,6,9,Saturday
5,19,15,34,2017,4,1,Saturday
2,8,20,28,2018,5,1,Tuesday
2,4,11,15,2017,11,26,Sunday
2,6,6,12,2018,3,14,Wednseday
2,7,18,25,2017,2,6,Monday
1,2,22,24,2018,6,4,Monday
2,12,22,34,2017,12,9,Saturday
1,5,10,15,2018,8,2,Thursday
5,21,16,37,2017,11,11,Saturday
5,14,17,31,2017,2,17,Friday
6,13,14,27,2017,4,19,Wednseday
1,8,10,18,2017,8,7,Monday
3,4,9,13,2018,8,24,Friday
6,29,-3,26,2017,12,14,Thursday
2,4,3,7,2018,8,13,Monday
1,12,22,34,2017,3,23,Thursday
2,7,14,21,2017,9,13,Wednseday
3,8,2,10,2018,8,19,Sunday
8,15,12,27,2017,2,21,Tuesday
3,17,3,20,2017,7,1,Saturday
4,8,4,12,2017,6,25,Sunday
1,21,10,31,2017,4,24,Monday
15,25,32,57,2016,10,6,Thursday
1,11,7,18,2018,6,10,Sunday
3,8,15,23,2017,11,19,Sunday
2,5,13,18,2018,7,16,Monday
1,5,18,23,2017,7,9,Sunday
1,8,14,22,2017,6,26,Monday
1,3,6,9,2018,6,11,Monday
1,7,14,21,2017,11,27,Monday
3,38,-10,28,2018,1,12,Friday
1,10,28,38,2018,6,3,Sunday
2,5,2,7,2018,8,22,Wednseday
2,14,4,18,2018,7,21,Saturday
0,10,10,20,2017,10,24,Tuesday
2,5,11,16,2017,10,18,Wednseday
6,17,22,39,2017,6,2,Friday
6,6,19,25,2018,4,1,Sunday
3,16,14,30,2018,2,24,Saturday
2,11,38,49,2018,3,26,Monday
6,17,13,30,2018,6,27,Wednseday
0,6,20,26,2018,1,5,Friday
2,9,16,25,2018,3,4,Sunday
1,4,15,19,2017,12,7,Thursday
4,12,29,41,2017,1,26,Thursday
5,10,21,31,2017,9,22,Friday
5,31,0,31,2018,3,18,Sunday
6,27,0,27,2017,3,2,Thursday
2,21,2,23,2017,3,13,Monday
2,14,6,20,2017,6,20,Tuesday
2,13,17,30,2017,12,31,Sunday
4,5,17,22,2018,6,21,Thursday
26,32,-7,25,2018,8,2,Thursday
4,13,12,25,2018,3,30,Friday
5,25,15,40,2018,3,8,Thursday
1,6,14,20,2017,8,2,Wednseday
1,7,17,24,2017,7,11,Tuesday
4,41,-15,26,2017,11,24,Friday
3,11,15,26,2017,10,28,Saturday
3,5,33,38,2018,6,23,Saturday
2,7,16,23,2017,7,3,Monday
2,9,15,24,2017,6,24,Saturday
2,6,20,26,2018,7,14,Saturday
3,14,10,24,2018,1,15,Monday
1,2,10,12,2018,4,11,Wednseday
4,11,14,25,2018,5,24,Thursday
0,46,0,46,2017,1,9,Monday
1,25,-3,22,2018,3,12,Monday
1,2,23,25,2018,3,12,Monday
6,11,15,26,2017,12,8,Friday
5,14,11,25,2018,2,9,Friday
2,7,23,30,2018,6,11,Monday
3,6,18,24,2017,10,13,Friday
3,9,14,23,2017,5,21,Sunday
3,27,14,41,2017,2,17,Friday
1,4,7,11,2018,5,10,Thursday
0,16,13,29,2017,2,21,Tuesday
5,11,18,29,2017,10,19,Thursday
2,12,11,23,2018,7,1,Sunday
2,13,16,29,2017,5,24,Wednseday
1,10,19,29,2017,12,4,Monday
6,13,11,24,2018,1,16,Tuesday
1,7,17,24,2017,7,25,Tuesday
2,3,8,11,2018,5,19,Saturday
1,4,13,17,2017,9,4,Monday
5,19,7,26,2017,10,4,Wednseday
1,32,-5,27,2018,2,22,Thursday
3,5,7,12,2018,5,4,Friday
5,6,7,13,2017,7,7,Friday
1,19,13,32,2018,5,10,Thursday
0,20,8,28,2018,3,23,Friday
2,18,11,29,2018,3,5,Monday
1,6,7,13,2018,8,14,Tuesday
1,17,18,35,2018,3,19,Monday
5,13,6,19,2018,5,9,Wednseday
1,19,5,24,2018,3,4,Sunday
0,7,14,21,2017,10,11,Wednseday
3,9,17,26,2017,10,21,Saturday
3,18,23,41,2017,11,25,Saturday
1,18,32,50,2018,6,3,Sunday
1,13,9,22,2017,9,11,Monday
3,19,13,32,2018,3,3,Saturday
3,6,9,15,2017,8,8,Tuesday
2,6,18,24,2018,2,17,Saturday
2,5,8,13,2017,5,31,Wednseday
1,6,23,29,2018,1,3,Wednseday
1,7,11,18,2018,7,20,Friday
9,28,6,34,2017,8,16,Wednseday
9,22,7,29,2018,4,11,Wednseday
8,14,10,24,2017,11,24,Friday
1,8,1,9,2018,8,13,Monday
8,22,0,22,2018,2,28,Wednseday
9,21,-1,20,2017,11,8,Wednseday
11,23,15,38,2017,4,16,Sunday
2,7,9,16,2017,11,21,Tuesday
1,4,15,19,2017,8,13,Sunday
1,3,0,3,2018,8,27,Monday
3,8,15,23,2018,1,23,Tuesday
2,17,0,17,2018,5,13,Sunday
4,12,23,35,2017,12,7,Thursday
2,8,11,19,2017,7,16,Sunday
1,12,7,19,2018,8,16,Thursday
2,9,31,40,2018,5,12,Saturday
2,35,-12,23,2017,11,29,Wednseday
1,28,-10,18,2018,5,17,Thursday
1,11,8,19,2018,8,9,Thursday
6,18,16,34,2017,9,21,Thursday
2,26,5,31,2018,1,21,Sunday
4,13,13,26,2017,12,15,Friday
14,25,-7,18,2017,9,18,Monday
7,10,7,17,2017,9,4,Monday
5,13,14,27,2017,10,5,Thursday
7,45,-15,30,2018,3,20,Tuesday
5,8,4,12,2017,5,14,Sunday
8,21,2,23,2018,3,13,Tuesday
2,6,11,17,2018,7,21,Saturday
1,4,9,13,2017,6,22,Thursday
2,18,14,32,2017,2,13,Monday
2,3,7,10,2018,6,19,Tuesday
4,10,30,40,2017,4,1,Saturday
6,13,21,34,2018,3,29,Thursday
1,5,24,29,2018,6,20,Wednseday
6,8,5,13,2017,7,18,Tuesday
1,30,-1,29,2017,4,26,Wednseday
3,10,18,28,2018,1,12,Friday
1,8,9,17,2018,3,26,Monday
1,6,27,33,2018,1,14,Sunday
4,7,6,13,2017,11,17,Friday
1,6,14,20,2017,6,28,Wednseday
3,14,11,25,2018,7,13,Friday
1,7,17,24,2017,7,17,Monday
3,6,15,21,2018,4,6,Friday
4,21,20,41,2017,4,29,Saturday
2,16,6,22,2017,7,12,Wednseday
1,9,6,15,2018,4,24,Tuesday
3,21,8,29,2017,12,19,Tuesday
7,36,-7,29,2018,1,10,Wednseday
27,31,28,59,2016,10,3,Monday
1,4,14,18,2018,7,22,Sunday
0,1,5,6,2018,8,1,Wednseday
3,6,4,10,2017,10,17,Tuesday
1,12,16,28,2017,11,8,Wednseday
1,6,17,23,2018,6,12,Tuesday
1,7,7,14,2018,5,14,Monday
6,18,7,25,2017,8,25,Friday
1,11,16,27,2017,9,7,Thursday
6,13,8,21,2017,8,31,Thursday
1,10,14,24,2017,7,7,Friday
1,19,3,22,2018,5,20,Sunday
1,10,10,20,2017,5,10,Wednseday
4,27,7,34,2018,1,20,Saturday
8,16,8,24,2017,11,14,Tuesday
4,7,16,23,2017,5,22,Monday
8,13,15,28,2017,5,29,Monday
6,15,7,22,2017,7,20,Thursday
5,9,14,23,2018,1,24,Wednseday
1,2,18,20,2017,12,26,Tuesday
26,30,11,41,2017,2,8,Wednseday
1,4,20,24,2018,4,22,Sunday
2,8,28,36,2018,4,15,Sunday
1,12,10,22,2018,3,28,Wednseday
1,6,22,28,2018,6,14,Thursday
1,13,14,27,2018,5,9,Wednseday
0,10,10,20,2018,3,2,Friday
4,5,9,14,2017,7,13,Thursday
3,15,6,21,2017,8,29,Tuesday
4,17,8,25,2017,8,4,Friday
1,16,11,27,2018,3,1,Thursday
2,3,7,10,2018,3,19,Monday
3,33,-6,27,2017,12,15,Friday
4,10,15,25,2018,3,23,Friday
5,11,9,20,2017,8,17,Thursday
5,8,18,26,2017,9,23,Saturday
1,4,7,11,2017,11,6,Monday
3,5,21,26,2018,1,6,Saturday
5,9,18,27,2018,1,18,Thursday
0,1,21,22,2018,6,21,Thursday
1,6,30,36,2018,8,23,Thursday
0,6,22,28,2018,7,19,Thursday
2,26,4,30,2018,4,11,Wednseday
3,19,1,20,2018,5,18,Friday
4,13,11,24,2017,9,23,Saturday
4,12,13,25,2017,9,1,Friday
3,4,7,11,2018,6,17,Sunday
1,9,21,30,2018,5,6,Sunday
1,17,10,27,2017,10,17,Tuesday
3,6,15,21,2018,4,20,Friday
0,3,7,10,2018,8,6,Monday
0,15,23,38,2017,5,2,Tuesday
3,14,10,24,2017,3,6,Monday
7,19,8,27,2017,11,9,Thursday
0,3,10,13,2017,9,1,Friday
3,21,10,31,2018,3,30,Friday
1,9,9,18,2018,2,19,Monday
2,12,6,18,2018,5,7,Monday
2,12,10,22,2017,9,27,Wednseday
2,8,6,14,2017,11,20,Monday
9,11,12,23,2018,6,19,Tuesday
1,4,18,22,2017,3,26,Sunday
1,15,39,54,2018,6,3,Sunday
1,3,13,16,2017,12,6,Wednseday
5,11,2,13,2018,7,19,Thursday
1,2,2,4,2018,8,26,Sunday
2,9,14,23,2017,9,16,Saturday
6,9,22,31,2018,7,17,Tuesday
1,5,21,26,2018,7,1,Sunday
2,17,7,24,2018,2,25,Sunday
2,15,17,32,2018,1,15,Monday
6,7,12,19,2017,12,1,Friday
2,7,15,22,2017,5,23,Tuesday
1,8,15,23,2018,3,12,Monday
2,4,15,19,2017,3,25,Saturday
7,9,13,22,2018,6,11,Monday
2,15,15,30,2018,1,17,Wednseday
1,9,15,24,2018,1,14,Sunday
4,10,21,31,2017,10,27,Friday
4,10,6,16,2018,8,4,Saturday
3,10,12,22,2017,7,25,Tuesday
2,18,11,29,2017,11,6,Monday
2,30,-9,21,2018,3,20,Tuesday
3,13,35,48,2018,6,1,Friday
5,19,26,45,2018,1,12,Friday
5,14,19,33,2018,3,22,Thursday
0,12,7,19,2018,7,27,Friday
4,8,18,26,2018,6,24,Sunday
3,5,19,24,2018,1,7,Sunday
2,3,12,15,2018,6,13,Wednseday
1,2,15,17,2017,12,12,Tuesday
0,4,10,14,2018,8,16,Thursday
7,28,0,28,2018,2,15,Thursday
4,6,12,18,2018,3,2,Friday
6,15,5,20,2017,11,15,Wednseday
1,5,9,14,2018,7,26,Thursday
7,31,23,54,2017,9,20,Wednseday
4,6,26,32,2018,5,11,Friday
5,8,8,16,2017,11,12,Sunday
20,22,14,36,2018,1,25,Thursday
1,9,15,24,2017,11,27,Monday
0,2,12,14,2017,11,27,Monday
1,8,10,18,2018,3,18,Sunday
2,5,14,19,2018,6,23,Saturday
2,16,7,23,2017,11,19,Sunday
7,16,8,24,2017,4,11,Tuesday
0,5,21,26,2017,10,4,Wednseday
3,10,34,44,2018,6,4,Monday
2,30,-8,22,2018,3,5,Monday
1,6,7,13,2018,3,8,Thursday
1,5,20,25,2018,8,20,Monday
5,12,14,26,2017,7,6,Thursday
1,14,13,27,2017,5,23,Tuesday
1,9,15,24,2018,7,2,Monday
1,3,13,16,2018,1,10,Wednseday
1,6,14,20,2017,5,10,Wednseday
3,15,20,35,2018,1,30,Tuesday
2,19,0,19,2018,5,19,Saturday
6,9,12,21,2018,1,11,Thursday
3,10,31,41,2017,1,10,Tuesday
1,4,14,18,2018,5,14,Monday
6,8,6,14,2018,8,14,Tuesday
1,4,21,25,2017,3,12,Sunday
4,12,14,26,2018,4,21,Saturday
6,18,6,24,2017,7,8,Saturday
4,17,9,26,2017,11,25,Saturday
2,13,4,17,2018,7,17,Tuesday
5,20,12,32,2017,12,28,Thursday
11,39,-3,36,2017,10,5,Thursday
1,8,16,24,2017,5,30,Tuesday
1,7,16,23,2017,4,26,Wednseday
1,22,-1,21,2017,11,27,Monday
20,44,-22,22,2018,2,27,Tuesday
3,8,12,20,2017,7,18,Tuesday
1,15,8,23,2018,4,17,Tuesday
3,19,7,26,2018,2,16,Friday
1,19,15,34,2018,1,4,Thursday
1,31,-7,24,2018,2,5,Monday
3,26,0,26,2018,2,17,Saturday
2,5,31,36,2018,5,13,Sunday
43,46,14,60,2018,1,5,Friday
1,7,25,32,2017,6,8,Thursday
1,2,11,13,2017,6,20,Tuesday
2,16,15,31,2017,8,15,Tuesday
2,4,13,17,2017,12,11,Monday
4,16,6,22,2017,7,24,Monday
5,18,19,37,2018,3,10,Saturday
1,15,6,21,2018,4,25,Wednseday
1,7,16,23,2018,4,25,Wednseday
7,15,13,28,2017,7,17,Monday
11,23,6,29,2017,7,10,Monday
1,10,11,21,2017,3,6,Monday
0,8,15,23,2018,1,17,Wednseday
2,4,11,15,2017,11,12,Sunday
4,11,12,23,2017,4,30,Sunday
2,14,15,29,2018,1,16,Tuesday
1,11,20,31,2017,12,15,Friday
4,24,11,35,2017,8,4,Friday
1,2,25,27,2017,11,29,Wednseday
3,6,8,14,2017,11,24,Friday
1,4,15,19,2017,12,7,Thursday
5,10,15,25,2017,10,27,Friday
2,7,25,32,2018,5,12,Saturday
1,4,20,24,2018,6,10,Sunday
1,8,20,28,2018,1,8,Monday
6,12,27,39,2017,5,12,Friday
1,11,28,39,2017,1,30,Monday
2,13,14,27,2018,6,27,Wednseday
2,47,-22,25,2017,11,4,Saturday
3,10,7,17,2018,5,6,Sunday
0,15,13,28,2018,2,21,Wednseday
3,14,25,39,2018,6,11,Monday
4,29,4,33,2018,1,4,Thursday
4,5,16,21,2017,12,18,Monday
5,6,21,27,2018,8,16,Thursday
0,4,16,20,2017,7,27,Thursday
3,23,11,34,2018,1,6,Saturday
6,24,-2,22,2018,5,16,Wednseday
1,9,21,30,2017,5,29,Monday
2,7,13,20,2017,12,14,Thursday
3,6,12,18,2018,5,18,Friday
6,16,4,20,2017,11,25,Saturday
6,39,-11,28,2017,12,15,Friday
1,6,5,11,2018,8,16,Thursday
8,19,5,24,2018,2,23,Friday
2,9,10,19,2017,11,22,Wednseday
5,7,9,16,2018,1,24,Wednseday
2,9,25,34,2018,5,5,Saturday
5,31,12,43,2018,4,22,Sunday
3,13,14,27,2018,2,23,Friday
2,7,10,17,2018,7,24,Tuesday
2,3,7,10,2018,3,6,Tuesday
5,12,8,20,2017,7,26,Wednseday
5,6,7,13,2018,4,13,Friday
1,6,16,22,2017,6,27,Tuesday
2,8,15,23,2018,3,13,Tuesday
2,6,8,14,2018,5,8,Tuesday
3,58,-29,29,2018,2,27,Tuesday
1,3,12,15,2018,2,14,Wednseday
4,22,0,22,2017,11,27,Monday
6,8,0,8,2017,5,11,Thursday
6,19,15,34,2018,2,17,Saturday
0,2,24,26,2017,12,27,Wednseday
1,7,35,42,2018,4,17,Tuesday
1,2,8,10,2018,3,5,Monday
1,23,22,45,2018,6,4,Monday
2,18,-1,17,2018,5,19,Saturday
1,6,69,75,2017,2,9,Thursday
7,12,8,20,2017,10,27,Friday
2,6,33,39,2018,7,7,Saturday
5,14,7,21,2018,6,8,Friday
4,14,19,33,2018,6,29,Friday
4,41,-7,34,2017,12,2,Saturday
2,16,19,35,2017,8,14,Monday
19,28,-4,24,2018,2,23,Friday
1,18,-10,8,2018,5,17,Thursday
3,6,11,17,2018,5,18,Friday
2,3,8,11,2017,7,3,Monday
0,10,16,26,2018,5,4,Friday
3,8,15,23,2017,7,2,Sunday
3,35,-16,19,2018,4,1,Sunday
3,12,14,26,2017,4,14,Friday
1,4,14,18,2018,2,2,Friday
5,11,8,19,2018,8,12,Sunday
5,7,13,20,2018,3,15,Thursday
1,8,39,47,2017,6,28,Wednseday
6,24,10,34,2017,7,12,Wednseday
2,31,-9,22,2018,3,4,Sunday
1,15,21,36,2017,9,20,Wednseday
2,18,14,32,2018,2,24,Saturday
3,14,17,31,2017,9,25,Monday
0,8,16,24,2017,7,11,Tuesday
4,11,12,23,2017,8,6,Sunday
1,2,2,4,2018,8,27,Monday
2,3,5,8,2018,5,8,Tuesday
4,10,20,30,2017,10,7,Saturday
2,5,17,22,2018,4,8,Sunday
5,9,4,13,2017,8,24,Thursday
1,8,14,22,2017,7,18,Tuesday
3,13,8,21,2018,7,10,Tuesday
0,5,22,27,2018,6,6,Wednseday
2,11,7,18,2017,9,10,Sunday
11,18,12,30,2018,7,7,Saturday
8,30,5,35,2018,2,8,Thursday
1,8,20,28,2017,4,10,Monday
2,13,32,45,2017,2,11,Saturday
6,16,27,43,2017,1,10,Tuesday
14,19,9,28,2018,3,28,Wednseday
2,21,7,28,2018,2,13,Tuesday
5,10,11,21,2018,2,23,Friday
0,7,24,31,2017,9,1,Friday
2,5,19,24,2017,8,5,Saturday
3,5,6,11,2018,8,24,Friday
1,2,6,8,2018,5,21,Monday
0,3,12,15,2018,5,15,Tuesday
1,8,21,29,2018,6,18,Monday
1,6,12,18,2018,8,2,Thursday
0,12,17,29,2018,5,23,Wednseday
38,47,-15,32,2017,10,22,Sunday
12,25,2,27,2018,7,21,Saturday
5,12,17,29,2017,10,1,Sunday
2,3,13,16,2018,6,30,Saturday
0,9,24,33,2017,2,4,Saturday
6,14,6,20,2017,8,9,Wednseday
0,2,22,24,2017,7,4,Tuesday
4,22,3,25,2017,9,21,Thursday
3,28,-4,24,2018,2,2,Friday
6,16,5,21,2018,3,21,Wednseday
2,13,16,29,2017,12,13,Wednseday
5,13,10,23,2017,3,15,Wednseday
1,7,18,25,2018,7,16,Monday
2,16,-4,12,2018,5,2,Wednseday
0,3,11,14,2017,6,12,Monday
9,10,4,14,2017,11,13,Monday
5,6,1,7,2018,8,24,Friday
3,11,23,34,2017,12,8,Friday
1,9,29,38,2018,7,15,Sunday
1,18,2,20,2018,3,20,Tuesday
3,21,7,28,2017,1,23,Monday
1,6,8,14,2018,6,28,Thursday
2,8,9,17,2018,4,2,Monday
2,8,22,30,2018,4,4,Wednseday
2,9,0,9,2017,5,15,Monday
1,9,19,28,2018,4,16,Monday
3,11,36,47,2018,5,26,Saturday
2,44,-10,34,2018,4,28,Saturday
13,15,-2,13,2018,2,28,Wednseday
3,10,13,23,2018,7,1,Sunday
5,16,15,31,2018,2,10,Saturday
7,10,18,28,2018,1,1,Monday
2,4,16,20,2017,9,2,Saturday
2,25,10,35,2018,4,19,Thursday
1,9,9,18,2018,7,15,Sunday
1,12,10,22,2017,3,22,Wednseday
1,6,15,21,2018,4,18,Wednseday
1,4,19,23,2017,5,8,Monday
1,6,16,22,2017,7,18,Tuesday
0,13,12,25,2018,7,27,Friday
2,8,17,25,2018,1,21,Sunday
3,9,-6,3,2018,8,7,Tuesday
1,6,13,19,2017,10,26,Thursday
9,19,4,23,2017,9,3,Sunday
2,44,-22,22,2018,3,5,Monday
0,5,14,19,2018,3,22,Thursday
1,3,9,12,2018,8,5,Sunday
4,5,8,13,2018,6,21,Thursday
2,26,6,32,2017,3,18,Saturday
2,9,15,24,2017,6,17,Saturday
7,8,29,37,2018,5,29,Tuesday
4,17,7,24,2017,4,30,Sunday
10,19,18,37,2018,4,28,Saturday
5,27,-7,20,2017,4,20,Thursday
2,10,19,29,2018,8,15,Wednseday
3,7,15,22,2018,2,12,Monday
2,24,14,38,2018,2,3,Saturday
5,22,8,30,2018,1,15,Monday
1,6,17,23,2018,4,24,Tuesday
3,10,13,23,2017,11,27,Monday
6,20,1,21,2018,3,22,Thursday
1,9,14,23,2017,11,27,Monday
24,28,15,43,2018,2,7,Wednseday
3,31,25,56,2018,1,5,Friday
2,21,6,27,2018,5,9,Wednseday
4,17,-1,16,2018,8,6,Monday
2,10,10,20,2018,7,10,Tuesday
3,4,8,12,2018,5,4,Friday
0,6,11,17,2018,5,15,Tuesday
1,25,1,26,2018,3,15,Thursday
2,12,9,21,2018,6,13,Wednseday
3,11,10,21,2018,8,10,Friday
5,15,15,30,2018,3,7,Wednseday
3,6,13,19,2017,9,2,Saturday
4,16,7,23,2017,12,4,Monday
1,6,22,28,2018,4,12,Thursday
0,12,8,20,2017,10,27,Friday
1,2,8,10,2018,4,22,Sunday
1,4,9,13,2017,6,1,Thursday
2,52,-29,23,2017,9,18,Monday
2,7,6,13,2018,8,1,Wednseday
11,18,3,21,2017,3,3,Friday
3,6,11,17,2018,7,14,Saturday
7,8,23,31,2018,8,21,Tuesday
1,2,9,11,2018,5,21,Monday
1,10,10,20,2017,11,7,Tuesday
1,9,19,28,2017,7,11,Tuesday
11,13,5,18,2017,9,30,Saturday
2,11,7,18,2018,3,25,Sunday
1,7,9,16,2017,11,21,Tuesday
6,15,8,23,2017,9,5,Tuesday
0,6,14,20,2017,8,3,Thursday
2,22,3,25,2017,11,27,Monday
2,4,13,17,2018,2,4,Sunday
2,15,8,23,2017,10,24,Tuesday
3,34,1,35,2018,4,6,Friday
4,19,12,31,2017,10,13,Friday
0,2,9,11,2017,6,19,Monday
3,22,-1,21,2017,4,25,Tuesday
2,7,13,20,2018,6,13,Wednseday
2,3,14,17,2017,12,3,Sunday
5,18,4,22,2018,2,22,Thursday
3,4,10,14,2017,11,27,Monday
1,6,7,13,2018,7,31,Tuesday
2,22,12,34,2018,5,2,Wednseday
4,22,5,27,2017,8,25,Friday
1,28,-4,24,2018,4,24,Tuesday
6,8,6,14,2017,10,31,Tuesday
3,11,12,23,2018,4,2,Monday
6,23,21,44,2018,1,17,Wednseday
4,10,8,18,2017,10,13,Friday
2,9,15,24,2018,4,23,Monday
1,4,4,8,2018,8,23,Thursday
1,5,21,26,2017,2,12,Sunday
1,16,14,30,2018,1,8,Monday
20,43,4,47,2018,3,1,Thursday
1,8,23,31,2018,8,13,Monday
7,27,7,34,2017,12,12,Tuesday
1,11,42,53,2018,5,31,Thursday
0,21,12,33,2017,9,22,Friday
12,28,-4,24,2017,11,24,Friday
1,3,18,21,2017,12,12,Tuesday
6,13,19,32,2017,10,13,Friday
3,4,1,5,2018,8,10,Friday
1,5,18,23,2017,5,21,Sunday
2,14,11,25,2018,5,7,Monday
1,13,16,29,2017,2,16,Thursday
4,10,13,23,2017,8,13,Sunday
1,10,12,22,2018,1,16,Tuesday
3,4,17,21,2018,4,30,Monday
2,16,8,24,2017,4,18,Tuesday
6,20,5,25,2018,1,11,Thursday
2,4,13,17,2017,9,23,Saturday
1,2,13,15,2018,1,16,Tuesday
1,2,8,10,2018,6,19,Tuesday
2,11,10,21,2017,11,27,Monday
3,8,18,26,2017,7,21,Friday
4,41,-10,31,2018,2,24,Saturday
4,18,7,25,2017,11,13,Monday
2,3,9,12,2018,6,23,Saturday
0,6,15,21,2018,8,22,Wednseday
2,3,8,11,2018,5,12,Saturday
1,2,13,15,2018,2,25,Sunday
5,18,7,25,2017,2,24,Friday
3,9,10,19,2018,7,29,Sunday
0,1,10,11,2017,8,7,Monday
1,7,15,22,2018,6,12,Tuesday
1,6,8,14,2018,5,10,Thursday
3,11,13,24,2017,7,17,Monday
0,6,7,13,2018,8,8,Wednseday
4,6,14,20,2018,8,23,Thursday
4,5,8,13,2018,5,11,Friday
8,14,14,28,2018,8,16,Thursday
0,3,13,16,2018,3,6,Tuesday
3,7,18,25,2018,7,20,Friday
2,9,36,45,2018,8,14,Tuesday
0,7,30,37,2018,6,4,Monday
5,6,14,20,2018,6,29,Friday
5,13,11,24,2018,2,11,Sunday
19,34,1,35,2018,1,26,Friday
1,4,14,18,2017,6,8,Thursday
1,4,17,21,2017,9,4,Monday
2,10,18,28,2018,1,17,Wednseday
6,13,15,28,2018,3,29,Thursday
1,10,21,31,2018,6,19,Tuesday
0,8,26,34,2018,6,13,Wednseday
23,23,-13,10,2017,11,21,Tuesday
1,33,-11,22,2018,2,21,Wednseday
9,23,14,37,2017,7,16,Sunday
3,8,16,24,2018,4,6,Friday
1,6,17,23,2018,1,23,Tuesday
4,20,12,32,2017,11,25,Saturday
4,7,12,19,2018,7,7,Saturday
0,15,11,26,2017,7,6,Thursday
5,8,13,21,2017,8,24,Thursday
4,5,3,8,2018,8,5,Sunday
6,10,1,11,2018,8,11,Saturday
2,10,-1,9,2018,8,11,Saturday
10,16,-2,14,2018,8,7,Tuesday
5,6,11,17,2018,2,16,Friday
1,8,19,27,2018,3,7,Wednseday
0,10,4,14,2018,2,9,Friday
3,9,27,36,2018,6,5,Tuesday
2,10,5,15,2018,1,16,Tuesday
2,3,10,13,2018,7,17,Tuesday
10,17,14,31,2017,2,21,Tuesday
4,10,14,24,2017,8,11,Friday
1,4,9,13,2017,6,1,Thursday
5,8,5,13,2017,11,17,Friday
5,20,11,31,2018,3,3,Saturday
3,10,14,24,2018,4,22,Sunday
2,3,20,23,2017,11,20,Monday
3,7,9,16,2018,1,23,Tuesday
2,16,17,33,2018,3,18,Sunday
1,21,7,28,2018,3,1,Thursday
0,17,4,21,2018,1,16,Tuesday
8,9,16,25,2018,6,3,Sunday
0,4,28,32,2018,6,15,Friday
2,5,38,43,2018,7,1,Sunday
2,15,7,22,2017,7,17,Monday
1,13,17,30,2018,8,1,Wednseday
4,13,27,40,2017,6,16,Friday
11,27,4,31,2017,9,9,Saturday
2,15,7,22,2018,2,27,Tuesday
4,11,18,29,2017,6,8,Thursday
17,20,5,25,2017,12,23,Saturday
0,6,14,20,2018,7,20,Friday
4,7,7,14,2017,11,10,Friday
1,2,23,25,2018,6,3,Sunday
1,28,1,29,2018,4,4,Wednseday
4,6,19,25,2017,8,25,Friday
4,5,12,17,2017,12,3,Sunday
3,34,5,39,2018,2,3,Saturday
1,11,9,20,2017,11,24,Friday
2,11,18,29,2018,7,31,Tuesday
1,9,20,29,2017,5,3,Wednseday
4,11,17,28,2017,10,30,Monday
3,11,25,36,2018,7,2,Monday
1,11,18,29,2018,7,19,Thursday
6,18,-1,17,2018,5,18,Friday
2,11,5,16,2017,9,17,Sunday
3,14,6,20,2018,6,30,Saturday
2,15,12,27,2018,3,7,Wednseday
0,9,23,32,2018,3,2,Friday
1,10,14,24,2017,10,3,Tuesday
2,3,8,11,2018,4,2,Monday
1,6,17,23,2017,10,8,Sunday
5,13,13,26,2018,5,31,Thursday
8,21,6,27,2017,6,13,Tuesday
3,6,8,14,2018,4,27,Friday
6,21,9,30,2017,12,20,Wednseday
7,13,18,31,2017,5,23,Tuesday
1,3,12,15,2018,5,13,Sunday
5,6,19,25,2017,2,2,Thursday
2,14,24,38,2017,9,12,Tuesday
1,6,17,23,2018,1,29,Monday
3,4,7,11,2017,9,18,Monday
0,4,25,29,2017,2,9,Thursday
9,29,-4,25,2018,5,10,Thursday
1,8,20,28,2017,12,8,Friday
2,39,-18,21,2018,2,15,Thursday
2,13,21,34,2017,10,4,Wednseday
1,7,15,22,2018,1,16,Tuesday
7,43,1,44,2018,2,27,Tuesday
2,4,21,25,2017,2,27,Monday
2,8,10,18,2017,8,14,Monday
1,8,11,19,2017,6,18,Sunday
2,9,8,17,2018,5,13,Sunday
9,15,22,37,2017,1,17,Tuesday
1,9,14,23,2017,5,16,Tuesday
3,6,10,16,2018,4,8,Sunday
3,14,9,23,2017,6,5,Monday
3,8,15,23,2017,11,1,Wednseday
1,3,15,18,2017,3,26,Sunday
4,26,11,37,2018,4,28,Saturday
3,15,5,20,2017,11,24,Friday
2,16,13,29,2017,10,15,Sunday
1,7,20,27,2017,8,23,Wednseday
5,22,33,55,2016,10,4,Tuesday
2,28,-1,27,2017,11,29,Wednseday
4,12,16,28,2017,4,28,Friday
1,2,7,9,2018,5,15,Tuesday
7,8,5,13,2018,3,28,Wednseday
2,6,19,25,2017,8,19,Saturday
7,13,7,20,2017,9,5,Tuesday
4,18,7,25,2018,3,22,Thursday
3,9,8,17,2017,9,10,Sunday
1,7,13,20,2017,11,23,Thursday
4,12,7,19,2018,3,15,Thursday
4,14,16,30,2017,3,11,Saturday
6,13,12,25,2017,3,10,Friday
9,20,6,26,2018,2,10,Saturday
0,8,19,27,2018,6,20,Wednseday
1,11,8,19,2017,9,3,Sunday
35,41,-10,31,2018,4,27,Friday
2,14,2,16,2018,7,11,Wednseday
2,15,19,34,2018,1,30,Tuesday
4,11,19,30,2018,4,21,Saturday
1,3,17,20,2017,3,28,Tuesday
3,19,21,40,2017,5,20,Saturday
1,24,6,30,2018,5,15,Tuesday
9,15,1,16,2018,8,15,Wednseday
3,9,13,22,2017,7,10,Monday
1,9,36,45,2017,1,29,Sunday
9,12,15,27,2017,12,2,Saturday
2,11,12,23,2017,8,14,Monday
1,11,11,22,2017,7,27,Thursday
1,12,17,29,2018,1,18,Thursday
0,10,6,16,2018,4,9,Monday
0,2,12,14,2017,6,12,Monday
1,7,29,36,2017,3,20,Monday
2,13,15,28,2018,5,8,Tuesday
1,3,21,24,2017,12,26,Tuesday
2,5,17,22,2018,5,13,Sunday
3,11,26,37,2018,1,14,Sunday
3,30,-7,23,2017,11,26,Sunday
1,14,11,25,2017,11,16,Thursday
4,21,4,25,2017,11,24,Friday
3,10,9,19,2018,3,17,Saturday
7,19,10,29,2017,7,20,Thursday
0,12,15,27,2018,2,7,Wednseday
2,12,24,36,2017,5,14,Sunday
4,18,4,22,2017,11,27,Monday
4,6,12,18,2018,4,6,Friday
3,11,12,23,2017,9,9,Saturday
6,18,3,21,2018,5,11,Friday
1,5,18,23,2017,10,8,Sunday
3,15,9,24,2018,1,30,Tuesday
2,7,9,16,2017,12,5,Tuesday
5,13,10,23,2017,10,29,Sunday
2,44,11,55,2018,3,6,Tuesday
4,6,4,10,2018,7,20,Friday
6,12,10,22,2017,6,21,Wednseday
12,14,16,30,2018,3,17,Saturday
10,16,24,40,2017,1,27,Friday
4,4,10,14,2017,11,24,Friday
1,16,40,56,2018,3,12,Monday
3,7,26,33,2018,4,20,Friday
16,17,2,19,2018,5,19,Saturday
2,5,20,25,2018,6,24,Sunday
1,13,6,19,2017,3,1,Wednseday
3,19,26,45,2018,1,21,Sunday
4,5,7,12,2017,10,14,Saturday
3,4,13,17,2018,1,19,Friday
2,8,15,23,2018,4,10,Tuesday
4,29,0,29,2017,12,7,Thursday
1,33,-16,17,2018,3,5,Monday
2,5,15,20,2018,3,21,Wednseday
0,6,22,28,2018,2,9,Friday
2,8,7,15,2018,5,7,Monday
0,9,13,22,2017,5,23,Tuesday
1,8,33,41,2018,8,8,Wednseday
2,15,9,24,2017,9,4,Monday
2,17,12,29,2018,2,5,Monday
3,3,13,16,2018,3,20,Tuesday
0,13,14,27,2018,1,25,Thursday
6,7,10,17,2018,7,6,Friday
3,10,16,26,2018,4,6,Friday
1,6,2,8,2018,8,1,Wednseday
1,5,19,24,2018,3,18,Sunday
4,23,6,29,2018,2,18,Sunday
1,17,9,26,2017,10,4,Wednseday
6,9,12,21,2017,9,12,Tuesday
1,7,16,23,2018,4,9,Monday
2,16,4,20,2018,5,22,Tuesday
3,10,14,24,2017,10,14,Saturday
2,53,-29,24,2018,2,25,Sunday
3,10,6,16,2018,2,6,Tuesday
5,8,7,15,2018,6,10,Sunday
1,3,13,16,2018,1,29,Monday
3,4,16,20,2017,12,16,Saturday
2,9,17,26,2018,1,31,Wednseday
5,12,22,34,2017,4,7,Friday
3,16,19,35,2018,4,16,Monday
4,8,17,25,2017,6,19,Monday
1,9,24,33,2018,7,4,Wednseday
2,4,17,21,2017,12,18,Monday
1,13,15,28,2017,3,23,Thursday
1,8,21,29,2018,7,5,Thursday
5,21,6,27,2018,2,15,Thursday
0,14,3,17,2018,5,21,Monday
1,8,17,25,2018,4,19,Thursday
2,17,5,22,2018,2,25,Sunday
1,3,14,17,2018,6,11,Monday
4,12,18,30,2017,5,15,Monday
1,23,10,33,2017,12,21,Thursday
3,24,0,24,2018,2,27,Tuesday
3,14,15,29,2018,5,1,Tuesday
1,12,41,53,2018,5,31,Thursday
2,16,6,22,2017,6,26,Monday
3,20,-6,14,2018,8,10,Friday
0,4,34,38,2018,6,4,Monday
1,26,-7,19,2018,3,14,Wednseday
6,15,11,26,2017,7,27,Thursday
2,25,16,41,2017,2,9,Thursday
0,13,16,29,2018,2,20,Tuesday
5,10,12,22,2018,4,25,Wednseday
0,4,15,19,2017,10,26,Thursday
1,3,0,3,2018,8,27,Monday
2,10,21,31,2017,4,25,Tuesday
7,18,20,38,2017,7,25,Tuesday
1,2,13,15,2017,6,27,Tuesday
0,2,21,23,2018,3,21,Wednseday
5,19,5,24,2017,11,18,Saturday
0,8,16,24,2018,6,18,Monday
1,35,-8,27,2018,2,28,Wednseday
3,10,17,27,2018,1,5,Friday
3,13,21,34,2018,4,24,Tuesday
0,28,4,32,2018,1,19,Friday
0,4,4,8,2018,7,19,Thursday
4,11,18,29,2017,6,18,Sunday
3,7,20,27,2018,2,2,Friday
3,13,14,27,2018,4,7,Saturday
1,16,15,31,2017,5,8,Monday
1,10,6,16,2018,3,5,Monday
1,13,0,13,2018,8,1,Wednseday
6,13,19,32,2018,4,27,Friday
2,5,9,14,2017,11,28,Tuesday
3,8,15,23,2017,9,5,Tuesday
5,9,25,34,2017,8,30,Wednseday
3,4,9,13,2017,8,5,Saturday
6,16,10,26,2018,8,8,Wednseday
2,15,10,25,2017,10,1,Sunday
2,32,-8,24,2018,3,17,Saturday
1,14,14,28,2017,11,15,Wednseday
3,16,13,29,2017,10,8,Sunday
1,7,20,27,2018,6,26,Tuesday
4,12,13,25,2017,10,14,Saturday
2,11,19,30,2017,2,5,Sunday
4,5,9,14,2018,2,15,Thursday
0,4,1,5,2018,8,23,Thursday
3,11,25,36,2018,1,14,Sunday
7,10,7,17,2017,11,10,Friday
2,4,24,28,2017,12,25,Monday
2,5,5,10,2018,6,10,Sunday
4,23,11,34,2018,3,20,Tuesday
1,14,14,28,2017,8,29,Tuesday
2,3,11,14,2018,7,24,Tuesday
1,64,-35,29,2017,12,19,Tuesday
5,9,11,20,2018,6,15,Friday
1,13,8,21,2018,5,8,Tuesday
1,13,21,34,2018,7,17,Tuesday
2,5,20,25,2018,1,6,Saturday
17,20,31,51,2016,10,4,Tuesday
3,6,11,17,2018,3,11,Sunday
4,6,9,15,2018,2,15,Thursday
2,4,15,19,2018,1,13,Saturday
1,10,19,29,2018,6,18,Monday
1,2,6,8,2018,5,15,Tuesday
3,15,10,25,2017,5,5,Friday
0,6,16,22,2017,3,29,Wednseday
4,7,12,19,2018,1,12,Friday
2,7,15,22,2018,1,30,Tuesday
1,4,1,5,2018,8,2,Thursday
3,10,10,20,2017,11,24,Friday
3,10,42,52,2017,6,19,Monday
2,4,7,11,2017,9,17,Sunday
0,5,20,25,2018,5,11,Friday
6,14,8,22,2018,7,12,Thursday
3,33,-8,25,2018,2,16,Friday
8,20,7,27,2018,2,6,Tuesday
11,14,5,19,2017,11,17,Friday
2,22,6,28,2018,1,23,Tuesday
1,17,14,31,2018,1,16,Tuesday
4,15,25,40,2017,12,29,Friday
3,10,11,21,2017,7,28,Friday
1,6,14,20,2017,7,18,Tuesday
2,17,13,30,2017,5,21,Sunday
1,4,11,15,2018,5,14,Monday
3,4,5,9,2018,8,19,Sunday
0,20,10,30,2018,4,25,Wednseday
6,12,13,25,2017,11,11,Saturday
1,16,15,31,2017,8,28,Monday
1,9,33,42,2018,6,12,Tuesday
5,32,-6,26,2017,11,25,Saturday
3,9,15,24,2017,6,17,Saturday
0,9,11,20,2018,8,14,Tuesday
1,10,27,37,2017,6,20,Tuesday
7,8,6,14,2018,2,27,Tuesday
3,17,7,24,2017,10,13,Friday
2,9,23,32,2017,10,28,Saturday
2,9,24,33,2018,6,2,Saturday
2,15,6,21,2017,4,25,Tuesday
1,9,15,24,2018,4,16,Monday
2,19,12,31,2017,5,14,Sunday
1,9,4,13,2018,7,5,Thursday
2,17,6,23,2017,3,14,Tuesday
1,20,2,22,2018,5,16,Wednseday
1,11,29,40,2018,4,29,Sunday
10,22,11,33,2018,1,13,Saturday
3,10,13,23,2018,8,11,Saturday
7,15,13,28,2017,6,28,Wednseday
3,5,18,23,2017,2,6,Monday
2,7,18,25,2018,6,18,Monday
3,15,10,25,2017,8,18,Friday
0,7,13,20,2017,10,18,Wednseday
1,7,26,33,2018,7,5,Thursday
8,14,22,36,2017,12,26,Tuesday
4,8,19,27,2017,6,1,Thursday
4,13,1,14,2017,11,24,Friday
2,8,15,23,2017,8,8,Tuesday
2,7,16,23,2017,6,12,Monday
4,12,12,24,2017,8,11,Friday
15,53,-14,39,2017,12,11,Monday
1,28,-8,20,2018,2,13,Tuesday
1,6,11,17,2018,7,24,Tuesday
1,4,8,12,2018,8,5,Sunday
1,4,14,18,2018,5,14,Monday
5,7,25,32,2017,12,21,Thursday
4,16,15,31,2017,4,1,Saturday
5,17,10,27,2017,2,24,Friday
1,4,11,15,2017,9,21,Thursday
0,6,35,41,2017,10,24,Tuesday
0,24,-5,19,2017,11,22,Wednseday
1,23,7,30,2018,1,22,Monday
1,2,6,8,2018,7,18,Wednseday
2,3,13,16,2017,8,1,Tuesday
2,10,13,23,2018,8,18,Saturday
2,12,7,19,2017,9,20,Wednseday
3,10,17,27,2017,3,28,Tuesday
1,2,7,9,2018,5,20,Sunday
1,6,13,19,2018,8,15,Wednseday
1,7,16,23,2017,11,13,Monday
1,8,50,58,2018,8,20,Monday
2,9,13,22,2017,4,23,Sunday
4,25,11,36,2018,5,21,Monday
7,12,9,21,2018,7,18,Wednseday
6,12,1,13,2018,3,22,Thursday
2,8,20,28,2017,12,26,Tuesday
1,9,12,21,2018,2,28,Wednseday
1,20,15,35,2017,11,21,Tuesday
0,5,23,28,2017,9,28,Thursday
6,9,19,28,2018,5,1,Tuesday
1,7,15,22,2018,7,25,Wednseday
3,6,19,25,2017,4,7,Friday
0,8,22,30,2017,7,31,Monday
2,9,11,20,2017,11,4,Saturday
1,6,6,12,2017,11,22,Wednseday
1,4,10,14,2017,11,27,Monday
1,21,1,22,2017,9,11,Monday
4,15,3,18,2018,3,23,Friday
6,15,6,21,2018,2,14,Wednseday
3,14,29,43,2017,9,11,Monday
3,22,2,24,2017,7,18,Tuesday
4,12,14,26,2017,7,27,Thursday
2,8,-1,7,2018,8,6,Monday
7,8,12,20,2017,8,17,Thursday
0,1,14,15,2018,4,24,Tuesday
2,17,8,25,2017,4,22,Saturday
4,7,11,18,2018,1,4,Thursday
1,5,11,16,2017,10,4,Wednseday
3,11,3,14,2018,2,20,Tuesday
3,11,9,20,2017,5,19,Friday
0,5,8,13,2018,8,22,Wednseday
1,16,11,27,2017,12,12,Tuesday
1,14,15,29,2018,1,8,Monday
4,21,3,24,2018,2,20,Tuesday
4,5,7,12,2017,8,20,Sunday
1,5,29,34,2018,8,8,Wednseday
4,15,8,23,2017,8,28,Monday
1,8,21,29,2018,3,7,Wednseday
1,16,24,40,2017,10,19,Thursday
6,7,0,7,2018,8,10,Friday
0,5,22,27,2018,6,15,Friday
1,4,11,15,2018,1,18,Thursday
1,14,9,23,2018,4,4,Wednseday
5,21,4,25,2018,3,15,Thursday
3,8,11,19,2018,3,30,Friday
18,23,-1,22,2018,3,5,Monday
1,12,25,37,2017,10,4,Wednseday
2,8,15,23,2017,6,14,Wednseday
3,5,19,24,2018,6,23,Saturday
1,20,-1,19,2017,11,16,Thursday
4,22,14,36,2018,2,5,Monday
6,43,0,43,2017,4,13,Thursday
1,10,18,28,2018,8,20,Monday
1,6,16,22,2018,1,9,Tuesday
4,9,11,20,2018,2,24,Saturday
6,20,8,28,2017,9,8,Friday
1,10,18,28,2018,2,6,Tuesday
4,11,14,25,2017,2,6,Monday
1,6,21,27,2018,3,21,Wednseday
1,4,10,14,2018,5,7,Monday
3,10,14,24,2017,4,8,Saturday
1,10,13,23,2017,2,28,Tuesday
0,12,22,34,2018,1,5,Friday
0,11,18,29,2017,6,1,Thursday
2,25,15,40,2018,1,20,Saturday
4,14,9,23,2017,10,9,Monday
7,28,2,30,2017,11,14,Tuesday
3,10,16,26,2017,10,6,Friday
3,4,6,10,2018,7,20,Friday
2,3,7,10,2018,5,13,Sunday
1,174,-137,37,2017,3,29,Wednseday
6,36,5,41,2017,11,29,Wednseday
4,5,9,14,2018,6,29,Friday
4,22,6,28,2017,12,8,Friday
4,12,12,24,2017,7,15,Saturday
0,5,8,13,2018,7,27,Friday
2,10,14,24,2018,1,21,Sunday
12,14,7,21,2018,4,20,Friday
1,5,11,16,2018,1,31,Wednseday
4,5,6,11,2018,7,19,Thursday
2,9,19,28,2018,1,9,Tuesday
4,12,9,21,2018,1,15,Monday
3,20,13,33,2017,8,12,Saturday
1,14,7,21,2017,11,21,Tuesday
2,9,13,22,2018,3,4,Sunday
3,7,16,23,2018,1,8,Monday
1,8,19,27,2017,1,26,Thursday
3,4,8,12,2018,6,23,Saturday
1,11,14,25,2018,1,12,Friday
3,16,10,26,2017,11,4,Saturday
2,5,13,18,2017,9,23,Saturday
1,4,18,22,2018,5,6,Sunday
7,16,6,22,2017,11,29,Wednseday
4,14,26,40,2018,6,30,Saturday
2,23,18,41,2017,2,18,Saturday
1,14,21,35,2018,1,2,Tuesday
2,11,12,23,2018,8,4,Saturday
1,13,16,29,2017,12,14,Thursday
0,39,-7,32,2018,2,9,Friday
6,56,-4,52,2018,1,5,Friday
2,19,3,22,2017,4,23,Sunday
2,7,10,17,2018,3,26,Monday
10,24,0,24,2018,7,29,Sunday
7,9,14,23,2018,1,17,Wednseday
0,17,2,19,2018,2,28,Wednseday
2,2,13,15,2018,1,17,Wednseday
2,7,7,14,2018,8,21,Tuesday
1,7,13,20,2018,3,22,Thursday
1,5,9,14,2018,7,19,Thursday
0,9,15,24,2017,2,7,Tuesday
2,10,15,25,2018,2,17,Saturday
1,3,10,13,2018,3,21,Wednseday
4,8,33,41,2017,1,20,Friday
4,8,15,23,2018,1,28,Sunday
0,3,13,16,2017,5,15,Monday
1,26,10,36,2017,6,7,Wednseday
2,9,10,19,2018,4,14,Saturday
3,19,7,26,2017,12,2,Saturday
7,19,5,24,2017,11,10,Friday
3,22,3,25,2018,1,26,Friday
5,5,18,23,2018,2,24,Saturday
3,4,13,17,2017,12,3,Sunday
5,14,10,24,2017,4,28,Friday
3,25,6,31,2018,2,18,Sunday
2,4,7,11,2018,5,13,Sunday
4,10,14,24,2017,9,22,Friday
2,15,15,30,2017,10,8,Sunday
2,8,8,16,2018,8,19,Sunday
3,10,15,25,2018,5,11,Friday
1,13,11,24,2018,2,13,Tuesday
1,3,10,13,2018,3,20,Tuesday
1,6,22,28,2017,10,12,Thursday
4,8,27,35,2017,3,23,Thursday
1,8,9,17,2018,4,17,Tuesday
3,16,14,30,2017,11,13,Monday
3,9,16,25,2017,5,27,Saturday
3,21,2,23,2018,1,8,Monday
6,17,15,32,2018,2,9,Friday
0,3,25,28,2017,3,28,Tuesday
2,16,13,29,2017,12,18,Monday
2,23,-1,22,2017,7,12,Wednseday
3,9,15,24,2017,7,15,Saturday
4,28,-9,19,2018,5,17,Thursday
6,8,7,15,2017,7,19,Wednseday
3,33,5,38,2017,12,9,Saturday
4,8,16,24,2018,7,23,Monday
3,25,-1,24,2017,7,21,Friday
0,10,17,27,2017,9,22,Friday
1,13,24,37,2018,5,29,Tuesday
0,4,1,5,2018,8,23,Thursday
1,11,17,28,2018,1,11,Thursday
5,10,13,23,2017,3,11,Saturday
1,15,8,23,2018,1,15,Monday
1,8,13,21,2018,7,23,Monday
1,8,7,15,2018,8,7,Tuesday
2,6,17,23,2018,1,23,Tuesday
5,15,11,26,2017,11,11,Saturday
3,10,23,33,2018,6,23,Saturday
6,13,17,30,2017,10,18,Wednseday
1,5,5,10,2018,6,18,Monday
2,5,12,17,2018,1,7,Sunday
2,9,16,25,2017,8,14,Monday
1,5,17,22,2018,5,16,Wednseday
5,7,16,23,2017,10,11,Wednseday
1,9,11,20,2017,8,30,Wednseday
3,10,16,26,2018,7,13,Friday
8,27,7,34,2018,1,3,Wednseday
3,17,12,29,2017,6,26,Monday
0,33,-7,26,2018,3,7,Wednseday
2,8,15,23,2018,4,17,Tuesday
1,4,22,26,2018,6,3,Sunday
4,11,14,25,2017,10,5,Thursday
4,50,-22,28,2017,11,16,Thursday
4,8,9,17,2017,10,15,Sunday
19,24,7,31,2018,7,8,Sunday
3,13,17,30,2017,9,23,Saturday
1,6,21,27,2018,6,29,Friday
3,13,31,44,2017,1,17,Tuesday
4,8,25,33,2017,12,15,Friday
1,2,14,16,2017,12,6,Wednseday
1,3,13,16,2018,2,7,Wednseday
4,8,13,21,2018,4,12,Thursday
5,6,9,15,2018,1,17,Wednseday
19,35,-8,27,2018,2,2,Friday
5,12,6,18,2018,8,10,Friday
1,6,22,28,2018,6,27,Wednseday
3,23,10,33,2018,2,3,Saturday
3,5,19,24,2018,5,6,Sunday
5,13,12,25,2017,2,24,Friday
1,14,27,41,2018,6,6,Wednseday
1,9,26,35,2018,7,24,Tuesday
2,3,2,5,2018,7,28,Saturday
3,21,4,25,2018,2,24,Saturday
0,2,18,20,2017,12,21,Thursday
1,7,15,22,2018,5,14,Monday
3,4,9,13,2018,6,22,Friday
1,6,17,23,2018,8,22,Wednseday
4,16,14,30,2018,2,19,Monday
3,7,27,34,2018,6,1,Friday
6,11,15,26,2018,7,28,Saturday
4,15,11,26,2017,6,30,Friday
2,8,5,13,2017,5,13,Saturday
2,12,16,28,2017,5,1,Monday
1,22,3,25,2017,7,2,Sunday
1,8,13,21,2017,5,17,Wednseday
2,8,14,22,2017,11,27,Monday
1,15,1,16,2018,5,22,Tuesday
4,9,12,21,2017,5,29,Monday
2,21,3,24,2018,5,8,Tuesday
5,6,7,13,2018,6,22,Friday
9,11,13,24,2017,11,27,Monday
4,22,-4,18,2018,2,26,Monday
2,7,11,18,2017,11,20,Monday
1,2,22,24,2018,6,5,Tuesday
0,12,22,34,2017,12,28,Thursday
3,6,6,12,2018,8,24,Friday
4,5,13,18,2017,11,17,Friday
7,19,25,44,2017,1,25,Wednseday
5,19,20,39,2017,12,21,Thursday
10,21,8,29,2017,6,6,Tuesday
3,5,9,14,2018,1,10,Wednseday
9,14,3,17,2017,10,9,Monday
2,16,17,33,2018,1,21,Sunday
2,8,15,23,2017,7,18,Tuesday
2,37,-13,24,2018,2,25,Sunday
2,8,12,20,2017,10,24,Tuesday
3,11,14,25,2018,2,5,Monday
1,2,10,12,2017,8,13,Sunday
27,55,-28,27,2018,3,8,Thursday
7,15,13,28,2017,8,15,Tuesday
1,14,10,24,2017,12,12,Tuesday
4,19,2,21,2017,11,24,Friday
3,14,10,24,2017,8,8,Tuesday
2,6,13,19,2017,3,1,Wednseday
5,18,8,26,2018,1,4,Thursday
1,8,11,19,2017,10,12,Thursday
2,8,23,31,2018,7,29,Sunday
6,18,16,34,2017,12,9,Saturday
0,3,16,19,2018,4,27,Friday
1,16,11,27,2017,7,26,Wednseday
1,40,-12,28,2018,3,14,Wednseday
7,13,18,31,2018,6,22,Friday
1,6,13,19,2018,2,25,Sunday
12,13,15,28,2018,3,16,Friday
1,5,22,27,2017,5,18,Thursday
2,4,8,12,2018,3,25,Sunday
1,6,28,34,2017,12,7,Thursday
15,20,1,21,2017,11,24,Friday
2,6,23,29,2018,5,6,Sunday
0,6,25,31,2018,8,24,Friday
1,8,10,18,2017,10,30,Monday
4,8,16,24,2018,1,15,Monday
8,20,2,22,2018,2,28,Wednseday
3,12,40,52,2018,6,1,Friday
1,12,16,28,2018,6,21,Thursday
1,26,1,27,2018,2,15,Thursday
1,10,16,26,2018,4,22,Sunday
1,5,13,18,2018,6,17,Sunday
1,10,14,24,2018,6,10,Sunday
2,11,13,24,2017,5,21,Sunday
5,35,-7,28,2018,1,5,Friday
1,7,23,30,2018,7,4,Wednseday
2,3,12,15,2018,6,19,Tuesday
3,14,14,28,2018,7,20,Friday
1,6,18,24,2017,6,20,Tuesday
7,8,18,26,2018,6,7,Thursday
3,13,11,24,2018,7,13,Friday
1,7,15,22,2017,7,10,Monday
5,11,22,33,2017,10,20,Friday
2,6,8,14,2017,11,28,Tuesday
10,22,6,28,2017,12,12,Tuesday
1,8,13,21,2017,5,29,Monday
1,5,18,23,2018,7,15,Sunday
10,16,26,42,2017,2,7,Tuesday
1,16,8,24,2018,7,15,Sunday
10,19,2,21,2017,10,11,Wednseday
3,8,10,18,2018,7,16,Monday
4,5,7,12,2017,7,30,Sunday
1,2,6,8,2018,8,9,Thursday
2,21,1,22,2018,3,26,Monday
5,21,1,22,2017,10,18,Wednseday
3,16,10,26,2017,11,4,Saturday
3,14,10,24,2017,9,8,Friday
6,14,17,31,2017,10,3,Tuesday
2,7,6,13,2018,3,27,Tuesday
3,4,6,10,2018,5,18,Friday
3,6,32,38,2018,6,16,Saturday
6,7,12,19,2017,12,8,Friday
5,14,20,34,2017,9,27,Wednseday
4,25,7,32,2017,12,1,Friday
0,10,18,28,2017,11,10,Friday
2,23,1,24,2017,5,1,Monday
1,4,9,13,2017,8,24,Thursday
2,4,6,10,2018,6,18,Monday
9,14,21,35,2017,10,31,Tuesday
4,20,1,21,2018,5,17,Thursday
1,4,13,17,2017,10,23,Monday
0,5,23,28,2018,7,19,Thursday
1,8,11,19,2018,3,28,Wednseday
0,40,-8,32,2017,8,10,Thursday
3,10,11,21,2017,9,12,Tuesday
2,15,2,17,2017,12,11,Monday
4,21,43,64,2018,5,28,Monday
13,46,-23,23,2018,3,21,Wednseday
2,11,14,25,2018,7,28,Saturday
1,4,19,23,2017,8,13,Sunday
4,9,9,18,2018,5,3,Thursday
3,11,15,26,2017,7,1,Saturday
1,9,29,38,2018,6,24,Sunday
3,14,15,29,2017,6,5,Monday
4,11,14,25,2018,2,17,Saturday
6,28,-7,21,2017,11,21,Tuesday
3,4,9,13,2018,6,22,Friday
9,26,3,29,2018,5,27,Sunday
5,19,7,26,2018,4,7,Saturday
2,8,15,23,2018,1,14,Sunday
2,8,18,26,2018,5,9,Wednseday
3,5,19,24,2018,5,27,Sunday
3,13,16,29,2017,11,19,Sunday
1,3,11,14,2018,8,7,Tuesday
1,2,10,12,2018,4,4,Wednseday
5,6,7,13,2017,9,6,Wednseday
1,2,11,13,2017,10,24,Tuesday
1,25,9,34,2018,5,3,Thursday
5,9,17,26,2017,8,16,Wednseday
2,6,8,14,2018,7,24,Tuesday
1,2,6,8,2018,7,18,Wednseday
1,14,7,21,2018,4,2,Monday
6,9,9,18,2018,1,27,Saturday
2,4,9,13,2018,5,19,Saturday
1,8,14,22,2017,8,1,Tuesday
1,18,3,21,2018,7,23,Monday
0,21,0,21,2018,5,18,Friday
5,6,10,16,2018,1,3,Wednseday
3,17,14,31,2018,7,3,Tuesday
1,15,14,29,2018,6,28,Thursday
2,7,16,23,2018,1,24,Wednseday
2,6,25,31,2017,9,30,Saturday
1,12,24,36,2017,5,7,Sunday
14,17,13,30,2017,4,25,Tuesday
3,38,-12,26,2018,2,18,Sunday
1,24,6,30,2017,11,26,Sunday
4,11,15,26,2018,7,27,Friday
12,20,14,34,2018,5,3,Thursday
0,4,21,25,2018,4,26,Thursday
2,3,7,10,2018,6,18,Monday
1,8,16,24,2017,10,17,Tuesday
3,13,17,30,2017,9,19,Tuesday
2,9,15,24,2017,5,7,Sunday
2,6,18,24,2017,9,17,Sunday
2,10,1,11,2018,8,19,Sunday
8,15,0,15,2018,2,28,Wednseday
4,10,16,26,2017,9,29,Friday
1,6,16,22,2017,7,18,Tuesday
1,4,8,12,2018,3,1,Thursday
2,59,-35,24,2018,3,17,Saturday
2,4,14,18,2017,12,31,Sunday
1,37,-6,31,2017,12,4,Monday
1,3,7,10,2018,4,3,Tuesday
2,6,19,25,2017,9,2,Saturday
7,27,9,36,2018,7,24,Tuesday
4,7,22,29,2018,6,28,Thursday
1,20,14,34,2017,3,29,Wednseday
1,4,10,14,2018,7,26,Thursday
1,2,2,4,2018,8,27,Monday
1,2,11,13,2017,10,25,Wednseday
1,6,14,20,2017,12,14,Thursday
3,11,8,19,2017,9,1,Friday
1,13,29,42,2018,6,5,Tuesday
3,6,16,22,2018,6,12,Tuesday
2,7,17,24,2017,12,19,Tuesday
3,8,22,30,2018,4,4,Wednseday
1,3,27,30,2018,5,23,Wednseday
2,9,20,29,2018,6,5,Tuesday
0,7,19,26,2017,7,14,Friday
9,19,-4,15,2018,1,22,Monday
2,12,6,18,2018,4,2,Monday
2,9,25,34,2018,8,14,Tuesday
2,9,25,34,2018,4,14,Saturday
4,13,17,30,2018,7,21,Saturday
10,29,10,39,2017,12,29,Friday
1,5,38,43,2018,6,20,Wednseday
4,18,8,26,2017,8,3,Thursday
5,12,9,21,2018,2,22,Thursday
0,5,20,25,2017,7,27,Thursday
1,7,27,34,2018,5,31,Thursday
2,8,13,21,2018,5,8,Tuesday
1,7,16,23,2017,5,29,Monday
3,10,16,26,2017,9,1,Friday
2,28,1,29,2017,5,9,Tuesday
4,5,0,5,2018,8,16,Thursday
2,14,9,23,2018,1,17,Wednseday
6,15,7,22,2018,2,21,Wednseday
2,5,4,9,2018,7,18,Wednseday
1,3,16,19,2017,7,23,Sunday
8,9,1,10,2018,7,16,Monday
2,15,21,36,2018,2,8,Thursday
2,15,6,21,2017,11,7,Tuesday
3,6,20,26,2018,6,22,Friday
4,15,7,22,2018,4,29,Sunday
3,20,4,24,2017,3,24,Friday
2,6,21,27,2018,6,6,Wednseday
3,16,22,38,2017,3,25,Saturday
4,12,13,25,2017,10,5,Thursday
1,3,17,20,2017,12,26,Tuesday
2,6,16,22,2018,1,30,Tuesday
1,11,15,26,2017,7,27,Thursday
3,42,-17,25,2018,2,12,Monday
1,2,12,14,2018,2,21,Wednseday
28,37,16,53,2016,10,10,Monday
6,15,6,21,2018,5,4,Friday
2,7,16,23,2017,11,1,Wednseday
3,10,15,25,2018,8,4,Saturday
2,13,22,35,2017,12,6,Wednseday
4,19,40,59,2017,1,21,Saturday
2,5,18,23,2017,7,2,Sunday
1,2,14,16,2018,1,31,Wednseday
2,6,17,23,2018,1,10,Wednseday
0,1,6,7,2018,8,14,Tuesday
2,4,15,19,2018,3,17,Saturday
28,35,-8,27,2018,3,7,Wednseday
4,12,10,22,2017,11,12,Sunday
1,2,10,12,2017,9,13,Wednseday
3,6,12,18,2018,7,14,Saturday
1,16,10,26,2017,10,22,Sunday
2,4,10,14,2018,2,20,Tuesday
4,13,14,27,2017,2,25,Saturday
4,21,12,33,2017,12,7,Thursday
2,4,15,19,2017,7,9,Sunday
2,5,3,8,2018,7,29,Sunday
1,2,20,22,2017,12,26,Tuesday
2,7,11,18,2018,4,5,Thursday
3,11,10,21,2017,3,13,Monday
1,18,1,19,2018,2,15,Thursday
4,14,11,25,2018,3,30,Friday
3,9,15,24,2017,8,26,Saturday
0,5,17,22,2017,4,10,Monday
1,12,34,46,2018,6,3,Sunday
5,7,13,20,2017,11,23,Thursday
1,11,18,29,2017,7,30,Sunday
2,16,3,19,2018,2,25,Sunday
8,12,7,19,2017,10,26,Thursday
3,6,19,25,2018,6,30,Saturday
4,6,17,23,2018,1,13,Saturday
4,8,6,14,2018,1,26,Friday
0,15,12,27,2017,11,8,Wednseday
1,6,27,33,2018,5,17,Thursday
0,23,4,27,2018,2,14,Wednseday
2,16,15,31,2018,5,19,Saturday
1,9,18,27,2017,6,13,Tuesday
7,21,-7,14,2017,11,24,Friday
3,5,20,25,2018,1,13,Saturday
3,16,13,29,2017,9,5,Tuesday
3,3,9,12,2018,3,3,Saturday
7,16,-3,13,2017,6,27,Tuesday
1,6,17,23,2018,6,20,Wednseday
1,9,12,21,2018,1,10,Wednseday
1,30,5,35,2018,4,10,Tuesday
5,10,18,28,2017,12,8,Friday
10,14,19,33,2017,1,20,Friday
7,15,13,28,2018,1,1,Monday
1,5,20,25,2018,7,1,Sunday
3,10,31,41,2018,6,1,Friday
6,11,7,18,2017,9,28,Thursday
7,17,7,24,2017,7,14,Friday
0,8,15,23,2017,5,3,Wednseday
3,8,15,23,2018,4,29,Sunday
5,8,10,18,2018,3,1,Thursday
7,20,12,32,2018,3,22,Thursday
2,3,15,18,2017,8,14,Monday
3,18,5,23,2018,5,19,Saturday
0,16,7,23,2017,10,24,Tuesday
1,9,14,23,2017,7,2,Sunday
2,3,9,12,2017,7,30,Sunday
2,30,1,31,2017,7,16,Sunday
3,4,9,13,2018,6,22,Friday
4,15,14,29,2017,5,1,Monday
1,10,25,35,2018,4,2,Monday
1,44,-5,39,2017,1,29,Sunday
2,25,-3,22,2017,10,9,Monday
2,9,17,26,2018,2,21,Wednseday
1,5,13,18,2017,3,19,Sunday
1,7,18,25,2018,7,5,Thursday
13,20,6,26,2018,8,1,Wednseday
7,13,6,19,2017,10,19,Thursday
1,6,21,27,2018,5,3,Thursday
3,4,21,25,2018,1,13,Saturday
5,13,13,26,2017,6,22,Thursday
4,11,16,27,2018,5,5,Saturday
2,5,13,18,2017,3,12,Sunday
5,8,19,27,2017,7,13,Thursday
2,10,27,37,2018,5,12,Saturday
1,2,8,10,2018,3,6,Tuesday
5,17,16,33,2018,3,28,Wednseday
6,17,7,24,2018,3,23,Friday
6,13,4,17,2018,5,22,Tuesday
2,10,28,38,2018,6,5,Tuesday
3,6,7,13,2018,8,3,Friday
7,19,16,35,2017,11,29,Wednseday
3,4,26,30,2018,3,3,Saturday
1,16,22,38,2018,5,27,Sunday
1,8,10,18,2018,4,29,Sunday
1,6,10,16,2018,4,10,Tuesday
4,35,-1,34,2017,4,20,Thursday
1,6,21,27,2018,4,24,Tuesday
1,6,20,26,2017,8,20,Sunday
8,20,20,40,2018,3,15,Thursday
3,3,7,10,2018,3,13,Tuesday
2,35,12,47,2018,3,14,Wednseday
3,6,15,21,2017,8,25,Friday
3,7,16,23,2018,1,29,Monday
2,13,13,26,2017,10,18,Wednseday
4,10,15,25,2017,3,31,Friday
0,17,16,33,2017,3,3,Friday
3,13,10,23,2018,8,14,Tuesday
2,3,23,26,2018,6,2,Saturday
2,13,17,30,2017,6,27,Tuesday
1,7,13,20,2017,11,28,Tuesday
1,12,10,22,2017,10,16,Monday
1,7,11,18,2018,4,16,Monday
1,7,14,21,2018,7,18,Wednseday
1,17,20,37,2017,4,24,Monday
6,11,8,19,2018,3,15,Thursday
2,4,6,10,2018,4,10,Tuesday
6,13,8,21,2018,4,19,Thursday
1,4,5,9,2018,7,9,Monday
3,18,14,32,2017,7,10,Monday
1,7,9,16,2018,7,16,Monday
1,2,6,8,2018,5,15,Tuesday
6,13,23,36,2018,6,14,Thursday
1,10,10,20,2017,11,21,Tuesday
4,17,15,32,2018,7,13,Friday
1,71,-45,26,2018,4,11,Wednseday
6,8,6,14,2017,6,8,Thursday
2,24,4,28,2018,5,1,Tuesday
3,6,28,34,2017,2,17,Friday
11,18,30,48,2017,2,4,Saturday
4,21,6,27,2018,3,30,Friday
0,5,22,27,2017,2,17,Friday
1,4,7,11,2018,7,29,Sunday
1,8,29,37,2017,2,7,Tuesday
5,13,19,32,2017,8,10,Thursday
3,12,7,19,2018,3,17,Saturday
1,3,27,30,2018,7,2,Monday
1,8,20,28,2018,5,7,Monday
2,3,11,14,2017,6,5,Monday
1,11,36,47,2018,5,31,Thursday
3,13,13,26,2018,2,11,Sunday
1,6,20,26,2018,8,15,Wednseday
3,4,14,18,2017,7,15,Saturday
5,28,6,34,2017,12,28,Thursday
2,6,4,10,2018,8,4,Saturday
1,7,17,24,2018,4,10,Tuesday
3,10,15,25,2017,5,26,Friday
5,13,9,22,2017,6,28,Wednseday
2,8,12,20,2017,5,9,Tuesday
8,23,3,26,2018,4,12,Thursday
3,16,12,28,2017,11,6,Monday
2,5,17,22,2018,6,24,Sunday
1,11,11,22,2018,3,15,Thursday
1,6,13,19,2017,11,22,Wednseday
2,8,13,21,2018,6,13,Wednseday
1,4,10,14,2018,5,7,Monday
2,5,11,16,2018,1,3,Wednseday
1,12,10,22,2017,11,12,Sunday
2,12,6,18,2018,3,25,Sunday
4,53,-29,24,2018,3,2,Friday
1,4,18,22,2017,7,3,Monday
2,14,21,35,2017,5,24,Wednseday
2,14,18,32,2017,7,22,Saturday
8,14,17,31,2018,1,23,Tuesday
4,8,2,10,2018,8,3,Friday
2,8,9,17,2017,10,15,Sunday
3,5,20,25,2017,7,8,Saturday
2,8,15,23,2018,7,29,Sunday
0,1,7,8,2018,5,3,Thursday
21,23,8,31,2018,7,31,Tuesday
3,6,21,27,2018,1,12,Friday
4,19,6,25,2018,7,13,Friday
1,7,16,23,2018,5,29,Tuesday
12,17,-5,12,2018,8,4,Saturday
15,16,13,29,2018,6,28,Thursday
1,10,27,37,2018,6,4,Monday
3,6,14,20,2017,10,20,Friday
1,24,-2,22,2018,3,7,Wednseday
2,10,11,21,2017,5,2,Tuesday
8,15,14,29,2017,7,6,Thursday
2,34,3,37,2017,10,11,Wednseday
2,9,14,23,2017,5,21,Sunday
2,6,14,20,2017,10,21,Saturday
2,43,-9,34,2017,12,20,Wednseday
2,13,14,27,2017,6,14,Wednseday
1,15,7,22,2017,7,11,Tuesday
2,15,55,70,2018,8,14,Tuesday
2,10,15,25,2018,1,28,Sunday
6,13,10,23,2017,6,13,Tuesday
1,15,7,22,2018,2,19,Monday
2,11,14,25,2017,6,3,Saturday
3,12,20,32,2018,1,13,Saturday
3,8,19,27,2018,2,27,Tuesday
2,10,14,24,2018,2,5,Monday
3,4,9,13,2018,3,10,Saturday
1,11,12,23,2017,7,30,Sunday
2,3,13,16,2018,1,29,Monday
0,12,7,19,2018,5,9,Wednseday
8,15,15,30,2018,6,17,Sunday
3,8,23,31,2018,1,1,Monday
2,6,14,20,2017,9,13,Wednseday
2,5,14,19,2017,8,30,Wednseday
5,8,14,22,2018,6,20,Wednseday
4,10,16,26,2017,11,17,Friday
2,24,9,33,2018,3,4,Sunday
2,13,17,30,2017,7,11,Tuesday
1,4,6,10,2018,7,30,Monday
3,12,27,39,2017,4,7,Friday
2,9,19,28,2017,11,20,Monday
7,31,-7,24,2018,2,19,Monday
1,7,15,22,2017,11,9,Thursday
2,6,16,22,2018,7,24,Tuesday
6,18,-1,17,2017,9,19,Tuesday
2,4,19,23,2018,2,20,Tuesday
2,10,26,36,2018,5,28,Monday
2,5,14,19,2017,8,26,Saturday
2,6,25,31,2018,8,21,Tuesday
0,11,18,29,2017,12,7,Thursday
1,7,22,29,2018,1,10,Wednseday
2,9,9,18,2018,3,26,Monday
1,8,18,26,2017,6,1,Thursday
2,13,14,27,2017,10,21,Saturday
3,13,14,27,2017,11,4,Saturday
4,10,26,36,2017,2,12,Sunday
6,10,13,23,2017,6,13,Tuesday
3,8,16,24,2018,7,17,Tuesday
4,15,8,23,2017,8,21,Monday
6,19,16,35,2017,12,27,Wednseday
19,25,-5,20,2018,7,12,Thursday
1,3,16,19,2017,10,4,Wednseday
1,70,-45,25,2018,1,25,Thursday
8,13,3,16,2018,2,6,Tuesday
4,11,11,22,2018,1,15,Monday
0,11,11,22,2018,3,26,Monday
0,6,8,14,2018,2,15,Thursday
2,25,13,38,2018,6,10,Sunday
3,19,8,27,2017,11,11,Saturday
4,27,5,32,2017,12,30,Saturday
1,4,14,18,2018,4,23,Monday
2,15,2,17,2018,3,11,Sunday
2,18,4,22,2017,11,26,Sunday
3,17,9,26,2017,11,26,Sunday
7,19,12,31,2017,12,15,Friday
4,9,12,21,2017,11,13,Monday
1,22,-1,21,2018,5,2,Wednseday
2,6,13,19,2018,8,1,Wednseday
1,16,6,22,2018,1,30,Tuesday
1,7,7,14,2018,5,14,Monday
4,15,16,31,2018,3,19,Monday
6,14,26,40,2017,3,23,Thursday
3,5,10,15,2017,9,3,Sunday
2,7,15,22,2017,8,8,Tuesday
1,8,20,28,2018,5,21,Monday
1,3,3,6,2018,8,21,Tuesday
1,7,7,14,2018,5,7,Monday
2,8,17,25,2017,9,3,Sunday
2,11,15,26,2018,5,12,Saturday
1,11,7,18,2018,5,21,Monday
3,8,10,18,2018,7,27,Friday
3,8,23,31,2017,12,3,Sunday
3,7,5,12,2018,6,8,Friday
1,20,3,23,2017,5,30,Tuesday
1,1,12,13,2018,3,22,Thursday
5,6,9,15,2018,4,18,Wednseday
3,8,29,37,2017,1,31,Tuesday
0,6,14,20,2017,6,20,Tuesday
2,29,5,34,2017,6,28,Wednseday
2,22,15,37,2018,2,4,Sunday
2,7,21,28,2018,4,11,Wednseday
2,7,11,18,2017,6,19,Monday
2,4,17,21,2017,8,21,Monday
2,6,17,23,2017,3,28,Tuesday
3,6,19,25,2018,1,6,Saturday
3,10,10,20,2018,2,20,Tuesday
4,11,6,17,2018,8,3,Friday
3,12,22,34,2017,11,24,Friday
2,11,15,26,2018,5,12,Saturday
2,9,3,12,2018,3,7,Wednseday
3,12,12,24,2017,9,1,Friday
2,9,23,32,2017,9,17,Sunday
1,14,14,28,2017,10,9,Monday
6,20,12,32,2017,12,29,Friday
3,26,-3,23,2018,3,31,Saturday
1,7,16,23,2018,3,26,Monday
3,10,22,32,2017,3,31,Friday
7,37,-1,36,2018,6,21,Thursday
1,6,16,22,2017,8,8,Tuesday
1,5,22,27,2018,7,5,Thursday
2,10,13,23,2017,3,18,Saturday
3,11,23,34,2018,1,6,Saturday
0,5,13,18,2018,8,16,Thursday
1,3,8,11,2018,4,1,Sunday
2,20,13,33,2018,2,17,Saturday
3,29,5,34,2018,1,2,Tuesday
2,24,-1,23,2017,11,20,Monday
5,26,4,30,2018,7,8,Sunday
1,7,24,31,2017,12,4,Monday
1,8,22,30,2017,5,28,Sunday
1,5,9,14,2018,7,11,Wednseday
0,6,8,14,2018,8,10,Friday
3,7,18,25,2017,5,26,Friday
5,18,5,23,2017,11,29,Wednseday
2,10,21,31,2017,6,11,Sunday
4,12,21,33,2017,2,9,Thursday
2,6,17,23,2017,11,4,Saturday
3,8,15,23,2018,6,12,Tuesday
1,11,11,22,2018,1,16,Tuesday
0,3,10,13,2017,5,23,Tuesday
1,2,14,16,2018,1,30,Tuesday
6,7,8,15,2018,6,14,Thursday
2,9,17,26,2017,8,9,Wednseday
3,7,11,18,2018,3,31,Saturday
2,6,2,8,2018,7,17,Tuesday
1,13,12,25,2018,2,25,Sunday
1,7,20,27,2018,7,4,Wednseday
1,31,20,51,2018,3,12,Monday
1,24,10,34,2018,1,2,Tuesday
1,13,23,36,2017,7,18,Tuesday
3,11,13,24,2017,5,1,Monday
3,4,15,19,2018,4,21,Saturday
11,14,-1,13,2017,8,31,Thursday
0,8,24,32,2017,4,27,Thursday
5,7,23,30,2018,6,3,Sunday
3,35,-11,24,2018,3,19,Monday
0,24,-13,11,2017,5,29,Monday
2,6,18,24,2017,10,3,Tuesday
1,13,12,25,2017,3,2,Thursday
1,2,13,15,2017,7,24,Monday
1,12,10,22,2018,5,23,Wednseday
4,5,14,19,2017,11,30,Thursday
3,20,5,25,2017,11,25,Saturday
4,14,6,20,2017,11,24,Friday
0,4,14,18,2017,12,1,Friday
0,7,6,13,2017,10,11,Wednseday
8,13,9,22,2018,7,17,Tuesday
2,18,8,26,2017,6,4,Sunday
2,14,7,21,2017,6,7,Wednseday
4,15,9,24,2018,1,9,Tuesday
3,10,11,21,2017,10,27,Friday
1,9,13,22,2018,5,1,Tuesday
5,14,7,21,2017,3,1,Wednseday
1,6,7,13,2018,5,2,Wednseday
1,8,21,29,2018,1,25,Thursday
6,9,11,20,2018,2,21,Wednseday
1,8,13,21,2018,5,16,Wednseday
3,8,14,22,2018,4,30,Monday
6,7,7,14,2018,6,12,Tuesday
2,9,16,25,2018,1,20,Saturday
3,5,12,17,2018,5,4,Friday
2,6,14,20,2018,4,18,Wednseday
3,5,12,17,2018,4,27,Friday
1,7,16,23,2017,5,31,Wednseday
0,13,7,20,2017,11,24,Friday
3,15,5,20,2018,2,20,Tuesday
3,7,20,27,2017,12,15,Friday
1,6,14,20,2017,6,29,Thursday
5,10,15,25,2018,4,28,Saturday
2,6,19,25,2018,4,21,Saturday
3,8,6,14,2018,8,10,Friday
40,60,-29,31,2017,11,25,Saturday
2,7,6,13,2018,7,3,Tuesday
7,26,12,38,2017,4,28,Friday
3,10,14,24,2017,11,10,Friday
6,11,7,18,2018,7,13,Friday
2,21,6,27,2017,8,22,Tuesday
2,28,19,47,2017,12,7,Thursday
5,11,8,19,2018,5,5,Saturday
1,38,-3,35,2018,4,23,Monday
0,6,17,23,2017,5,24,Wednseday
6,9,5,14,2018,6,12,Tuesday
1,7,7,14,2017,10,31,Tuesday
2,11,14,25,2017,7,30,Sunday
2,9,9,18,2017,3,12,Sunday
3,7,13,20,2017,12,19,Tuesday
3,9,4,13,2018,8,4,Saturday
2,24,-7,17,2018,3,4,Sunday
0,14,13,27,2017,12,28,Thursday
1,6,13,19,2018,5,16,Wednseday
1,14,8,22,2018,7,18,Wednseday
2,6,14,20,2018,5,15,Tuesday
5,10,22,32,2018,1,20,Saturday
2,15,21,36,2017,4,26,Wednseday
1,21,9,30,2018,6,20,Wednseday
1,11,14,25,2017,6,29,Thursday
2,15,7,22,2018,2,18,Sunday
5,11,17,28,2017,6,8,Thursday
2,15,21,36,2017,1,30,Monday
9,10,12,22,2017,5,1,Monday
3,7,17,24,2017,11,3,Friday
4,24,7,31,2018,2,3,Saturday
0,36,-9,27,2018,3,27,Tuesday
5,14,16,30,2017,5,31,Wednseday
3,24,10,34,2017,7,21,Friday
1,7,8,15,2018,7,30,Monday
6,14,8,22,2018,3,1,Thursday
1,7,15,22,2017,6,26,Monday
1,2,7,9,2018,7,10,Tuesday
3,13,6,19,2017,10,13,Friday
1,7,15,22,2018,2,14,Wednseday
1,12,14,26,2017,11,23,Thursday
15,34,8,42,2018,1,23,Tuesday
1,6,24,30,2018,1,30,Tuesday
4,8,11,19,2017,9,7,Thursday
4,27,5,32,2017,12,14,Thursday
1,8,22,30,2018,2,7,Wednseday
2,16,7,23,2017,10,11,Wednseday
1,16,19,35,2018,5,23,Wednseday
3,20,16,36,2017,7,23,Sunday
2,23,15,38,2017,3,4,Saturday
12,13,-8,5,2018,8,3,Friday
2,11,13,24,2017,12,11,Monday
2,9,14,23,2018,6,27,Wednseday
7,12,10,22,2017,10,16,Monday
3,4,17,21,2017,11,6,Monday
0,17,16,33,2017,12,1,Friday
1,14,21,35,2017,8,17,Thursday
2,8,14,22,2018,6,19,Tuesday
4,10,17,27,2017,10,21,Saturday
8,10,11,21,2018,4,25,Wednseday
1,10,12,22,2018,4,22,Sunday
0,7,27,34,2018,7,4,Wednseday
1,14,14,28,2018,4,11,Wednseday
1,7,11,18,2018,7,19,Thursday
4,23,1,24,2018,3,13,Tuesday
2,7,14,21,2018,8,7,Tuesday
4,20,15,35,2018,1,18,Thursday
4,5,15,20,2018,6,8,Friday
1,10,12,22,2017,3,27,Monday
2,9,8,17,2017,10,17,Tuesday
2,24,9,33,2018,1,27,Saturday
0,42,-20,22,2017,7,4,Tuesday
39,57,-29,28,2017,10,9,Monday
3,6,21,27,2017,5,12,Friday
1,2,14,16,2018,8,12,Sunday
5,19,3,22,2017,10,18,Wednseday
1,7,15,22,2017,8,10,Thursday
2,9,16,25,2018,3,3,Saturday
1,14,13,27,2017,11,30,Thursday
1,2,14,16,2017,10,3,Tuesday
4,13,12,25,2017,9,22,Friday
1,6,14,20,2017,8,17,Thursday
3,9,17,26,2017,10,21,Saturday
13,25,23,48,2018,1,13,Saturday
5,11,7,18,2018,7,15,Sunday
1,22,5,27,2017,11,23,Thursday
9,16,24,40,2017,1,21,Saturday
4,12,16,28,2017,12,22,Friday
4,5,11,16,2018,5,28,Monday
5,11,28,39,2017,2,2,Thursday
2,26,2,28,2017,7,12,Wednseday
1,17,6,23,2018,1,16,Tuesday
1,5,17,22,2017,5,14,Sunday
6,17,16,33,2018,5,4,Friday
3,11,4,15,2018,1,23,Tuesday
2,6,28,34,2018,1,31,Wednseday
3,27,1,28,2018,2,23,Friday
3,6,10,16,2018,1,30,Tuesday
2,7,14,21,2017,11,1,Wednseday
1,6,17,23,2017,4,5,Wednseday
3,10,14,24,2017,7,21,Friday
1,7,11,18,2017,11,13,Monday
1,13,6,19,2018,3,22,Thursday
6,20,18,38,2017,4,28,Friday
9,12,7,19,2018,4,18,Wednseday
6,19,14,33,2017,10,25,Wednseday
3,10,15,25,2017,7,7,Friday
5,11,10,21,2018,1,19,Friday
1,8,15,23,2017,6,25,Sunday
8,22,18,40,2018,2,1,Thursday
3,12,15,27,2018,1,12,Friday
1,7,15,22,2018,1,31,Wednseday
3,12,21,33,2018,1,6,Saturday
1,14,6,20,2018,3,14,Wednseday
2,4,8,12,2017,9,9,Saturday
1,2,21,23,2017,9,11,Monday
2,11,11,22,2018,3,12,Monday
3,9,20,29,2018,1,8,Monday
4,12,16,28,2018,6,7,Thursday
4,13,19,32,2018,4,20,Friday
2,18,13,31,2018,2,4,Sunday
4,11,11,22,2018,6,11,Monday
1,8,20,28,2018,2,21,Wednseday
3,16,15,31,2017,8,12,Saturday
1,5,7,12,2018,8,5,Sunday
4,20,16,36,2017,5,22,Monday
2,12,4,16,2018,5,23,Wednseday
3,16,31,47,2018,6,2,Saturday
2,24,9,33,2018,3,10,Saturday
1,11,11,22,2018,5,6,Sunday
6,10,1,11,2018,8,11,Saturday
1,7,10,17,2018,7,24,Tuesday
1,2,11,13,2018,7,24,Tuesday
1,7,15,22,2017,9,21,Thursday
0,2,19,21,2017,3,6,Monday
4,17,11,28,2018,1,12,Friday
1,8,12,20,2017,8,1,Tuesday
2,10,8,18,2017,8,27,Sunday
2,7,13,20,2017,7,5,Wednseday
3,14,13,27,2017,8,26,Saturday
1,4,25,29,2018,5,31,Thursday
2,11,20,31,2017,12,16,Saturday
2,4,12,16,2017,9,18,Monday
3,9,9,18,2018,4,23,Monday
5,13,13,26,2017,10,11,Wednseday
4,18,7,25,2017,5,27,Saturday
1,14,6,20,2018,7,25,Wednseday
1,5,13,18,2018,7,26,Thursday
1,9,12,21,2018,1,17,Wednseday
5,16,15,31,2017,6,3,Saturday
3,7,16,23,2018,1,30,Tuesday
6,8,4,12,2018,4,4,Wednseday
2,4,7,11,2018,8,11,Saturday
7,18,20,38,2017,3,20,Monday
4,10,10,20,2017,8,5,Saturday
0,9,27,36,2017,2,7,Tuesday
4,11,13,24,2017,7,28,Friday
0,5,21,26,2017,12,1,Friday
2,35,-7,28,2018,1,17,Wednseday
4,12,15,27,2017,1,26,Thursday
1,9,15,24,2017,5,1,Monday
1,9,17,26,2018,4,11,Wednseday
12,19,39,58,2016,10,9,Sunday
2,14,11,25,2017,10,2,Monday
8,13,10,23,2017,12,4,Monday
14,20,-4,16,2018,8,7,Tuesday
11,19,15,34,2018,3,1,Thursday
1,6,19,25,2018,6,24,Sunday
4,23,15,38,2018,3,3,Saturday
0,2,6,8,2018,7,24,Tuesday
2,76,-46,30,2018,1,3,Wednseday
1,8,17,25,2018,5,7,Monday
4,12,16,28,2018,5,4,Friday
1,12,20,32,2018,6,10,Sunday
0,7,23,30,2018,6,26,Tuesday
1,11,12,23,2017,12,4,Monday
1,4,17,21,2017,11,6,Monday
4,6,15,21,2017,8,24,Thursday
2,3,7,10,2018,6,25,Monday
18,29,-5,24,2018,3,5,Monday
9,10,13,23,2018,5,29,Tuesday
4,16,10,26,2018,2,18,Sunday
2,7,1,8,2018,5,14,Monday
6,15,22,37,2018,2,3,Saturday
2,8,22,30,2017,8,13,Sunday
3,8,12,20,2017,8,1,Tuesday
2,6,20,26,2018,2,17,Saturday
5,10,12,22,2018,1,10,Wednseday
1,21,11,32,2018,5,17,Thursday
7,9,4,13,2018,3,30,Friday
8,13,11,24,2017,9,26,Tuesday
3,26,-9,17,2018,8,5,Sunday
1,16,13,29,2018,5,6,Sunday
2,3,3,6,2018,8,25,Saturday
8,17,6,23,2017,12,5,Tuesday
1,5,18,23,2017,10,4,Wednseday
0,4,23,27,2017,8,17,Thursday
2,11,23,34,2018,5,26,Saturday
3,17,9,26,2017,11,24,Friday
2,16,8,24,2018,4,8,Sunday
0,29,11,40,2017,12,6,Wednseday
1,9,17,26,2017,3,22,Wednseday
3,6,8,14,2017,7,11,Tuesday
13,18,10,28,2017,7,13,Thursday
14,28,-4,24,2017,5,1,Monday
2,12,15,27,2017,11,8,Wednseday
3,45,-28,17,2017,9,19,Tuesday
1,8,19,27,2018,6,21,Thursday
1,7,9,16,2018,7,24,Tuesday
1,9,14,23,2017,5,31,Wednseday
22,37,1,38,2018,2,26,Monday
1,9,19,28,2017,12,12,Tuesday
1,6,16,22,2017,4,12,Wednseday
1,44,-20,24,2018,2,5,Monday
2,8,14,22,2017,5,15,Monday
2,9,8,17,2018,5,7,Monday
0,4,23,27,2018,5,3,Thursday
0,7,4,11,2018,8,9,Thursday
6,15,4,19,2018,3,29,Thursday
5,11,10,21,2018,3,30,Friday
1,5,9,14,2018,8,3,Friday
1,20,12,32,2017,11,27,Monday
3,5,15,20,2017,12,15,Friday
1,50,-22,28,2018,3,29,Thursday
1,12,5,17,2017,6,18,Sunday
9,12,15,27,2017,2,11,Saturday
4,12,9,21,2018,5,17,Thursday
2,24,-4,20,2018,3,24,Saturday
3,10,13,23,2018,4,23,Monday
3,5,12,17,2018,5,18,Friday
3,4,7,11,2018,7,28,Saturday
10,13,2,15,2018,8,14,Tuesday
2,3,7,10,2018,4,2,Monday
4,19,9,28,2017,7,28,Friday
2,10,20,30,2018,4,24,Tuesday
7,14,13,27,2017,11,14,Tuesday
1,2,15,17,2017,8,29,Tuesday
3,7,14,21,2017,11,10,Friday
5,9,19,28,2018,8,8,Wednseday
9,22,-1,21,2017,11,28,Tuesday
4,28,-2,26,2017,12,8,Friday
1,14,15,29,2017,8,10,Thursday
1,11,14,25,2017,6,8,Thursday
2,27,5,32,2017,9,23,Saturday
1,3,11,14,2018,5,7,Monday
1,46,-23,23,2017,7,2,Sunday
1,6,1,7,2018,8,22,Wednseday
4,27,20,47,2017,4,15,Saturday
2,10,23,33,2017,12,2,Saturday
3,16,13,29,2017,7,23,Sunday
38,45,6,51,2016,10,4,Tuesday
3,16,20,36,2017,7,17,Monday
3,12,27,39,2017,2,4,Saturday
2,8,14,22,2017,10,23,Monday
3,8,9,17,2017,6,30,Friday
1,6,14,20,2018,4,3,Tuesday
9,25,-5,20,2017,6,17,Saturday
5,10,17,27,2017,11,25,Saturday
1,7,18,25,2018,5,10,Thursday
4,8,2,10,2017,10,16,Monday
4,26,15,41,2018,5,25,Friday
2,5,17,22,2017,8,2,Wednseday
3,36,-4,32,2017,8,14,Monday
6,13,10,23,2018,7,31,Tuesday
2,4,8,12,2017,5,21,Sunday
0,8,5,13,2018,8,22,Wednseday
1,9,15,24,2017,8,27,Sunday
3,6,17,23,2018,7,7,Saturday
15,29,5,34,2017,10,26,Thursday
19,23,10,33,2017,10,11,Wednseday
2,17,29,46,2018,6,3,Sunday
1,4,15,19,2017,5,11,Thursday
3,18,1,19,2018,5,18,Friday
4,6,17,23,2017,5,6,Saturday
0,3,7,10,2018,7,30,Monday
2,9,14,23,2018,2,20,Tuesday
0,1,16,17,2018,6,25,Monday
1,5,8,13,2018,8,15,Wednseday
1,7,29,36,2018,5,1,Tuesday
5,10,18,28,2017,6,30,Friday
2,9,17,26,2017,5,6,Saturday
1,2,5,7,2018,8,15,Wednseday
3,4,14,18,2017,12,1,Friday
1,9,17,26,2017,3,5,Sunday
1,12,20,32,2017,5,18,Thursday
3,11,24,35,2018,1,19,Friday
3,8,17,25,2017,6,5,Monday
1,14,8,22,2018,3,15,Thursday
1,11,35,46,2018,5,28,Monday
1,8,16,24,2018,1,9,Tuesday
3,10,19,29,2018,8,12,Sunday
8,15,20,35,2018,4,2,Monday
1,13,10,23,2017,11,8,Wednseday
0,12,17,29,2018,8,16,Thursday
0,8,4,12,2017,9,14,Thursday
0,15,15,30,2018,4,24,Tuesday
1,12,14,26,2017,7,13,Thursday
6,21,11,32,2017,8,5,Saturday
4,16,9,25,2018,4,7,Saturday
4,14,25,39,2017,10,13,Friday
3,4,15,19,2018,4,20,Friday
4,20,4,24,2018,3,19,Monday
0,6,19,25,2017,6,2,Friday
2,3,10,13,2018,3,24,Saturday
3,11,40,51,2018,6,10,Sunday
3,19,8,27,2018,1,20,Saturday
1,12,23,35,2018,5,24,Thursday
2,12,14,26,2017,6,17,Saturday
2,9,15,24,2018,8,19,Sunday
4,12,15,27,2017,10,13,Friday
2,3,18,21,2017,12,25,Monday
1,19,15,34,2018,1,3,Wednseday
3,17,14,31,2017,3,3,Friday
1,10,21,31,2018,5,13,Sunday
2,27,6,33,2017,12,20,Wednseday
2,15,6,21,2018,2,28,Wednseday
4,36,-4,32,2018,2,11,Sunday
4,14,8,22,2018,2,12,Monday
8,25,3,28,2017,11,28,Tuesday
1,21,14,35,2017,11,2,Thursday
2,7,1,8,2018,7,30,Monday
2,34,-2,32,2017,12,10,Sunday
3,4,6,10,2018,7,20,Friday
3,5,9,14,2018,7,20,Friday
1,4,13,17,2018,7,24,Tuesday
3,31,-6,25,2018,3,10,Saturday
1,17,13,30,2018,2,6,Tuesday
3,4,12,16,2018,6,30,Saturday
1,7,22,29,2018,2,27,Tuesday
1,13,28,41,2017,2,21,Tuesday
1,8,14,22,2018,1,30,Tuesday
2,3,10,13,2017,8,22,Tuesday
2,10,13,23,2018,7,16,Monday
2,15,22,37,2017,6,25,Sunday
4,19,6,25,2018,2,19,Monday
4,23,6,29,2017,11,28,Tuesday
7,15,3,18,2017,10,30,Monday
2,6,3,9,2018,8,11,Saturday
1,4,10,14,2017,5,25,Thursday
7,22,4,26,2017,6,30,Friday
1,7,30,37,2017,2,7,Tuesday
2,9,15,24,2018,8,18,Saturday
3,5,7,12,2017,9,3,Sunday
3,6,12,18,2017,11,19,Sunday
2,9,18,27,2017,12,13,Wednseday
4,9,9,18,2018,7,29,Sunday
3,10,12,22,2018,7,16,Monday
5,10,9,19,2017,3,10,Friday
2,5,8,13,2018,6,13,Wednseday
1,8,9,17,2018,7,16,Monday
3,17,18,35,2017,8,25,Friday
4,12,16,28,2018,4,20,Friday
3,10,10,20,2017,10,10,Tuesday
4,25,14,39,2018,1,14,Sunday
4,7,26,33,2017,9,28,Thursday
5,7,4,11,2018,5,17,Thursday
1,8,12,20,2017,7,11,Tuesday
3,14,24,38,2017,12,30,Saturday
4,15,4,19,2018,3,29,Thursday
1,8,17,25,2017,10,29,Sunday
2,3,2,5,2018,7,28,Saturday
1,6,17,23,2018,5,2,Wednseday
4,6,48,54,2017,1,21,Saturday
2,6,11,17,2018,8,12,Sunday
5,33,-12,21,2018,2,22,Thursday
4,31,3,34,2017,4,7,Friday
2,4,25,29,2018,6,25,Monday
4,13,18,31,2018,7,1,Sunday
1,7,13,20,2017,11,21,Tuesday
8,12,18,30,2018,1,21,Sunday
5,13,15,28,2017,3,31,Friday
1,8,22,30,2017,4,26,Wednseday
4,11,14,25,2018,2,24,Saturday
6,24,24,48,2018,5,30,Wednseday
5,12,9,21,2017,11,30,Thursday
2,16,6,22,2018,5,16,Wednseday
1,10,25,35,2017,6,13,Tuesday
6,73,-40,33,2017,12,28,Thursday
3,9,16,25,2018,1,20,Saturday
2,14,3,17,2018,4,3,Tuesday
2,3,12,15,2018,6,26,Tuesday
1,2,13,15,2018,2,14,Wednseday
7,13,6,19,2018,3,31,Saturday
0,4,13,17,2018,2,16,Friday
1,14,35,49,2017,8,17,Thursday
1,2,11,13,2017,7,25,Tuesday
1,9,16,25,2018,2,8,Thursday
1,2,8,10,2018,3,19,Monday
1,4,7,11,2018,6,7,Thursday
1,5,25,30,2017,2,19,Sunday
5,7,14,21,2017,2,24,Friday
5,8,9,17,2017,12,3,Sunday
1,11,17,28,2017,12,11,Monday
7,23,6,29,2018,1,2,Tuesday
1,9,19,28,2017,1,25,Wednseday
1,8,15,23,2017,6,5,Monday
1,6,14,20,2017,9,13,Wednseday
1,7,8,15,2017,10,30,Monday
2,15,4,19,2018,4,22,Sunday
3,9,15,24,2017,5,28,Sunday
2,6,35,41,2017,5,3,Wednseday
6,16,27,43,2018,6,5,Tuesday
1,2,2,4,2018,8,19,Sunday
2,8,25,33,2017,2,22,Wednseday
5,15,8,23,2018,1,10,Wednseday
3,8,3,11,2018,4,30,Monday
36,41,-14,27,2017,2,16,Thursday
5,18,13,31,2017,12,8,Friday
3,16,13,29,2017,8,15,Tuesday
3,6,12,18,2017,12,2,Saturday
4,5,6,11,2018,7,26,Thursday
1,14,9,23,2018,7,25,Wednseday
2,10,24,34,2017,12,16,Saturday
7,14,14,28,2017,4,6,Thursday
1,7,8,15,2018,8,8,Wednseday
4,11,8,19,2017,9,1,Friday
1,13,10,23,2017,10,8,Sunday
1,7,13,20,2018,6,28,Thursday
1,2,1,3,2018,8,21,Tuesday
2,5,8,13,2017,5,17,Wednseday
2,35,-6,29,2018,2,21,Wednseday
1,2,14,16,2018,1,14,Sunday
1,8,13,21,2018,8,16,Thursday
4,6,12,18,2018,5,3,Thursday
4,11,13,24,2017,8,11,Friday
2,11,15,26,2018,2,7,Wednseday
3,27,7,34,2018,1,5,Friday
1,16,26,42,2018,5,31,Thursday
2,17,9,26,2018,4,8,Sunday
3,22,1,23,2017,8,27,Sunday
1,11,34,45,2017,1,22,Sunday
3,10,9,19,2017,10,13,Friday
9,14,5,19,2018,6,7,Thursday
2,3,8,11,2018,7,8,Sunday
3,36,-5,31,2018,1,30,Tuesday
5,8,13,21,2017,12,15,Friday
4,5,7,12,2018,3,31,Saturday
3,6,13,19,2018,7,14,Saturday
0,21,35,56,2018,3,13,Tuesday
6,10,15,25,2018,2,9,Friday
2,11,7,18,2018,3,3,Saturday
2,9,14,23,2018,6,24,Sunday
1,8,15,23,2018,1,24,Wednseday
0,15,0,15,2018,1,16,Tuesday
2,9,9,18,2018,4,2,Monday
4,11,10,21,2017,6,1,Thursday
6,7,10,17,2018,1,19,Friday
14,21,14,35,2017,5,1,Monday
10,31,2,33,2018,2,17,Saturday
6,50,-22,28,2018,3,14,Wednseday
3,5,18,23,2018,6,23,Saturday
0,15,6,21,2018,8,9,Thursday
4,11,14,25,2017,6,3,Saturday
6,14,15,29,2017,12,13,Wednseday
2,8,16,24,2018,6,17,Sunday
6,30,3,33,2017,12,7,Thursday
2,23,-3,20,2017,11,21,Tuesday
2,6,9,15,2018,1,17,Wednseday
4,12,12,24,2017,7,1,Saturday
1,8,20,28,2018,5,7,Monday
2,14,23,37,2017,1,31,Tuesday
1,2,9,11,2017,8,21,Monday
1,8,16,24,2018,4,15,Sunday
0,8,21,29,2017,5,18,Thursday
8,11,7,18,2018,2,26,Monday
1,13,10,23,2017,4,4,Tuesday
5,11,20,31,2017,3,25,Saturday
4,20,5,25,2017,12,2,Saturday
2,5,14,19,2018,6,23,Saturday
5,12,23,35,2018,1,25,Thursday
2,5,16,21,2017,5,31,Wednseday
1,2,9,11,2017,6,19,Monday
3,11,16,27,2018,4,13,Friday
3,18,16,34,2017,7,21,Friday
8,15,7,22,2017,5,10,Wednseday
3,19,1,20,2018,5,19,Saturday
1,2,10,12,2017,9,3,Sunday
7,36,-3,33,2017,11,30,Thursday
2,4,15,19,2017,11,5,Sunday
1,11,18,29,2017,1,17,Tuesday
2,3,9,12,2017,8,27,Sunday
1,4,9,13,2017,5,25,Thursday
4,8,33,41,2018,6,14,Thursday
2,5,14,19,2017,3,15,Wednseday
1,12,15,27,2017,5,24,Wednseday
7,15,3,18,2018,2,16,Friday
7,20,11,31,2017,6,27,Tuesday
1,19,9,28,2017,10,25,Wednseday
4,12,19,31,2017,2,18,Saturday
6,9,42,51,2016,10,4,Tuesday
8,12,5,17,2018,8,3,Friday
1,11,27,38,2017,12,25,Monday
3,6,24,30,2017,8,19,Saturday
3,20,2,22,2018,2,26,Monday
4,15,10,25,2018,7,6,Friday
2,10,8,18,2017,11,6,Monday
4,14,11,25,2018,2,23,Friday
1,9,20,29,2018,8,12,Sunday
1,19,11,30,2017,7,26,Wednseday
1,2,11,13,2018,3,27,Tuesday
2,27,0,27,2018,4,3,Tuesday
2,12,21,33,2018,6,17,Sunday
1,14,3,17,2017,3,6,Monday
1,4,3,7,2018,8,9,Thursday
1,2,1,3,2018,8,14,Tuesday
3,15,18,33,2017,11,19,Sunday
2,8,12,20,2017,6,27,Tuesday
2,5,8,13,2017,8,16,Wednseday
6,7,6,13,2017,5,31,Wednseday
10,14,27,41,2017,2,3,Friday
2,9,6,15,2018,5,8,Tuesday
3,14,10,24,2017,7,11,Tuesday
1,8,16,24,2017,10,24,Tuesday
4,8,3,11,2018,8,2,Thursday
4,5,14,19,2018,5,4,Friday
0,4,16,20,2018,4,26,Thursday
2,8,41,49,2017,6,6,Tuesday
5,7,11,18,2018,4,19,Thursday
5,19,19,38,2018,2,3,Saturday
2,14,10,24,2018,4,24,Tuesday
2,7,23,30,2018,8,22,Wednseday
2,13,6,19,2018,1,13,Saturday
2,15,14,29,2017,11,8,Wednseday
1,7,10,17,2018,3,26,Monday
2,50,-22,28,2018,3,13,Tuesday
5,13,16,29,2018,4,19,Thursday
1,6,9,15,2018,1,23,Tuesday
10,21,7,28,2017,4,25,Tuesday
1,9,11,20,2018,4,18,Wednseday
1,10,8,18,2017,9,10,Sunday
3,21,1,22,2018,2,27,Tuesday
4,11,17,28,2017,12,29,Friday
2,10,3,13,2018,7,31,Tuesday
1,6,16,22,2017,7,25,Tuesday
1,14,9,23,2017,11,29,Wednseday
2,10,20,30,2017,12,4,Monday
12,17,19,36,2018,4,2,Monday
5,21,5,26,2018,2,9,Friday
3,16,11,27,2017,6,13,Tuesday
3,4,7,11,2017,7,31,Monday
4,5,3,8,2018,8,6,Monday
0,18,6,24,2018,3,23,Friday
5,8,20,28,2018,3,29,Thursday
0,14,10,24,2018,7,13,Friday
4,18,10,28,2018,1,19,Friday
2,19,17,36,2018,4,9,Monday
3,4,8,12,2018,4,6,Friday
3,7,10,17,2018,8,3,Friday
0,10,11,21,2017,6,9,Friday
5,18,2,20,2018,5,3,Thursday
8,15,10,25,2017,9,4,Monday
1,5,19,24,2018,1,7,Sunday
2,17,8,25,2017,9,18,Monday
2,5,24,29,2017,7,2,Sunday
1,9,16,25,2017,10,2,Monday
2,8,16,24,2017,9,24,Sunday
4,5,8,13,2017,7,7,Friday
1,6,7,13,2017,8,16,Wednseday
4,8,12,20,2017,8,3,Thursday
0,14,24,38,2018,7,20,Friday
1,6,23,29,2017,11,29,Wednseday
1,18,15,33,2017,6,1,Thursday
1,16,8,24,2018,5,21,Monday
3,44,-21,23,2018,3,25,Sunday
2,12,14,26,2017,7,26,Wednseday
0,5,22,27,2018,1,9,Tuesday
2,4,23,27,2017,2,4,Saturday
1,11,11,22,2017,9,4,Monday
2,3,20,23,2017,6,11,Sunday
3,5,14,19,2017,7,23,Sunday
3,7,17,24,2018,4,30,Monday
4,16,7,23,2018,3,12,Monday
2,16,18,34,2017,12,5,Tuesday
2,7,17,24,2018,8,21,Tuesday
3,9,11,20,2018,7,28,Saturday
1,7,24,31,2018,1,29,Monday
6,17,13,30,2018,6,12,Tuesday
3,11,14,25,2017,11,6,Monday
3,14,20,34,2018,6,19,Tuesday
0,10,9,19,2017,10,11,Wednseday
2,8,9,17,2018,3,5,Monday
1,6,14,20,2017,7,4,Tuesday
5,25,1,26,2018,3,3,Saturday
2,31,-8,23,2017,12,4,Monday
4,11,7,18,2018,7,5,Thursday
5,10,9,19,2018,8,15,Wednseday
2,10,18,28,2017,10,4,Wednseday
0,20,14,34,2018,7,5,Thursday
4,7,3,10,2018,5,7,Monday
1,8,15,23,2018,5,29,Tuesday
3,12,5,17,2018,4,1,Sunday
1,6,21,27,2017,9,28,Thursday
1,10,18,28,2017,9,18,Monday
2,13,17,30,2018,4,14,Saturday
2,4,8,12,2018,8,12,Sunday
2,9,20,29,2017,2,15,Wednseday
2,32,19,51,2018,3,12,Monday
5,27,8,35,2018,1,25,Thursday
1,15,19,34,2018,2,6,Tuesday
1,13,9,22,2017,11,26,Sunday
2,5,5,10,2018,8,25,Saturday
1,3,14,17,2018,4,8,Sunday
3,4,13,17,2017,6,9,Friday
5,5,11,16,2018,1,8,Monday
1,9,12,21,2018,4,3,Tuesday
2,10,22,32,2017,6,24,Saturday
10,25,0,25,2017,9,10,Sunday
8,9,2,11,2018,7,23,Monday
6,11,11,22,2017,7,20,Thursday
3,7,3,10,2018,3,6,Tuesday
1,6,6,12,2018,8,23,Thursday
1,9,14,23,2017,11,7,Tuesday
5,33,2,35,2017,12,14,Thursday
4,22,7,29,2017,10,12,Thursday
3,33,5,38,2017,12,2,Saturday
1,4,17,21,2017,11,6,Monday
6,13,12,25,2018,2,1,Thursday
1,7,20,27,2017,3,23,Thursday
1,7,22,29,2017,10,3,Tuesday
1,12,17,29,2017,8,17,Thursday
0,3,15,18,2017,12,1,Friday
3,10,13,23,2018,8,13,Monday
6,7,1,8,2018,7,25,Wednseday
3,10,21,31,2018,7,3,Tuesday
5,12,7,19,2018,8,9,Thursday
1,4,5,9,2018,5,20,Sunday
4,7,18,25,2017,5,25,Thursday
2,14,15,29,2018,2,6,Tuesday
8,21,7,28,2017,8,29,Tuesday
1,15,14,29,2017,11,27,Monday
2,8,14,22,2017,7,4,Tuesday
2,33,-10,23,2017,11,27,Monday
1,15,22,37,2017,11,22,Wednseday
1,16,19,35,2017,7,31,Monday
2,20,26,46,2018,5,26,Saturday
5,11,16,27,2018,3,16,Friday
1,10,19,29,2018,1,31,Wednseday
3,10,16,26,2017,6,30,Friday
4,11,8,19,2017,11,18,Saturday
1,17,7,24,2017,11,5,Sunday
1,4,14,18,2018,1,4,Thursday
1,16,10,26,2018,2,14,Wednseday
2,13,16,29,2018,5,1,Tuesday
1,9,12,21,2017,9,5,Tuesday
1,16,7,23,2017,11,27,Monday
4,6,12,18,2017,7,14,Friday
2,3,3,6,2018,8,25,Saturday
1,16,13,29,2018,3,7,Wednseday
3,20,10,30,2018,1,6,Saturday
1,2,22,24,2018,6,11,Monday
6,28,4,32,2017,8,18,Friday
2,7,7,14,2018,7,17,Tuesday
1,8,18,26,2017,12,27,Wednseday
3,4,16,20,2018,4,20,Friday
3,7,12,19,2017,10,21,Saturday
14,15,9,24,2018,5,15,Tuesday
3,17,15,32,2018,6,2,Saturday
3,14,13,27,2017,12,15,Friday
2,14,13,27,2017,11,8,Wednseday
2,10,18,28,2018,1,8,Monday
5,10,23,33,2018,7,11,Wednseday
4,8,11,19,2017,10,26,Thursday
1,8,23,31,2018,6,4,Monday
4,5,7,12,2017,10,14,Saturday
0,5,22,27,2018,6,30,Saturday
1,15,19,34,2017,12,21,Thursday
2,45,-28,17,2017,11,21,Tuesday
2,4,7,11,2018,6,24,Sunday
7,12,10,22,2017,8,9,Wednseday
0,7,13,20,2017,10,20,Friday
7,10,5,15,2018,1,18,Thursday
10,24,12,36,2017,10,3,Tuesday
1,2,13,15,2017,9,20,Wednseday
5,12,16,28,2017,8,31,Thursday
2,16,14,30,2018,3,17,Saturday
3,12,19,31,2018,7,13,Friday
1,4,17,21,2017,6,5,Monday
1,11,0,11,2018,8,12,Sunday
2,8,17,25,2017,5,22,Monday
4,22,1,23,2018,5,13,Sunday
4,11,7,18,2018,8,19,Sunday
3,13,7,20,2018,7,13,Friday
1,2,12,14,2017,10,24,Tuesday
2,5,10,15,2018,6,20,Wednseday
6,18,16,34,2018,2,9,Friday
2,6,14,20,2017,8,15,Tuesday
3,12,12,24,2017,4,29,Saturday
1,2,10,12,2018,5,20,Sunday
3,12,14,26,2018,2,16,Friday
4,15,13,28,2018,4,16,Monday
4,31,-5,26,2017,11,23,Thursday
3,8,26,34,2018,6,1,Friday
1,9,13,22,2017,6,28,Wednseday
5,11,10,21,2018,5,3,Thursday
5,10,7,17,2017,7,8,Saturday
2,10,12,22,2017,7,18,Tuesday
1,15,13,28,2017,12,20,Wednseday
2,7,5,12,2018,3,31,Saturday
6,14,2,16,2017,9,13,Wednseday
2,11,7,18,2017,10,23,Monday
2,8,19,27,2017,8,1,Tuesday
2,12,23,35,2017,8,16,Wednseday
2,10,12,22,2017,7,4,Tuesday
2,4,11,15,2018,7,22,Sunday
2,7,14,21,2017,4,4,Tuesday
4,16,10,26,2018,1,11,Thursday
2,9,17,26,2018,4,7,Saturday
3,24,6,30,2017,9,17,Sunday
2,4,17,21,2017,11,27,Monday
1,14,21,35,2017,10,26,Thursday
3,12,11,23,2017,10,14,Saturday
1,16,0,16,2018,5,16,Wednseday
2,4,8,12,2017,6,18,Sunday
5,11,21,32,2017,4,27,Thursday
5,7,7,14,2018,2,15,Thursday
1,5,12,17,2018,7,1,Sunday
3,4,13,17,2017,8,18,Friday
1,4,7,11,2018,8,6,Monday
3,7,26,33,2018,6,8,Friday
1,28,5,33,2017,12,20,Wednseday
7,17,21,38,2017,10,2,Monday
0,1,12,13,2018,5,10,Thursday
10,11,-2,9,2018,8,5,Sunday
3,8,22,30,2017,8,6,Sunday
13,24,-1,23,2017,11,28,Tuesday
4,17,7,24,2017,9,1,Friday
1,6,8,14,2018,8,9,Thursday
1,10,11,21,2018,1,16,Tuesday
1,7,21,28,2017,9,25,Monday
11,25,2,27,2018,1,11,Thursday
3,11,16,27,2018,1,5,Friday
1,15,19,34,2018,2,2,Friday
9,15,-2,13,2018,5,1,Tuesday
1,19,15,34,2018,4,11,Wednseday
3,11,5,16,2018,1,21,Sunday
2,7,17,24,2018,7,30,Monday
5,10,15,25,2017,9,2,Saturday
1,24,3,27,2018,3,20,Tuesday
2,13,14,27,2018,4,11,Wednseday
2,12,13,25,2018,1,14,Sunday
1,21,5,26,2018,2,21,Wednseday
10,19,5,24,2017,11,24,Friday
2,6,14,20,2018,2,17,Saturday
1,9,8,17,2018,8,19,Sunday
0,12,11,23,2017,6,7,Wednseday
5,12,30,42,2017,12,1,Friday
2,14,16,30,2017,10,4,Wednseday
1,2,25,27,2018,6,6,Wednseday
1,7,8,15,2018,5,14,Monday
0,10,28,38,2017,2,10,Friday
2,5,9,14,2017,11,27,Monday
6,22,18,40,2018,1,5,Friday
2,38,-8,30,2018,1,24,Wednseday
2,17,13,30,2017,6,4,Sunday
2,5,18,23,2017,7,2,Sunday
3,9,12,21,2018,7,16,Monday
16,17,14,31,2017,12,11,Monday
2,8,12,20,2017,8,16,Wednseday
1,5,1,6,2018,8,16,Thursday
1,4,14,18,2018,7,22,Sunday
5,9,18,27,2018,4,18,Wednseday
2,10,20,30,2017,4,23,Sunday
2,7,1,8,2018,8,8,Wednseday
0,1,9,10,2018,7,20,Friday
3,11,15,26,2018,4,13,Friday
6,10,7,17,2017,10,10,Tuesday
1,5,4,9,2018,5,9,Wednseday
1,7,20,27,2018,7,19,Thursday
1,8,13,21,2018,8,1,Wednseday
1,8,16,24,2018,8,13,Monday
3,16,8,24,2017,11,25,Saturday
4,17,6,23,2017,7,2,Sunday
1,6,21,27,2018,7,24,Tuesday
4,21,18,39,2017,11,30,Thursday
2,8,15,23,2017,5,28,Sunday
1,6,12,18,2017,10,19,Thursday
1,10,4,14,2017,6,7,Wednseday
1,13,9,22,2017,11,22,Wednseday
4,11,16,27,2017,11,24,Friday
3,8,6,14,2017,10,31,Tuesday
0,3,8,11,2018,6,8,Friday
0,10,21,31,2017,8,18,Friday
4,17,8,25,2018,5,18,Friday
3,9,17,26,2017,11,19,Sunday
0,18,5,23,2018,4,3,Tuesday
7,13,1,14,2018,8,9,Thursday
4,14,26,40,2017,12,14,Thursday
3,6,26,32,2018,7,27,Friday
2,6,17,23,2018,5,12,Saturday
1,9,16,25,2018,5,3,Thursday
1,15,10,25,2018,5,24,Thursday
1,13,15,28,2018,2,6,Tuesday
2,16,26,42,2018,6,20,Wednseday
1,37,-16,21,2017,4,5,Wednseday
1,4,24,28,2018,7,9,Monday
10,17,14,31,2018,7,27,Friday
4,41,-10,31,2017,4,15,Saturday
1,34,-5,29,2018,1,24,Wednseday
1,18,7,25,2017,11,6,Monday
2,8,15,23,2018,7,23,Monday
1,21,11,32,2017,9,28,Thursday
1,22,12,34,2017,10,4,Wednseday
3,4,10,14,2017,11,27,Monday
5,7,13,20,2018,7,20,Friday
5,19,7,26,2018,1,19,Friday
1,5,14,19,2018,3,28,Wednseday
5,8,45,53,2016,10,10,Monday
8,9,12,21,2018,1,17,Wednseday
1,19,0,19,2018,3,21,Wednseday
2,9,13,22,2017,11,7,Tuesday
3,7,13,20,2017,8,5,Saturday
2,10,16,26,2017,6,4,Sunday
3,9,21,30,2018,4,30,Monday
4,11,16,27,2017,11,24,Friday
2,17,13,30,2018,6,24,Sunday
3,10,9,19,2018,2,18,Sunday
1,10,11,21,2018,1,16,Tuesday
0,7,20,27,2017,10,4,Wednseday
2,12,17,29,2018,4,11,Wednseday
1,3,18,21,2018,6,25,Monday
1,5,3,8,2018,8,22,Wednseday
6,26,-7,19,2018,4,27,Friday
13,15,12,27,2017,10,4,Wednseday
0,23,16,39,2018,4,19,Thursday
2,15,21,36,2018,4,15,Sunday
1,7,10,17,2018,8,20,Monday
0,6,21,27,2017,5,5,Friday
2,13,10,23,2017,9,13,Wednseday
2,23,14,37,2017,6,3,Saturday
2,9,10,19,2017,9,9,Saturday
1,6,16,22,2017,7,20,Thursday
6,12,46,58,2016,10,9,Sunday
3,10,10,20,2018,2,16,Friday
1,12,20,32,2018,6,11,Monday
5,8,20,28,2018,6,13,Wednseday
4,12,13,25,2017,3,4,Saturday
3,7,21,28,2018,5,4,Friday
1,3,6,9,2018,7,10,Tuesday
3,14,12,26,2018,3,9,Friday
2,3,6,9,2018,7,9,Monday
4,15,6,21,2017,10,9,Monday
3,3,8,11,2018,4,8,Sunday
1,13,2,15,2018,1,18,Thursday
2,10,7,17,2018,8,19,Sunday
1,10,2,12,2018,4,15,Sunday
0,3,19,22,2017,11,27,Monday
4,14,4,18,2018,2,1,Thursday
3,10,14,24,2018,1,30,Tuesday
2,6,18,24,2018,1,27,Saturday
2,7,17,24,2018,8,20,Monday
1,22,5,27,2018,3,27,Tuesday
17,45,-20,25,2018,2,23,Friday
1,5,14,19,2017,10,26,Thursday
8,29,1,30,2018,3,5,Monday
2,10,26,36,2017,4,3,Monday
3,12,30,42,2017,8,18,Friday
4,17,18,35,2017,9,29,Friday
0,1,13,14,2018,4,11,Wednseday
2,4,11,15,2018,1,22,Monday
1,8,35,43,2018,6,27,Wednseday
2,4,23,27,2018,6,6,Wednseday
1,15,13,28,2017,5,16,Tuesday
3,12,13,25,2018,7,14,Saturday
1,8,23,31,2018,1,1,Monday
1,6,14,20,2018,7,18,Wednseday
1,9,11,20,2017,6,27,Tuesday
3,19,7,26,2018,3,10,Saturday
4,17,8,25,2017,6,5,Monday
16,24,-1,23,2017,11,25,Saturday
1,4,24,28,2017,10,2,Monday
7,14,20,34,2017,7,5,Wednseday
4,14,2,16,2017,9,25,Monday
2,13,23,36,2018,3,14,Wednseday
2,16,11,27,2018,3,20,Tuesday
1,7,16,23,2018,6,19,Tuesday
0,2,13,15,2017,8,2,Wednseday
3,4,12,16,2018,4,22,Sunday
1,25,-4,21,2018,2,26,Monday
7,17,5,22,2017,8,15,Tuesday
3,13,13,26,2018,1,27,Saturday
1,2,8,10,2017,9,18,Monday
1,11,7,18,2018,7,23,Monday
6,188,-162,26,2017,3,15,Wednseday
1,12,10,22,2017,9,27,Wednseday
0,3,2,5,2018,8,24,Friday
2,11,18,29,2018,7,8,Sunday
3,10,11,21,2017,9,8,Friday
3,10,15,25,2018,5,26,Saturday
3,9,12,21,2017,3,7,Tuesday
1,6,14,20,2018,6,13,Wednseday
3,30,-9,21,2018,3,5,Monday
3,18,2,20,2017,11,3,Friday
2,8,10,18,2018,3,18,Sunday
1,10,26,36,2018,5,28,Monday
1,7,10,17,2017,3,6,Monday
1,3,6,9,2017,10,31,Tuesday
5,6,12,18,2018,6,29,Friday
0,6,28,34,2018,1,26,Friday
1,8,12,20,2018,6,28,Thursday
3,18,14,32,2018,2,4,Sunday
1,13,15,28,2017,3,30,Thursday
2,12,8,20,2017,8,16,Wednseday
4,6,16,22,2017,9,21,Thursday
2,9,22,31,2018,7,14,Saturday
19,31,-7,24,2017,6,24,Saturday
1,13,16,29,2018,4,5,Thursday
3,9,11,20,2018,3,24,Saturday
0,13,22,35,2017,8,11,Friday
1,14,21,35,2017,8,23,Wednseday
4,19,26,45,2018,2,25,Sunday
0,2,8,10,2018,6,18,Monday
3,24,3,27,2018,5,12,Saturday
3,8,16,24,2018,8,19,Sunday
7,12,9,21,2018,1,10,Wednseday
20,23,21,44,2018,7,18,Wednseday
6,16,0,16,2017,10,31,Tuesday
0,11,22,33,2017,4,7,Friday
2,17,6,23,2017,10,4,Wednseday
0,1,2,3,2018,8,6,Monday
2,10,20,30,2017,7,16,Sunday
2,21,3,24,2017,10,16,Monday
5,19,6,25,2017,11,24,Friday
1,6,16,22,2017,3,28,Tuesday
1,2,13,15,2018,4,11,Wednseday
12,32,-12,20,2017,4,20,Thursday
1,9,9,18,2018,4,16,Monday
1,54,-31,23,2018,3,12,Monday
6,10,5,15,2018,7,17,Tuesday
3,9,11,20,2017,6,17,Saturday
2,17,20,37,2018,4,8,Sunday
1,8,14,22,2017,7,13,Thursday
7,8,1,9,2018,8,20,Monday
2,3,13,16,2018,5,19,Saturday
5,7,6,13,2017,7,19,Wednseday
2,15,8,23,2017,8,27,Sunday
1,15,17,32,2017,4,27,Thursday
2,13,11,24,2017,7,11,Tuesday
0,6,13,19,2017,10,18,Wednseday
6,17,6,23,2018,8,11,Saturday
0,1,9,10,2018,3,5,Monday
2,14,12,26,2018,7,18,Wednseday
3,5,5,10,2018,8,3,Friday
5,26,-1,25,2017,11,19,Sunday
5,10,10,20,2017,11,24,Friday
3,8,13,21,2018,6,25,Monday
8,12,13,25,2017,5,15,Monday
0,8,18,26,2018,6,8,Friday
2,11,5,16,2018,5,12,Saturday
1,4,4,8,2018,7,19,Thursday
3,14,3,17,2018,8,7,Tuesday
1,9,24,33,2017,2,22,Wednseday
1,2,8,10,2017,10,17,Tuesday
0,3,15,18,2017,12,1,Friday
4,11,19,30,2018,1,6,Saturday
2,14,14,28,2018,5,8,Tuesday
0,4,23,27,2018,6,14,Thursday
4,5,9,14,2018,3,29,Thursday
0,10,17,27,2018,3,27,Tuesday
3,17,18,35,2018,2,6,Tuesday
3,7,15,22,2017,8,7,Monday
2,12,15,27,2018,4,7,Saturday
1,6,11,17,2018,7,3,Tuesday
3,8,21,29,2017,7,18,Tuesday
3,14,11,25,2018,8,6,Monday
1,24,9,33,2017,7,23,Sunday
1,8,14,22,2017,5,16,Tuesday
1,14,12,26,2018,1,10,Wednseday
4,17,9,26,2017,11,17,Friday
0,27,-5,22,2018,6,28,Thursday
2,8,15,23,2017,10,8,Sunday
16,28,29,57,2017,5,28,Sunday
1,3,20,23,2017,5,29,Monday
2,10,12,22,2017,8,14,Monday
1,9,29,38,2018,3,25,Sunday
1,8,13,21,2018,7,23,Monday
2,10,14,24,2018,1,15,Monday
0,5,5,10,2018,8,13,Monday
1,10,22,32,2018,3,26,Monday
4,23,9,32,2018,5,17,Thursday
4,22,10,32,2017,11,24,Friday
3,10,19,29,2018,1,1,Monday
3,13,22,35,2017,10,24,Tuesday
6,13,9,22,2017,8,10,Thursday
1,7,24,31,2017,12,12,Tuesday
1,8,18,26,2017,12,10,Sunday
2,7,14,21,2018,3,26,Monday
2,10,26,36,2017,1,23,Monday
3,9,16,25,2017,5,14,Sunday
1,7,4,11,2018,8,2,Thursday
8,22,9,31,2017,7,10,Monday
3,13,22,35,2017,3,31,Friday
8,16,16,32,2017,3,12,Sunday
2,15,20,35,2017,2,6,Monday
6,15,12,27,2017,5,3,Wednseday
1,2,19,21,2017,12,25,Monday
1,8,12,20,2018,5,2,Wednseday
0,5,7,12,2018,8,15,Wednseday
1,11,13,24,2017,4,23,Sunday
3,11,15,26,2017,9,2,Saturday
1,7,17,24,2017,10,3,Tuesday
3,7,6,13,2018,8,17,Friday
1,8,13,21,2018,2,21,Wednseday
1,7,8,15,2017,11,27,Monday
3,18,18,36,2018,1,21,Sunday
1,9,21,30,2017,2,12,Sunday
10,16,10,26,2017,6,3,Saturday
5,33,-13,20,2018,3,3,Saturday
2,7,18,25,2018,5,5,Saturday
3,16,12,28,2018,1,29,Monday
3,13,13,26,2017,2,26,Sunday
6,19,9,28,2017,11,30,Thursday
0,18,8,26,2018,2,9,Friday
3,10,26,36,2017,11,21,Tuesday
5,10,6,16,2017,11,25,Saturday
9,25,6,31,2018,2,11,Sunday
2,18,6,24,2017,5,29,Monday
2,17,5,22,2018,4,16,Monday
9,13,-3,10,2017,11,21,Tuesday
1,13,5,18,2018,3,4,Sunday
8,12,12,24,2017,3,12,Sunday
2,13,15,28,2018,2,13,Tuesday
2,18,14,32,2017,7,1,Saturday
2,24,3,27,2018,5,8,Tuesday
2,9,19,28,2017,8,28,Monday
1,6,15,21,2017,10,17,Tuesday
2,4,2,6,2018,8,21,Tuesday
4,10,11,21,2017,8,18,Friday
2,7,12,19,2017,9,27,Wednseday
5,8,3,11,2018,5,17,Thursday
14,21,16,37,2018,3,13,Tuesday
2,7,21,28,2017,10,16,Monday
3,26,-3,23,2018,3,17,Saturday
0,1,13,14,2018,2,27,Tuesday
2,10,24,34,2018,1,27,Saturday
0,6,18,24,2018,2,2,Friday
5,8,4,12,2018,3,9,Friday
7,8,7,15,2018,2,15,Thursday
4,10,11,21,2017,5,19,Friday
3,20,28,48,2017,4,21,Friday
1,8,14,22,2018,8,2,Thursday
2,6,15,21,2017,8,22,Tuesday
4,7,31,38,2018,6,8,Friday
2,10,19,29,2018,1,21,Sunday
5,6,12,18,2017,7,7,Friday
2,9,20,29,2017,12,5,Tuesday
1,4,14,18,2017,11,19,Sunday
6,11,11,22,2017,5,11,Thursday
7,16,11,27,2017,9,12,Tuesday
1,13,9,22,2017,4,19,Wednseday
1,3,13,16,2018,1,3,Wednseday
1,9,11,20,2018,5,15,Tuesday
3,11,11,22,2017,10,16,Monday
5,18,14,32,2017,5,18,Thursday
3,10,22,32,2018,3,11,Sunday
5,6,17,23,2018,4,14,Saturday
5,18,2,20,2017,11,24,Friday
6,13,8,21,2017,10,31,Tuesday
3,7,10,17,2017,10,17,Tuesday
3,27,8,35,2018,1,12,Friday
1,8,16,24,2017,7,11,Tuesday
2,15,6,21,2018,2,26,Monday
2,14,14,28,2017,12,12,Tuesday
1,6,17,23,2017,3,26,Sunday
1,12,23,35,2018,1,10,Wednseday
2,9,23,32,2017,6,10,Saturday
2,8,12,20,2017,10,18,Wednseday
3,5,13,18,2018,3,31,Saturday
1,6,8,14,2018,7,31,Tuesday
2,22,2,24,2018,7,14,Saturday
1,12,14,26,2018,2,21,Wednseday
1,6,9,15,2018,2,14,Wednseday
2,14,17,31,2018,3,12,Monday
0,4,17,21,2017,11,24,Friday
1,3,7,10,2017,9,19,Tuesday
0,7,26,33,2017,12,20,Wednseday
1,9,19,28,2017,5,17,Wednseday
5,10,24,34,2018,1,12,Friday
3,6,14,20,2018,7,27,Friday
1,7,22,29,2017,11,27,Monday
3,17,16,33,2018,2,2,Friday
4,11,15,26,2018,1,4,Thursday
4,8,11,19,2018,3,29,Thursday
2,18,18,36,2018,2,4,Sunday
1,10,26,36,2017,12,17,Sunday
2,4,10,14,2018,6,11,Monday
11,13,6,19,2018,6,2,Saturday
1,20,1,21,2018,2,28,Wednseday
5,12,21,33,2017,4,5,Wednseday
0,1,13,14,2018,7,5,Thursday
6,11,14,25,2018,8,4,Saturday
0,7,10,17,2018,7,30,Monday
1,2,14,16,2018,4,10,Tuesday
3,6,12,18,2018,8,3,Friday
1,2,2,4,2018,8,13,Monday
3,36,-18,18,2018,2,26,Monday
4,12,13,25,2017,8,17,Thursday
2,7,15,22,2017,8,1,Tuesday
3,17,9,26,2018,5,19,Saturday
3,18,12,30,2017,12,3,Sunday
1,2,13,15,2018,2,25,Sunday
3,12,14,26,2017,6,23,Friday
1,7,23,30,2018,1,24,Wednseday
2,12,26,38,2017,2,5,Sunday
1,10,13,23,2018,7,3,Tuesday
3,21,10,31,2017,6,13,Tuesday
1,3,11,14,2017,11,28,Tuesday
1,5,7,12,2018,3,14,Wednseday
7,25,10,35,2018,3,26,Monday
2,9,23,32,2017,10,2,Monday
4,15,16,31,2017,8,13,Sunday
1,3,19,22,2017,8,1,Tuesday
1,11,7,18,2018,5,7,Monday
3,4,15,19,2018,4,20,Friday
4,13,26,39,2017,6,1,Thursday
28,40,22,62,2018,1,24,Wednseday
1,8,6,14,2018,7,30,Monday
5,20,12,32,2018,7,19,Thursday
1,3,13,16,2018,8,19,Sunday
2,10,14,24,2018,3,18,Sunday
2,7,10,17,2017,3,7,Tuesday
0,6,31,37,2018,5,15,Tuesday
5,13,9,22,2017,8,3,Thursday
1,11,11,22,2017,4,23,Sunday
1,12,22,34,2018,1,16,Tuesday
1,2,12,14,2018,2,21,Wednseday
1,5,8,13,2018,7,5,Thursday
0,11,20,31,2017,6,20,Tuesday
48,64,-29,35,2017,12,20,Wednseday
11,13,6,19,2018,1,12,Friday
2,14,10,24,2017,9,23,Saturday
5,14,6,20,2017,7,14,Friday
1,8,14,22,2018,7,17,Tuesday
3,8,6,14,2017,11,13,Monday
1,9,11,20,2017,5,9,Tuesday
2,10,19,29,2017,10,9,Monday
3,27,-3,24,2018,5,12,Saturday
2,12,12,24,2018,4,1,Sunday
4,18,14,32,2017,9,22,Friday
1,6,24,30,2018,8,1,Wednseday
7,16,7,23,2017,12,6,Wednseday
2,7,6,13,2018,8,1,Wednseday
3,6,22,28,2017,7,28,Friday
12,14,29,43,2017,2,8,Wednseday
4,18,9,27,2017,11,24,Friday
1,6,8,14,2018,7,25,Wednseday
3,14,19,33,2018,4,13,Friday
1,20,3,23,2017,8,29,Tuesday
11,13,0,13,2017,11,17,Friday
1,4,10,14,2017,6,8,Thursday
6,9,-1,8,2018,8,8,Wednseday
3,13,13,26,2018,1,13,Saturday
2,4,8,12,2018,8,4,Saturday
2,3,15,18,2018,6,2,Saturday
0,5,24,29,2018,7,5,Thursday
1,14,21,35,2018,6,14,Thursday
6,23,14,37,2018,1,24,Wednseday
2,14,17,31,2017,9,30,Saturday
0,5,17,22,2017,5,17,Wednseday
2,11,13,24,2018,4,30,Monday
1,23,7,30,2017,12,11,Monday
1,5,11,16,2018,5,13,Sunday
2,14,8,22,2017,8,15,Tuesday
2,8,16,24,2018,6,25,Monday
6,15,6,21,2017,2,24,Friday
4,11,4,15,2017,11,2,Thursday
1,7,14,21,2017,12,20,Wednseday
34,43,-7,36,2017,7,5,Wednseday
1,6,12,18,2018,3,8,Thursday
2,14,13,27,2017,4,26,Wednseday
3,9,26,35,2018,7,31,Tuesday
17,21,10,31,2017,11,13,Monday
4,16,7,23,2017,8,7,Monday
1,9,9,18,2017,7,17,Monday
1,8,12,20,2017,4,19,Wednseday
1,9,1,10,2018,6,18,Monday
7,21,9,30,2017,12,5,Tuesday
3,7,9,16,2017,7,22,Saturday
5,6,7,13,2018,7,6,Friday
1,5,15,20,2017,8,17,Thursday
4,34,-1,33,2018,2,22,Thursday
1,2,7,9,2018,7,22,Sunday
1,24,9,33,2017,6,25,Sunday
4,12,31,43,2018,5,31,Thursday
1,15,21,36,2017,6,4,Sunday
1,2,6,8,2018,5,7,Monday
1,5,22,27,2018,6,6,Wednseday
9,15,16,31,2017,10,16,Monday
4,19,20,39,2017,6,2,Friday
3,4,15,19,2017,7,9,Sunday
1,4,6,10,2018,4,2,Monday
3,24,-2,22,2018,2,26,Monday
1,3,15,18,2017,9,10,Sunday
1,6,14,20,2017,5,9,Tuesday
3,24,1,25,2017,11,24,Friday
4,13,21,34,2017,7,28,Friday
2,12,8,20,2017,10,11,Wednseday
6,9,43,52,2016,10,9,Sunday
4,7,6,13,2018,8,3,Friday
4,9,9,18,2017,8,27,Sunday
10,21,8,29,2018,5,14,Monday
5,36,-8,28,2018,2,28,Wednseday
1,7,16,23,2018,4,17,Tuesday
3,10,17,27,2017,10,21,Saturday
2,5,11,16,2017,8,23,Wednseday
0,9,12,21,2018,5,14,Monday
3,11,22,33,2017,1,14,Saturday
3,10,16,26,2017,10,6,Friday
1,2,6,8,2018,8,28,Tuesday
7,24,10,34,2018,2,20,Tuesday
1,5,23,28,2018,6,28,Thursday
3,13,18,31,2018,1,26,Friday
1,30,11,41,2018,5,22,Tuesday
2,10,0,10,2018,8,13,Monday
1,10,6,16,2018,7,25,Wednseday
3,9,17,26,2017,12,9,Saturday
1,8,20,28,2017,8,9,Wednseday
3,5,25,30,2017,3,18,Saturday
2,8,12,20,2017,10,24,Tuesday
7,35,2,37,2018,1,10,Wednseday
2,9,5,14,2018,8,21,Tuesday
1,7,15,22,2017,6,19,Monday
1,42,-6,36,2018,3,14,Wednseday
1,2,12,14,2017,11,8,Wednseday
1,11,8,19,2018,3,8,Thursday
0,6,7,13,2018,8,14,Tuesday
3,16,2,18,2017,5,15,Monday
2,9,21,30,2018,6,24,Sunday
7,32,-7,25,2017,2,24,Friday
13,26,21,47,2018,1,25,Thursday
1,11,36,47,2018,6,3,Sunday
3,9,7,16,2017,9,12,Tuesday
5,6,14,20,2018,1,11,Thursday
7,14,7,21,2017,3,7,Tuesday
5,23,13,36,2017,4,13,Thursday
3,16,22,38,2017,9,23,Saturday
1,22,1,23,2017,4,18,Tuesday
1,5,7,12,2018,8,15,Wednseday
2,6,14,20,2018,4,21,Saturday
2,23,25,48,2018,4,10,Tuesday
0,8,26,34,2017,12,27,Wednseday
4,13,15,28,2017,8,3,Thursday
1,2,6,8,2018,5,9,Wednseday
6,26,-1,25,2017,6,2,Friday
4,15,9,24,2018,2,25,Sunday
3,9,18,27,2017,10,21,Saturday
1,13,9,22,2018,4,19,Thursday
5,14,8,22,2017,9,21,Thursday
4,10,19,29,2018,2,4,Sunday
0,8,12,20,2018,3,20,Tuesday
2,17,11,28,2018,3,19,Monday
3,9,25,34,2018,1,6,Saturday
1,5,16,21,2017,8,10,Thursday
12,21,5,26,2018,5,3,Thursday
3,7,18,25,2017,8,25,Friday
1,11,17,28,2018,2,8,Thursday
3,7,9,16,2017,9,11,Monday
1,30,-9,21,2018,7,10,Tuesday
0,7,31,38,2018,6,5,Tuesday
7,28,21,49,2017,11,3,Friday
1,8,19,27,2018,4,12,Thursday
6,18,13,31,2017,5,6,Saturday
2,15,21,36,2017,2,28,Tuesday
2,4,13,17,2018,4,22,Sunday
2,8,26,34,2018,1,31,Wednseday
2,24,-5,19,2017,3,15,Wednseday
7,18,22,40,2018,1,5,Friday
4,7,13,20,2018,1,26,Friday
0,12,7,19,2018,8,17,Friday
1,12,18,30,2017,7,5,Wednseday
4,11,21,32,2018,6,14,Thursday
2,6,16,22,2018,6,19,Tuesday
8,8,7,15,2017,7,18,Tuesday
6,49,-20,29,2017,11,16,Thursday
3,6,20,26,2018,8,17,Friday
1,3,12,15,2017,5,22,Monday
6,17,9,26,2018,4,27,Friday
2,4,7,11,2018,3,4,Sunday
1,5,17,22,2018,2,25,Sunday
1,23,25,48,2017,9,26,Tuesday
4,13,11,24,2017,7,15,Saturday
8,15,14,29,2017,2,26,Sunday
1,17,6,23,2018,4,4,Wednseday
2,11,12,23,2018,3,18,Sunday
4,36,-11,25,2018,2,16,Friday
2,3,21,24,2018,7,1,Sunday
3,11,11,22,2017,9,18,Monday
2,10,20,30,2018,2,17,Saturday
1,58,-25,33,2017,11,26,Sunday
1,8,17,25,2017,9,11,Monday
1,25,8,33,2017,12,17,Sunday
3,8,22,30,2018,6,18,Monday
3,7,14,21,2017,8,22,Tuesday
4,13,10,23,2017,3,18,Saturday
2,8,34,42,2018,6,5,Tuesday
2,18,7,25,2018,2,24,Saturday
2,8,17,25,2017,12,10,Sunday
3,15,8,23,2018,1,9,Tuesday
12,16,14,30,2018,3,17,Saturday
5,12,11,23,2017,11,1,Wednseday
5,18,2,20,2018,2,16,Friday
1,5,24,29,2017,4,12,Wednseday
2,3,4,7,2018,8,13,Monday
3,9,15,24,2017,4,8,Saturday
1,9,15,24,2018,1,23,Tuesday
4,13,27,40,2017,11,24,Friday
1,2,2,4,2018,7,30,Monday
4,12,22,34,2017,12,29,Friday
3,4,10,14,2017,7,17,Monday
5,6,5,11,2018,5,18,Friday
2,7,11,18,2017,11,6,Monday
2,18,13,31,2017,12,16,Saturday
1,11,11,22,2017,7,13,Thursday
2,11,21,32,2018,2,4,Sunday
5,8,-2,6,2018,8,9,Thursday
7,16,13,29,2017,10,3,Tuesday
7,22,-1,21,2017,11,29,Wednseday
1,9,10,19,2018,3,28,Wednseday
3,20,5,25,2018,4,7,Saturday
1,4,6,10,2018,7,31,Tuesday
2,8,15,23,2018,4,9,Monday
2,3,20,23,2017,12,18,Monday
2,8,16,24,2017,7,18,Tuesday
4,11,5,16,2018,4,23,Monday
3,10,22,32,2018,8,18,Saturday
1,21,7,28,2018,3,21,Wednseday
6,39,-6,33,2018,2,23,Friday
2,13,10,23,2017,6,14,Wednseday
1,3,15,18,2017,8,14,Monday
3,9,22,31,2017,2,3,Friday
2,7,14,21,2017,11,1,Wednseday
1,2,8,10,2018,6,19,Tuesday
1,4,10,14,2018,6,21,Thursday
10,13,11,24,2018,1,2,Tuesday
6,19,7,26,2017,11,11,Saturday
2,46,8,54,2018,5,27,Sunday
9,12,8,20,2018,5,12,Saturday
1,21,5,26,2018,3,7,Wednseday
3,28,-7,21,2018,5,15,Tuesday
6,12,12,24,2018,2,9,Friday
6,12,10,22,2017,7,19,Wednseday
3,11,13,24,2018,4,29,Sunday
1,4,1,5,2018,8,2,Thursday
1,10,13,23,2018,1,16,Tuesday
1,11,10,21,2017,4,4,Tuesday
5,8,11,19,2018,8,8,Wednseday
2,19,32,51,2018,6,16,Saturday
4,16,23,39,2017,10,21,Saturday
7,8,5,13,2018,2,13,Tuesday
3,18,19,37,2017,8,5,Saturday
4,5,12,17,2017,10,15,Sunday
1,4,26,30,2018,6,17,Sunday
1,8,12,20,2017,9,14,Thursday
2,26,-3,23,2018,5,7,Monday
2,8,17,25,2017,5,22,Monday
0,3,11,14,2018,1,26,Friday
1,8,18,26,2017,12,10,Sunday
2,16,10,26,2017,12,2,Saturday
1,6,31,37,2018,6,6,Wednseday
1,17,18,35,2018,4,24,Tuesday
2,5,9,14,2018,2,22,Thursday
2,13,7,20,2018,4,3,Tuesday
1,14,10,24,2017,12,26,Tuesday
0,4,4,8,2018,7,19,Thursday
1,8,15,23,2018,6,27,Wednseday
0,9,20,29,2017,12,26,Tuesday
1,6,14,20,2018,5,8,Tuesday
4,11,23,34,2017,6,1,Thursday
2,12,13,25,2018,7,12,Thursday
3,11,20,31,2018,2,3,Saturday
2,13,10,23,2017,3,4,Saturday
6,21,14,35,2018,5,15,Tuesday
8,13,6,19,2017,10,12,Thursday
8,16,10,26,2017,7,5,Wednseday
2,7,12,19,2017,10,4,Wednseday
0,4,15,19,2018,5,25,Friday
2,3,2,5,2018,7,28,Saturday
1,4,14,18,2018,8,26,Sunday
0,6,14,20,2018,7,31,Tuesday
5,10,16,26,2017,3,17,Friday
0,7,22,29,2018,6,21,Thursday
5,16,11,27,2018,4,28,Saturday
11,19,12,31,2018,7,22,Sunday
0,4,19,23,2018,4,16,Monday
2,22,4,26,2018,1,7,Sunday
0,8,23,31,2018,7,3,Tuesday
1,7,21,28,2017,8,21,Monday
4,10,15,25,2018,7,30,Monday
0,18,0,18,2018,5,18,Friday
1,19,14,33,2018,1,7,Sunday
2,10,35,45,2018,8,20,Monday
5,19,16,35,2017,12,1,Friday
6,9,18,27,2018,3,14,Wednseday
4,39,-16,23,2017,5,29,Monday
7,14,31,45,2018,4,20,Friday
5,10,28,38,2018,6,4,Monday
7,12,7,19,2018,6,29,Friday
2,11,22,33,2018,5,26,Saturday
1,5,19,24,2017,11,20,Monday
5,15,30,45,2018,2,11,Sunday
1,2,10,12,2017,5,28,Sunday
2,6,24,30,2018,5,9,Wednseday
0,3,3,6,2018,8,24,Friday
0,7,28,35,2017,10,18,Wednseday
10,22,14,36,2017,6,19,Monday
2,10,13,23,2018,5,2,Wednseday
1,9,26,35,2018,1,22,Monday
5,12,17,29,2018,6,14,Thursday
1,9,19,28,2018,4,23,Monday
2,12,9,21,2017,11,9,Thursday
3,4,13,17,2018,1,14,Sunday
21,23,13,36,2018,1,24,Wednseday
4,7,7,14,2018,8,16,Thursday
1,11,18,29,2017,8,31,Thursday
1,8,5,13,2017,5,30,Tuesday
0,15,10,25,2017,2,24,Friday
3,91,-38,53,2017,2,3,Friday
2,5,8,13,2018,2,28,Wednseday
3,22,1,23,2017,8,13,Sunday
2,22,10,32,2018,2,5,Monday
4,5,18,23,2018,2,24,Saturday
5,10,21,31,2017,7,29,Saturday
4,10,9,19,2018,1,13,Saturday
2,7,22,29,2018,1,31,Wednseday
0,3,15,18,2017,12,1,Friday
4,5,1,6,2018,7,28,Saturday
2,6,14,20,2017,6,17,Saturday
1,8,15,23,2017,4,4,Tuesday
9,50,-32,18,2018,2,26,Monday
1,6,18,24,2017,10,17,Tuesday
1,13,13,26,2018,4,26,Thursday
2,25,0,25,2018,1,27,Saturday
6,16,14,30,2018,2,10,Saturday
1,7,17,24,2018,2,13,Tuesday
5,9,14,23,2018,1,13,Saturday
2,4,13,17,2018,1,13,Saturday
3,17,8,25,2017,11,24,Friday
2,9,24,33,2017,8,12,Saturday
7,20,0,20,2017,11,3,Friday
8,12,36,48,2018,5,30,Wednseday
2,8,8,16,2018,4,11,Wednseday
14,41,21,62,2018,1,12,Friday
3,19,21,40,2018,4,27,Friday
9,10,7,17,2017,7,17,Monday
4,11,8,19,2017,12,8,Friday
1,2,17,19,2018,6,24,Sunday
2,16,5,21,2018,1,17,Wednseday
1,16,7,23,2018,2,25,Sunday
4,14,8,22,2018,7,12,Thursday
1,9,8,17,2017,11,21,Tuesday
1,4,14,18,2018,7,2,Monday
4,6,13,19,2017,3,4,Saturday
2,9,18,27,2017,8,22,Tuesday
1,8,14,22,2018,8,1,Wednseday
0,17,10,27,2018,3,7,Wednseday
2,10,7,17,2018,3,19,Monday
0,6,27,33,2018,6,28,Thursday
2,5,20,25,2018,6,3,Sunday
2,15,29,44,2017,2,5,Sunday
2,14,20,34,2017,12,20,Wednseday
2,13,22,35,2017,10,4,Wednseday
3,4,13,17,2018,4,7,Saturday
2,7,20,27,2018,6,26,Tuesday
4,9,8,17,2017,3,20,Monday
2,8,17,25,2018,7,2,Monday
1,8,7,15,2018,8,19,Sunday
1,4,11,15,2018,1,18,Thursday
1,6,14,20,2017,11,28,Tuesday
2,13,18,31,2017,10,3,Tuesday
26,40,3,43,2018,6,20,Wednseday
1,21,1,22,2017,9,18,Monday
3,15,13,28,2018,3,20,Tuesday
2,8,11,19,2017,11,5,Sunday
1,7,6,13,2017,7,20,Thursday
5,7,12,19,2017,10,18,Wednseday
2,36,-5,31,2017,7,17,Monday
4,17,7,24,2017,10,2,Monday
3,10,38,48,2018,5,4,Friday
2,3,2,5,2018,8,19,Sunday
4,8,17,25,2017,3,16,Thursday
1,16,20,36,2017,12,26,Tuesday
9,20,6,26,2017,6,28,Wednseday
2,8,9,17,2018,7,22,Sunday
1,6,14,20,2017,7,13,Thursday
2,10,3,13,2017,9,6,Wednseday
1,8,14,22,2018,3,26,Monday
4,5,8,13,2017,7,21,Friday
1,9,18,27,2018,7,5,Thursday
1,7,10,17,2017,9,5,Tuesday
2,31,-6,25,2018,1,29,Monday
2,13,17,30,2018,3,10,Saturday
5,9,13,22,2018,4,25,Wednseday
11,20,10,30,2017,7,15,Saturday
6,14,13,27,2017,7,26,Wednseday
0,2,14,16,2018,2,6,Tuesday
1,9,41,50,2018,6,3,Sunday
1,9,14,23,2018,8,6,Monday
1,3,10,13,2018,3,22,Thursday
1,16,7,23,2017,8,6,Sunday
2,8,10,18,2018,3,25,Sunday
3,7,20,27,2017,5,2,Tuesday
1,17,5,22,2017,6,27,Tuesday
3,49,-18,31,2018,3,5,Monday
5,12,17,29,2018,1,25,Thursday
3,9,13,22,2018,5,8,Tuesday
6,19,30,49,2017,2,2,Thursday
2,3,13,16,2017,11,25,Saturday
2,13,7,20,2017,11,7,Tuesday
1,3,26,29,2017,2,12,Sunday
1,9,20,29,2018,2,7,Wednseday
8,18,22,40,2018,6,7,Thursday
2,14,2,16,2018,3,13,Tuesday
5,22,-2,20,2018,3,1,Thursday
4,12,9,21,2018,4,12,Thursday
1,7,28,35,2017,4,27,Thursday
1,6,14,20,2017,8,2,Wednseday
1,4,14,18,2018,4,26,Thursday
11,31,7,38,2017,12,3,Sunday
1,20,0,20,2018,3,13,Tuesday
2,11,29,40,2017,10,1,Sunday
1,3,3,6,2018,7,31,Tuesday
6,27,-1,26,2018,1,24,Wednseday
1,14,4,18,2017,10,23,Monday
1,11,16,27,2018,3,27,Tuesday
4,8,14,22,2018,4,8,Sunday
2,18,4,22,2017,8,28,Monday
1,2,16,18,2018,6,17,Sunday
4,15,5,20,2017,10,19,Thursday
3,10,16,26,2018,7,27,Friday
0,5,18,23,2017,11,8,Wednseday
2,3,19,22,2018,2,7,Wednseday
6,13,4,17,2017,10,31,Tuesday
1,19,14,33,2018,4,19,Thursday
2,13,26,39,2018,1,27,Saturday
1,7,16,23,2017,5,24,Wednseday
2,3,23,26,2017,9,30,Saturday
1,15,17,32,2017,5,15,Monday
33,52,21,73,2018,1,6,Saturday
3,4,21,25,2018,7,20,Friday
1,6,20,26,2018,8,16,Thursday
1,7,17,24,2017,9,25,Monday
5,14,12,26,2017,7,7,Friday
1,9,11,20,2017,9,12,Tuesday
2,14,14,28,2018,1,23,Tuesday
4,26,6,32,2017,12,8,Friday
6,8,12,20,2018,3,28,Wednseday
10,20,3,23,2018,3,24,Saturday
4,10,6,16,2018,7,16,Monday
3,11,5,16,2018,8,19,Sunday
3,13,10,23,2017,11,11,Saturday
9,38,-5,33,2017,12,6,Wednseday
5,7,32,39,2017,1,26,Thursday
1,17,13,30,2017,2,19,Sunday
2,3,2,5,2018,8,18,Saturday
2,3,7,10,2018,6,18,Monday
1,33,-5,28,2017,12,27,Wednseday
1,10,16,26,2018,4,22,Sunday
7,13,5,18,2018,8,2,Thursday
1,14,14,28,2017,2,10,Friday
6,22,12,34,2017,7,13,Thursday
1,4,17,21,2017,4,4,Tuesday
24,26,7,33,2017,11,25,Saturday
1,2,7,9,2018,6,12,Tuesday
2,17,24,41,2017,11,4,Saturday
1,7,18,25,2018,4,26,Thursday
1,39,-8,31,2017,10,9,Monday
2,6,18,24,2018,4,15,Sunday
1,7,13,20,2017,10,17,Tuesday
3,13,14,27,2018,3,14,Wednseday
4,8,14,22,2018,5,3,Thursday
5,13,8,21,2018,5,4,Friday
1,15,16,31,2017,7,16,Sunday
3,4,13,17,2017,11,4,Saturday
6,18,8,26,2017,11,18,Saturday
1,10,14,24,2017,12,19,Tuesday
3,9,14,23,2017,3,5,Sunday
7,10,2,12,2018,3,9,Friday
2,8,13,21,2017,3,6,Monday
3,10,14,24,2017,10,17,Tuesday
1,26,-3,23,2018,5,14,Monday
0,8,13,21,2017,3,6,Monday
2,4,7,11,2017,9,4,Monday
1,10,13,23,2017,3,7,Tuesday
4,12,24,36,2017,3,19,Sunday
5,22,5,27,2018,4,27,Friday
4,17,12,29,2018,1,22,Monday
3,20,-1,19,2018,3,3,Saturday
2,17,11,28,2017,12,12,Tuesday
2,24,-7,17,2018,3,4,Sunday
0,8,12,20,2018,8,7,Tuesday
7,16,12,28,2017,11,28,Tuesday
4,6,15,21,2018,6,29,Friday
1,6,21,27,2017,11,7,Tuesday
1,13,14,27,2017,8,15,Tuesday
4,45,-23,22,2018,3,19,Monday
6,13,22,35,2017,11,24,Friday
4,19,12,31,2017,12,22,Friday
1,5,27,32,2017,5,8,Monday
3,6,14,20,2018,7,27,Friday
1,12,10,22,2018,6,7,Thursday
8,15,23,38,2017,1,24,Tuesday
1,2,13,15,2018,7,4,Wednseday
5,14,26,40,2017,1,25,Wednseday
1,13,17,30,2017,5,3,Wednseday
2,15,5,20,2018,2,27,Tuesday
2,13,18,31,2018,2,3,Saturday
4,13,7,20,2017,9,2,Saturday
1,20,8,28,2017,6,22,Thursday
2,5,20,25,2018,6,30,Saturday
0,14,8,22,2018,7,24,Tuesday
2,43,-21,22,2018,3,19,Monday
1,2,13,15,2017,11,27,Monday
9,12,41,53,2016,10,6,Thursday
2,37,3,40,2017,5,17,Wednseday
1,6,30,36,2018,6,5,Tuesday
5,20,10,30,2018,2,10,Saturday
7,25,0,25,2017,11,24,Friday
3,25,0,25,2017,11,3,Friday
2,8,7,15,2018,8,20,Monday
3,18,5,23,2017,4,22,Saturday
0,7,14,21,2018,6,12,Tuesday
18,34,-2,32,2017,4,7,Friday
4,11,14,25,2017,9,22,Friday
2,9,11,20,2017,10,14,Saturday
3,16,14,30,2018,3,31,Saturday
1,19,9,28,2018,4,25,Wednseday
4,14,13,27,2018,2,2,Friday
4,11,11,22,2018,5,7,Monday
1,3,12,15,2017,7,25,Tuesday
2,8,13,21,2018,7,23,Monday
9,15,15,30,2017,3,19,Sunday
4,4,16,20,2018,3,23,Friday
2,12,1,13,2017,5,17,Wednseday
2,3,4,7,2018,7,31,Tuesday
3,32,-1,31,2017,12,4,Monday
2,3,14,17,2018,6,9,Saturday
8,10,0,10,2018,5,8,Tuesday
4,7,19,26,2017,8,24,Thursday
4,9,21,30,2017,5,6,Saturday
2,9,12,21,2017,11,1,Wednseday
1,3,11,14,2018,2,20,Tuesday
2,5,11,16,2018,4,28,Saturday
3,8,15,23,2017,8,16,Wednseday
1,7,17,24,2017,10,24,Tuesday
2,14,8,22,2017,11,28,Tuesday
1,7,8,15,2018,4,4,Wednseday
2,16,1,17,2018,3,20,Tuesday
11,23,3,26,2018,2,9,Friday
1,11,13,24,2018,4,23,Monday
3,16,2,18,2017,11,27,Monday
1,4,13,17,2017,8,28,Monday
1,8,5,13,2017,11,16,Thursday
0,7,18,25,2017,7,3,Monday
4,7,16,23,2018,3,24,Saturday
1,5,26,31,2018,5,28,Monday
1,2,6,8,2018,7,11,Wednseday
2,7,8,15,2018,7,18,Wednseday
6,15,8,23,2018,8,1,Wednseday
11,12,5,17,2017,11,24,Friday
5,13,19,32,2017,9,14,Thursday
2,9,14,23,2017,6,25,Sunday
1,10,12,22,2018,1,29,Monday
1,13,14,27,2018,3,15,Thursday
1,6,15,21,2018,6,26,Tuesday
1,22,-3,19,2018,3,28,Wednseday
2,16,15,31,2018,1,23,Tuesday
3,5,7,12,2018,8,4,Saturday
5,20,0,20,2017,11,24,Friday
7,17,11,28,2018,2,9,Friday
5,6,7,13,2018,4,28,Saturday
5,12,14,26,2017,7,20,Thursday
0,4,4,8,2018,8,14,Tuesday
0,27,6,33,2017,11,30,Thursday
5,14,13,27,2017,12,30,Saturday
3,31,-5,26,2018,2,11,Sunday
6,9,14,23,2017,6,10,Saturday
1,5,32,37,2018,6,13,Wednseday
1,7,12,19,2018,3,22,Thursday
2,16,16,32,2017,4,23,Sunday
1,10,16,26,2018,4,29,Sunday
3,8,10,18,2017,10,6,Friday
0,15,15,30,2018,3,27,Tuesday
1,10,27,37,2017,1,16,Monday
2,30,5,35,2018,1,10,Wednseday
1,6,15,21,2017,11,2,Thursday
2,6,23,29,2018,4,10,Tuesday
3,10,28,38,2018,4,7,Saturday
7,21,4,25,2017,11,16,Thursday
2,8,14,22,2017,7,25,Tuesday
5,17,21,38,2017,12,1,Friday
0,11,21,32,2018,2,8,Thursday
1,9,19,28,2018,1,2,Tuesday
38,53,-28,25,2017,11,27,Monday
1,13,2,15,2018,5,8,Tuesday
3,9,12,21,2018,6,12,Tuesday
1,26,0,26,2018,3,1,Thursday
2,4,10,14,2018,3,19,Monday
3,9,13,22,2017,3,5,Sunday
4,29,-4,25,2017,8,17,Thursday
5,13,15,28,2017,10,25,Wednseday
1,21,-1,20,2018,2,22,Thursday
5,20,7,27,2017,8,16,Wednseday
4,12,12,24,2017,10,13,Friday
2,15,16,31,2017,12,5,Tuesday
4,19,5,24,2017,11,18,Saturday
1,8,12,20,2017,3,23,Thursday
1,7,15,22,2017,6,20,Tuesday
2,32,-2,30,2018,2,4,Sunday
16,23,13,36,2018,3,19,Monday
1,2,8,10,2018,8,21,Tuesday
5,9,16,25,2017,9,23,Saturday
14,33,34,67,2016,10,7,Friday
7,19,23,42,2017,9,22,Friday
6,21,13,34,2018,3,6,Tuesday
5,8,10,18,2017,9,30,Saturday
7,15,18,33,2018,2,7,Wednseday
2,11,13,24,2018,2,25,Sunday
2,3,11,14,2018,2,27,Tuesday
3,4,30,34,2018,6,16,Saturday
0,1,13,14,2017,10,26,Thursday
4,5,20,25,2018,6,3,Sunday
5,24,22,46,2018,5,31,Thursday
5,7,6,13,2018,6,13,Wednseday
5,9,11,20,2018,7,28,Saturday
1,9,12,21,2017,11,20,Monday
1,5,14,19,2018,8,16,Thursday
2,16,11,27,2017,6,3,Saturday
3,14,19,33,2018,1,21,Sunday
6,20,8,28,2017,7,11,Tuesday
12,14,11,25,2017,11,24,Friday
1,13,8,21,2017,9,5,Tuesday
1,10,21,31,2018,4,8,Sunday
2,12,21,33,2017,5,3,Wednseday
3,6,20,26,2018,6,15,Friday
1,14,2,16,2017,11,28,Tuesday
4,24,8,32,2017,12,16,Saturday
2,12,11,23,2018,3,14,Wednseday
1,8,12,20,2017,6,22,Thursday
1,4,21,25,2018,6,3,Sunday
2,4,14,18,2017,8,14,Monday
2,3,4,7,2018,8,7,Tuesday
2,15,15,30,2018,2,7,Wednseday
1,8,24,32,2017,10,12,Thursday
0,6,28,34,2018,6,28,Thursday
5,9,12,21,2018,1,10,Wednseday
1,47,-21,26,2018,2,21,Wednseday
3,7,13,20,2017,8,4,Friday
1,5,15,20,2017,8,31,Thursday
1,5,17,22,2017,10,19,Thursday
1,24,5,29,2018,1,9,Tuesday
1,16,6,22,2018,3,26,Monday
2,10,28,38,2017,10,1,Sunday
13,16,20,36,2017,2,22,Wednseday
9,25,12,37,2018,6,6,Wednseday
5,39,-5,34,2017,4,13,Thursday
23,30,2,32,2017,8,21,Monday
1,5,18,23,2018,5,13,Sunday
1,5,9,14,2018,7,25,Wednseday
14,21,0,21,2017,6,12,Monday
4,10,18,28,2018,6,29,Friday
1,9,20,29,2018,6,25,Monday
2,7,15,22,2017,9,26,Tuesday
2,7,10,17,2018,3,20,Tuesday
9,52,-21,31,2018,1,20,Saturday
1,7,15,22,2018,3,27,Tuesday
0,1,6,7,2018,8,21,Tuesday
1,3,10,13,2018,7,17,Tuesday
2,8,21,29,2018,1,8,Monday
2,6,13,19,2018,4,18,Wednseday
0,35,15,50,2018,6,5,Tuesday
1,4,11,15,2018,7,23,Monday
4,7,6,13,2017,7,27,Thursday
1,4,8,12,2018,3,1,Thursday
5,33,-11,22,2018,4,5,Thursday
5,12,9,21,2017,9,14,Thursday
4,53,-33,20,2017,11,23,Thursday
4,16,1,17,2018,7,23,Monday
1,11,14,25,2017,6,8,Thursday
2,5,7,12,2018,8,4,Saturday
4,18,17,35,2017,5,26,Friday
5,18,9,27,2017,12,23,Saturday
0,9,18,27,2018,4,25,Wednseday
1,13,14,27,2017,2,7,Tuesday
11,11,11,22,2017,11,26,Sunday
3,10,8,18,2017,11,6,Monday
6,8,4,12,2018,7,18,Wednseday
7,27,-5,22,2018,2,13,Tuesday
2,7,7,14,2017,11,14,Tuesday
1,11,18,29,2018,6,25,Monday
1,6,13,19,2018,4,25,Wednseday
16,39,-19,20,2017,11,14,Tuesday
3,9,20,29,2017,12,4,Monday
0,3,15,18,2018,5,14,Monday
1,6,17,23,2017,5,30,Tuesday
4,11,14,25,2017,6,18,Sunday
0,34,-8,26,2017,11,30,Thursday
19,13,42,55,2016,10,7,Friday
2,4,42,46,2017,12,18,Monday
1,11,11,22,2017,11,13,Monday
4,9,11,20,2017,6,17,Saturday
2,8,16,24,2017,8,8,Tuesday
9,23,21,44,2018,1,24,Wednseday
1,14,26,40,2017,12,14,Thursday
0,4,27,31,2017,12,15,Friday
1,11,18,29,2017,10,12,Thursday
2,11,8,19,2018,8,18,Saturday
11,15,-3,12,2017,5,7,Sunday
0,17,14,31,2018,2,20,Tuesday
4,15,10,25,2017,8,28,Monday
4,21,5,26,2018,3,9,Friday
5,7,7,14,2018,2,26,Monday
33,38,-11,27,2017,2,10,Friday
4,7,28,35,2018,6,29,Friday
2,10,21,31,2017,12,11,Monday
18,22,21,43,2018,2,13,Tuesday
2,7,10,17,2018,7,14,Saturday
4,12,14,26,2017,9,28,Thursday
1,7,25,32,2017,10,9,Monday
3,8,22,30,2017,12,3,Sunday
4,50,-18,32,2018,3,25,Sunday
8,15,17,32,2018,1,15,Monday
0,13,7,20,2017,7,21,Friday
3,6,14,20,2017,11,24,Friday
15,18,5,23,2017,10,9,Monday
4,19,6,25,2017,10,27,Friday
0,6,16,22,2017,11,16,Thursday
1,12,9,21,2018,3,8,Thursday
2,8,9,17,2017,4,24,Monday
4,6,6,12,2018,5,5,Saturday
6,11,13,24,2017,9,22,Friday
1,11,25,36,2018,5,28,Monday
3,11,12,23,2018,3,24,Saturday
9,11,11,22,2018,2,13,Tuesday
7,23,13,36,2018,1,1,Monday
1,15,18,33,2018,2,7,Wednseday
1,9,24,33,2017,12,27,Wednseday
1,2,14,16,2017,11,29,Wednseday
3,5,7,12,2017,11,1,Wednseday
4,7,13,20,2018,8,10,Friday
0,6,37,43,2017,9,27,Wednseday
3,12,15,27,2017,7,29,Saturday
2,7,21,28,2017,5,23,Tuesday
1,21,2,23,2018,1,16,Tuesday
1,13,8,21,2017,10,31,Tuesday
6,16,19,35,2018,1,10,Wednseday
1,14,9,23,2018,1,9,Tuesday
4,16,9,25,2018,1,20,Saturday
0,7,9,16,2018,7,18,Wednseday
1,2,5,7,2018,8,27,Monday
1,8,8,16,2017,9,13,Wednseday
6,14,16,30,2018,7,24,Tuesday
2,23,0,23,2017,11,27,Monday
1,3,5,8,2018,5,9,Wednseday
2,23,3,26,2017,11,26,Sunday
24,25,-3,22,2018,1,2,Tuesday
4,10,16,26,2018,8,11,Saturday
3,9,12,21,2017,4,3,Monday
7,27,12,39,2018,7,5,Thursday
7,7,28,35,2017,2,10,Friday
2,8,14,22,2017,5,23,Tuesday
6,13,29,42,2017,6,14,Wednseday
3,31,8,39,2017,3,17,Friday
1,26,-5,21,2018,3,21,Wednseday
2,14,4,18,2018,2,3,Saturday
1,7,36,43,2018,3,26,Monday
1,8,11,19,2018,7,18,Wednseday
2,40,-22,18,2018,3,26,Monday
4,13,25,38,2018,3,2,Friday
18,32,6,38,2017,4,21,Friday
3,6,11,17,2018,5,12,Saturday
5,20,13,33,2018,2,21,Wednseday
3,42,-21,21,2017,11,28,Tuesday
6,28,11,39,2017,12,21,Thursday
2,10,17,27,2017,8,12,Saturday
2,3,9,12,2018,4,7,Saturday
2,4,20,24,2018,2,12,Monday
2,18,8,26,2017,6,24,Saturday
3,14,7,21,2018,3,12,Monday
1,6,47,53,2018,6,21,Thursday
2,4,11,15,2018,1,11,Thursday
1,3,18,21,2017,11,27,Monday
0,18,-1,17,2017,11,21,Tuesday
1,6,4,10,2018,8,21,Tuesday
1,15,-1,14,2018,2,27,Tuesday
6,11,9,20,2017,10,14,Saturday
2,9,27,36,2018,6,12,Tuesday
2,4,22,26,2018,6,2,Saturday
1,7,13,20,2017,7,13,Thursday
1,2,11,13,2017,8,30,Wednseday
4,14,7,21,2017,7,3,Monday
4,21,14,35,2018,1,15,Monday
3,11,10,21,2017,9,12,Tuesday
2,12,20,32,2017,12,17,Sunday
9,17,4,21,2017,11,27,Monday
1,9,17,26,2018,7,18,Wednseday
1,15,8,23,2018,4,4,Wednseday
6,20,3,23,2018,7,10,Tuesday
1,16,8,24,2018,2,27,Tuesday
2,15,9,24,2018,3,25,Sunday
2,8,9,17,2017,10,17,Tuesday
10,24,12,36,2017,4,18,Tuesday
5,12,17,29,2017,6,28,Wednseday
1,16,7,23,2017,11,21,Tuesday
1,12,12,24,2018,7,15,Sunday
2,23,2,25,2017,6,17,Saturday
3,7,9,16,2018,4,10,Tuesday
2,4,2,6,2018,8,18,Saturday
2,12,24,36,2018,6,10,Sunday
0,26,1,27,2018,2,16,Friday
0,3,21,24,2018,3,12,Monday
3,5,10,15,2018,2,11,Sunday
2,10,20,30,2018,7,16,Monday
3,15,6,21,2018,5,8,Tuesday
0,11,15,26,2018,2,16,Friday
5,17,3,20,2018,3,16,Friday
4,17,11,28,2017,12,1,Friday
8,16,11,27,2018,4,18,Wednseday
2,23,9,32,2017,11,26,Sunday
1,11,15,26,2018,3,25,Sunday
13,22,17,39,2018,2,1,Thursday
20,22,-9,13,2018,5,2,Wednseday
3,15,9,24,2017,8,1,Tuesday
2,8,13,21,2017,6,5,Monday
5,27,2,29,2018,1,24,Wednseday
1,15,22,37,2018,2,27,Tuesday
1,16,13,29,2018,2,6,Tuesday
5,6,-1,5,2018,8,15,Wednseday
1,14,16,30,2017,8,7,Monday
2,5,4,9,2018,7,25,Wednseday
6,7,6,13,2018,5,4,Friday
1,9,5,14,2018,8,7,Tuesday
4,12,20,32,2017,10,12,Thursday
3,14,21,35,2017,12,8,Friday
2,7,36,43,2018,6,4,Monday
4,49,-10,39,2018,3,26,Monday
1,7,35,42,2018,6,4,Monday
3,13,11,24,2018,7,10,Tuesday
2,10,15,25,2018,2,5,Monday
3,23,3,26,2017,11,26,Sunday
6,8,21,29,2018,1,9,Tuesday
2,4,7,11,2018,8,19,Sunday
1,8,11,19,2018,7,19,Thursday
2,10,13,23,2017,7,9,Sunday
2,6,14,20,2018,6,9,Saturday
0,9,9,18,2017,7,31,Monday
4,10,27,37,2017,5,27,Saturday
4,13,7,20,2017,9,14,Thursday
1,16,1,17,2017,10,31,Tuesday
1,2,14,16,2018,4,9,Monday
21,29,-7,22,2018,3,12,Monday
4,5,20,25,2017,10,27,Friday
5,12,11,23,2018,1,10,Wednseday
5,31,-2,29,2018,2,11,Sunday
13,25,14,39,2018,5,11,Friday
3,36,-8,28,2017,11,14,Tuesday
2,8,13,21,2018,8,21,Tuesday
1,2,14,16,2018,1,30,Tuesday
2,8,7,15,2018,8,19,Sunday
2,8,13,21,2018,8,20,Monday
1,5,11,16,2018,5,9,Wednseday
1,8,17,25,2018,1,14,Sunday
2,10,19,29,2018,2,5,Monday
9,10,12,22,2018,6,11,Monday
2,8,27,35,2017,1,31,Tuesday
1,5,15,20,2018,7,18,Wednseday
6,13,21,34,2017,12,5,Tuesday
2,4,20,24,2018,6,23,Saturday
2,13,40,53,2018,8,4,Saturday
4,10,9,19,2018,1,11,Thursday
3,9,13,22,2017,8,7,Monday
41,84,-60,24,2017,11,24,Friday
0,27,-1,26,2018,3,29,Thursday
5,20,8,28,2017,9,28,Thursday
3,5,17,22,2018,2,4,Sunday
2,10,17,27,2017,11,4,Saturday
2,7,21,28,2017,11,1,Wednseday
2,13,12,25,2018,2,15,Thursday
3,10,7,17,2017,10,17,Tuesday
1,12,17,29,2018,6,24,Sunday
7,24,1,25,2017,12,11,Monday
2,8,14,22,2017,11,12,Sunday
2,9,15,24,2018,5,1,Tuesday
2,3,21,24,2018,6,4,Monday
4,6,14,20,2017,5,25,Thursday
1,22,17,39,2018,1,1,Monday
1,9,8,17,2018,1,28,Sunday
0,8,15,23,2017,10,3,Tuesday
3,13,18,31,2018,5,4,Friday
4,17,7,24,2017,11,6,Monday
1,6,21,27,2017,5,25,Thursday
13,19,7,26,2017,11,25,Saturday
3,12,29,41,2018,6,1,Friday
11,29,-7,22,2017,11,28,Tuesday
14,19,9,28,2017,3,1,Wednseday
1,14,18,32,2018,5,24,Thursday
2,8,14,22,2018,7,23,Monday
2,6,14,20,2017,7,18,Tuesday
4,31,2,33,2017,10,20,Friday
3,7,30,37,2017,8,26,Saturday
1,49,-19,30,2018,2,27,Tuesday
1,21,11,32,2017,7,10,Monday
2,3,9,12,2017,10,14,Saturday
2,13,10,23,2018,5,22,Tuesday
3,12,13,25,2017,11,11,Saturday
2,7,20,27,2017,9,19,Tuesday
4,11,15,26,2017,12,9,Saturday
1,15,13,28,2018,5,7,Monday
1,8,39,47,2017,1,29,Sunday
8,20,3,23,2017,9,5,Tuesday
0,32,0,32,2018,6,21,Thursday
2,7,23,30,2018,2,20,Tuesday
5,13,13,26,2017,11,1,Wednseday
3,11,14,25,2017,8,28,Monday
12,16,17,33,2018,5,23,Wednseday
1,4,11,15,2017,7,17,Monday
1,8,8,16,2017,11,21,Tuesday
5,19,15,34,2017,11,23,Thursday
0,11,17,28,2018,7,13,Friday
1,22,-6,16,2018,3,12,Monday
1,7,27,34,2017,3,22,Wednseday
1,12,21,33,2017,1,26,Thursday
14,26,6,32,2017,11,24,Friday
2,6,18,24,2018,1,9,Tuesday
4,9,4,13,2017,7,8,Saturday
1,8,13,21,2018,7,26,Thursday
8,16,3,19,2017,4,26,Wednseday
1,21,0,21,2017,11,28,Tuesday
1,4,13,17,2018,7,23,Monday
4,12,5,17,2018,8,10,Friday
6,11,10,21,2018,4,5,Thursday
3,6,20,26,2018,4,20,Friday
3,4,14,18,2017,10,21,Saturday
3,27,-1,26,2018,2,17,Saturday
1,4,6,10,2018,8,14,Tuesday
1,7,15,22,2017,7,17,Monday
3,7,-2,5,2018,8,3,Friday
3,8,12,20,2018,2,16,Friday
2,13,3,16,2018,5,22,Tuesday
2,5,11,16,2017,9,13,Wednseday
1,3,12,15,2017,9,5,Tuesday
1,10,15,25,2017,6,12,Monday
4,16,18,34,2017,12,5,Tuesday
15,18,11,29,2017,3,20,Monday
0,13,17,30,2017,12,13,Wednseday
3,6,8,14,2017,9,5,Tuesday
2,18,10,28,2018,1,11,Thursday
1,14,7,21,2017,3,2,Thursday
1,11,11,22,2017,5,18,Thursday
4,17,25,42,2018,1,29,Monday
3,17,11,28,2017,6,27,Tuesday
1,15,13,28,2017,12,12,Tuesday
2,11,15,26,2017,7,15,Saturday
2,12,12,24,2017,12,11,Monday
2,10,18,28,2018,4,9,Monday
4,42,-18,24,2017,10,16,Monday
2,6,19,25,2017,10,28,Saturday
13,19,15,34,2018,7,20,Friday
3,7,5,12,2018,8,10,Friday
1,19,18,37,2017,8,30,Wednseday
4,7,25,32,2017,12,29,Friday
1,2,3,5,2018,8,22,Wednseday
1,5,-2,3,2018,8,7,Tuesday
1,7,17,24,2017,7,4,Tuesday
2,9,32,41,2018,6,6,Wednseday
0,11,7,18,2017,5,12,Friday
3,7,21,28,2018,6,29,Friday
1,12,10,22,2018,8,15,Wednseday
5,12,12,24,2017,11,24,Friday
2,5,19,24,2018,3,24,Saturday
23,23,0,23,2017,6,5,Monday
3,11,21,32,2017,11,3,Friday
1,3,20,23,2017,4,9,Sunday
1,5,9,14,2018,7,30,Monday
4,32,-9,23,2018,3,5,Monday
1,3,11,14,2017,11,13,Monday
0,13,13,26,2017,11,30,Thursday
2,21,1,22,2017,11,27,Monday
4,10,26,36,2017,2,5,Sunday
2,7,18,25,2018,6,16,Saturday
6,11,22,33,2018,6,15,Friday
2,22,1,23,2018,2,28,Wednseday
2,6,25,31,2017,9,30,Saturday
3,10,8,18,2018,7,28,Saturday
1,23,6,29,2018,1,31,Wednseday
1,12,11,23,2017,6,7,Wednseday
1,2,22,24,2018,6,5,Tuesday
5,13,18,31,2017,7,29,Saturday
3,6,19,25,2018,6,1,Friday
6,34,-10,24,2017,8,8,Tuesday
3,14,17,31,2017,5,29,Monday
8,9,5,14,2018,5,21,Monday
1,7,10,17,2017,9,12,Tuesday
2,72,-42,30,2017,3,20,Monday
2,27,-11,16,2018,3,13,Tuesday
2,3,19,22,2018,2,20,Tuesday
1,6,10,16,2018,5,9,Wednseday
4,27,8,35,2017,12,15,Friday
2,7,18,25,2017,5,22,Monday
1,10,14,24,2018,2,5,Monday
1,9,19,28,2017,5,8,Monday
7,10,12,22,2017,8,29,Tuesday
0,5,9,14,2018,5,16,Wednseday
2,37,-10,27,2018,3,10,Saturday
2,5,13,18,2018,3,18,Sunday
6,13,12,25,2018,7,19,Thursday
1,29,5,34,2017,12,27,Wednseday
2,19,18,37,2018,1,3,Wednseday
25,33,-3,30,2018,3,10,Saturday
1,9,18,27,2017,5,24,Wednseday
5,8,8,16,2018,7,25,Wednseday
8,31,-8,23,2017,11,28,Tuesday
4,11,17,28,2018,1,19,Friday
1,8,13,21,2018,7,26,Thursday
1,11,-5,6,2018,8,16,Thursday
7,14,9,23,2018,4,18,Wednseday
4,18,10,28,2017,11,30,Thursday
2,17,3,20,2017,12,19,Tuesday
1,13,10,23,2017,10,22,Sunday
4,14,17,31,2018,2,12,Monday
6,43,-28,15,2017,8,1,Tuesday
3,16,15,31,2017,5,1,Monday
2,18,12,30,2018,3,11,Sunday
2,21,6,27,2018,4,5,Thursday
3,4,12,16,2018,2,24,Saturday
1,13,19,32,2018,6,14,Thursday
15,23,10,33,2017,2,9,Thursday
4,12,13,25,2018,1,4,Thursday
1,18,12,30,2017,12,10,Sunday
1,6,15,21,2018,1,16,Tuesday
0,1,9,10,2018,6,25,Monday
1,25,-1,24,2017,6,19,Monday
2,5,8,13,2017,8,16,Wednseday
18,19,12,31,2018,7,22,Sunday
6,23,6,29,2017,11,14,Tuesday
7,12,13,25,2018,1,11,Thursday
1,30,-7,23,2018,1,22,Monday
1,5,22,27,2018,6,6,Wednseday
4,12,7,19,2017,8,31,Thursday
13,23,27,50,2018,2,7,Wednseday
1,4,11,15,2018,1,25,Thursday
1,7,21,28,2017,4,11,Tuesday
2,12,28,40,2018,6,6,Wednseday
10,11,10,21,2017,10,9,Monday
1,22,-3,19,2017,11,26,Sunday
3,13,17,30,2018,1,20,Saturday
3,10,23,33,2018,6,23,Saturday
7,16,8,24,2017,11,20,Monday
3,12,14,26,2018,6,30,Saturday
3,14,9,23,2018,3,5,Monday
5,12,20,32,2017,8,18,Friday
1,13,8,21,2017,6,15,Thursday
2,4,9,13,2018,3,24,Saturday
1,6,8,14,2018,7,27,Friday
4,12,16,28,2017,4,28,Friday
8,146,-119,27,2017,4,26,Wednseday
0,6,28,34,2018,2,2,Friday
5,29,14,43,2018,1,3,Wednseday
10,13,14,27,2017,10,3,Tuesday
5,9,7,16,2018,8,8,Wednseday
2,26,-1,25,2017,4,22,Saturday
1,17,20,37,2017,12,27,Wednseday
2,27,10,37,2017,2,7,Tuesday
3,4,14,18,2017,5,19,Friday
3,9,11,20,2017,10,10,Tuesday
1,8,21,29,2018,1,2,Tuesday
7,20,11,31,2017,12,15,Friday
7,15,7,22,2017,8,10,Thursday
7,23,-5,18,2017,11,27,Monday
2,5,7,12,2017,11,19,Sunday
1,11,2,13,2017,8,17,Thursday
0,8,14,22,2018,7,19,Thursday
11,15,2,17,2017,10,9,Monday
3,12,18,30,2018,1,7,Sunday
2,3,10,13,2017,8,2,Wednseday
1,2,6,8,2018,8,13,Monday
1,10,10,20,2017,11,28,Tuesday
7,11,13,24,2017,12,11,Monday
1,9,12,21,2018,3,7,Wednseday
6,8,5,13,2017,8,30,Wednseday
1,4,14,18,2017,11,20,Monday
4,6,7,13,2018,7,6,Friday
2,20,14,34,2018,1,20,Saturday
1,19,-1,18,2017,9,28,Thursday
2,10,13,23,2017,11,11,Saturday
6,9,11,20,2017,11,24,Friday
1,5,10,15,2018,4,19,Thursday
9,28,1,29,2018,3,5,Monday
5,7,18,25,2017,8,25,Friday
10,12,21,33,2018,6,16,Saturday
1,20,1,21,2017,3,21,Tuesday
2,8,12,20,2018,8,15,Wednseday
1,2,15,17,2018,5,15,Tuesday
2,9,9,18,2018,4,5,Thursday
3,10,15,25,2018,1,26,Friday
3,20,20,40,2018,3,16,Friday
4,10,17,27,2018,7,14,Saturday
3,9,16,25,2017,6,10,Saturday
0,10,14,24,2017,12,11,Monday
1,7,10,17,2018,5,8,Tuesday
3,5,21,26,2017,3,25,Saturday
5,10,14,24,2018,2,9,Friday
6,16,6,22,2017,10,18,Wednseday
1,13,20,33,2017,2,22,Wednseday
4,41,-20,21,2018,3,6,Tuesday
4,14,15,29,2018,2,1,Thursday
5,9,7,16,2017,11,11,Saturday
2,9,23,32,2018,7,22,Sunday
5,19,4,23,2018,5,16,Wednseday
1,12,21,33,2018,6,14,Thursday
3,58,-21,37,2017,12,9,Saturday
5,10,2,12,2017,7,16,Sunday
6,15,12,27,2017,11,2,Thursday
4,14,14,28,2017,6,23,Friday
2,6,16,22,2018,4,24,Tuesday
1,16,21,37,2017,2,14,Tuesday
0,10,21,31,2018,1,26,Friday
0,9,26,35,2018,6,12,Tuesday
2,19,13,32,2017,5,1,Monday
5,14,20,34,2017,2,17,Friday
2,12,10,22,2017,7,26,Wednseday
5,20,14,34,2017,6,23,Friday
1,8,20,28,2017,1,25,Wednseday
10,22,9,31,2017,12,31,Sunday
3,64,-41,23,2018,2,12,Monday
3,24,1,25,2017,9,15,Friday
8,14,1,15,2018,5,22,Tuesday
5,54,-19,35,2018,3,15,Thursday
2,36,-8,28,2018,3,6,Tuesday
3,10,15,25,2017,12,4,Monday
2,8,12,20,2017,8,15,Tuesday
5,7,7,14,2018,2,19,Monday
4,5,11,16,2018,6,17,Sunday
15,29,5,34,2017,5,18,Thursday
2,4,13,17,2018,8,13,Monday
7,12,8,20,2017,5,19,Friday
4,11,17,28,2017,12,7,Thursday
2,10,14,24,2017,6,17,Saturday
1,14,9,23,2017,10,24,Tuesday
1,15,12,27,2017,9,28,Thursday
3,25,22,47,2018,7,27,Friday
2,21,15,36,2017,12,17,Sunday
2,3,9,12,2017,10,22,Sunday
4,14,6,20,2018,2,23,Friday
1,3,10,13,2018,5,9,Wednseday
2,7,15,22,2017,6,27,Tuesday
3,14,13,27,2018,1,19,Friday
6,14,2,16,2018,8,14,Tuesday
1,14,17,31,2017,10,23,Monday
5,12,17,29,2018,4,8,Sunday
1,6,4,10,2018,7,31,Tuesday
4,46,-20,26,2018,3,3,Saturday
3,23,8,31,2018,5,12,Saturday
17,23,8,31,2017,11,25,Saturday
12,13,1,14,2018,4,20,Friday
2,8,22,30,2018,6,26,Tuesday
1,7,19,26,2017,11,9,Thursday
2,6,10,16,2018,8,1,Wednseday
1,3,14,17,2018,7,23,Monday
18,34,-8,26,2017,11,24,Friday
5,12,12,24,2017,11,5,Sunday
3,11,10,21,2017,11,24,Friday
1,4,10,14,2018,7,26,Thursday
1,8,14,22,2018,7,2,Monday
1,24,29,53,2018,5,27,Sunday
0,4,37,41,2018,6,26,Tuesday
3,6,14,20,2018,7,14,Saturday
1,3,9,12,2018,7,25,Wednseday
3,6,24,30,2018,6,16,Saturday
1,18,2,20,2018,3,6,Tuesday
5,13,13,26,2018,3,22,Thursday
3,20,11,31,2018,2,3,Saturday
2,7,19,26,2017,7,19,Wednseday
1,13,15,28,2017,7,12,Wednseday
3,14,12,26,2017,9,15,Friday
3,7,8,15,2018,4,23,Monday
5,15,7,22,2018,8,2,Thursday
2,4,22,26,2018,6,2,Saturday
1,10,14,24,2018,6,10,Sunday
3,8,8,16,2018,3,11,Sunday
6,12,21,33,2018,3,8,Thursday
2,5,7,12,2018,4,11,Wednseday
2,10,20,30,2017,11,18,Saturday
3,11,13,24,2017,9,10,Sunday
3,21,3,24,2017,8,1,Tuesday
2,7,9,16,2017,10,16,Monday
4,27,21,48,2017,12,14,Thursday
1,2,33,35,2017,8,7,Monday
1,6,21,27,2017,5,24,Wednseday
1,6,13,19,2017,10,18,Wednseday
2,10,23,33,2018,5,27,Sunday
1,3,10,13,2017,10,24,Tuesday
2,43,-18,25,2017,11,27,Monday
2,7,9,16,2018,4,10,Tuesday
0,7,18,25,2017,5,25,Thursday
9,15,6,21,2017,3,7,Tuesday
2,9,18,27,2017,5,27,Saturday
6,51,-22,29,2018,2,22,Thursday
4,11,6,17,2018,5,11,Friday
2,19,8,27,2018,3,17,Saturday
0,7,10,17,2017,6,9,Friday
1,24,-6,18,2018,2,26,Monday
1,7,12,19,2018,5,2,Wednseday
3,13,21,34,2018,1,16,Tuesday
8,11,1,12,2018,3,16,Friday
3,11,14,25,2017,9,30,Saturday
1,7,7,14,2018,7,16,Monday
3,19,-1,18,2018,5,18,Friday
1,2,8,10,2018,4,3,Tuesday
1,19,7,26,2017,11,23,Thursday
1,18,14,32,2018,2,18,Sunday
11,14,5,19,2018,8,9,Thursday
13,19,29,48,2018,3,7,Wednseday
5,12,8,20,2017,11,16,Thursday
1,8,20,28,2018,7,23,Monday
5,12,19,31,2018,4,29,Sunday
1,3,8,11,2018,3,26,Monday
1,10,19,29,2017,6,26,Monday
4,46,-13,33,2017,6,8,Thursday
6,8,9,17,2018,4,27,Friday
3,9,21,30,2018,6,24,Sunday
1,21,-1,20,2018,2,21,Wednseday
1,18,10,28,2018,4,12,Thursday
1,2,8,10,2018,6,19,Tuesday
2,3,21,24,2018,6,4,Monday
4,10,8,18,2017,9,8,Friday
1,2,11,13,2017,8,10,Thursday
10,21,0,21,2017,11,24,Friday
1,8,18,26,2017,10,19,Thursday
1,14,25,39,2018,6,4,Monday
15,45,-24,21,2018,3,5,Monday
4,11,10,21,2017,10,13,Friday
0,4,20,24,2017,6,26,Monday
3,4,11,15,2018,4,15,Sunday
2,15,4,19,2018,3,14,Wednseday
2,6,13,19,2018,4,28,Saturday
42,57,-20,37,2018,1,16,Tuesday
6,13,21,34,2017,9,13,Wednseday
3,9,16,25,2018,4,14,Saturday
6,11,28,39,2017,1,5,Thursday
14,19,34,53,2018,6,14,Thursday
4,15,22,37,2017,12,3,Sunday
9,12,21,33,2018,6,10,Sunday
3,19,13,32,2017,10,6,Friday
2,5,17,22,2018,7,29,Sunday
2,5,19,24,2018,4,22,Sunday
1,6,21,27,2017,2,2,Thursday
1,5,2,7,2018,8,9,Thursday
1,8,24,32,2018,6,28,Thursday
4,7,4,11,2017,7,10,Monday
0,14,10,24,2017,6,19,Monday
4,11,18,29,2018,4,29,Sunday
3,17,20,37,2017,11,26,Sunday
2,5,39,44,2017,2,19,Sunday
25,28,7,35,2017,10,27,Friday
1,7,3,10,2018,8,6,Monday
6,43,-12,31,2018,3,6,Tuesday
1,15,10,25,2018,3,4,Sunday
1,14,10,24,2017,7,11,Tuesday
2,7,15,22,2017,11,14,Tuesday
5,10,10,20,2017,11,25,Saturday
10,23,8,31,2017,5,2,Tuesday
0,7,17,24,2018,5,15,Tuesday
1,12,18,30,2018,1,24,Wednseday
17,22,1,23,2017,4,24,Monday
2,8,14,22,2018,6,13,Wednseday
2,4,10,14,2018,2,19,Monday
1,9,13,22,2017,10,22,Sunday
1,18,6,24,2017,12,3,Sunday
12,16,7,23,2018,4,29,Sunday
10,13,5,18,2018,8,3,Friday
3,13,10,23,2018,1,13,Saturday
10,30,4,34,2018,2,17,Saturday
2,27,-10,17,2018,3,11,Sunday
4,31,-10,21,2018,2,26,Monday
2,5,6,11,2018,8,11,Saturday
2,5,5,10,2018,8,11,Saturday
1,9,9,18,2017,10,9,Monday
3,26,7,33,2018,3,9,Friday
5,18,-2,16,2018,7,29,Sunday
7,8,3,11,2017,6,19,Monday
9,37,-6,31,2017,12,2,Saturday
2,4,13,17,2017,3,6,Monday
2,13,10,23,2017,11,15,Wednseday
0,3,21,24,2017,10,6,Friday
5,15,13,28,2017,11,30,Thursday
2,7,14,21,2017,5,29,Monday
3,4,9,13,2017,11,4,Saturday
2,9,31,40,2017,9,24,Sunday
1,7,26,33,2017,5,17,Wednseday
4,5,15,20,2017,6,23,Friday
6,19,8,27,2018,8,10,Friday
2,5,4,9,2018,8,4,Saturday
5,44,-17,27,2017,11,25,Saturday
8,29,8,37,2018,1,8,Monday
3,7,15,22,2017,11,14,Tuesday
2,13,21,34,2018,2,20,Tuesday
1,5,11,16,2018,8,5,Sunday
1,6,16,22,2018,5,16,Wednseday
4,9,4,13,2018,8,11,Saturday
1,6,20,26,2018,6,27,Wednseday
0,3,10,13,2018,3,23,Friday
9,15,17,32,2018,1,7,Sunday
1,10,14,24,2018,2,5,Monday
1,16,13,29,2018,2,1,Thursday
2,3,13,16,2017,7,2,Sunday
3,16,10,26,2017,4,14,Friday
1,8,19,27,2018,6,19,Tuesday
1,23,3,26,2018,7,25,Wednseday
3,6,20,26,2018,7,28,Saturday
1,7,23,30,2017,10,4,Wednseday
1,2,15,17,2018,6,25,Monday
3,32,5,37,2018,1,28,Sunday
5,13,9,22,2017,7,12,Wednseday
1,3,1,4,2018,7,30,Monday
5,12,12,24,2017,6,16,Friday
1,11,15,26,2018,4,19,Thursday
3,4,20,24,2017,12,16,Saturday
2,6,13,19,2017,11,12,Sunday
6,28,-2,26,2017,11,23,Thursday
2,8,9,17,2018,7,9,Monday
4,6,22,28,2017,12,15,Friday
2,10,15,25,2017,5,6,Saturday
2,9,14,23,2018,4,10,Tuesday
8,14,12,26,2017,12,27,Wednseday
1,5,14,19,2018,4,8,Sunday
1,7,17,24,2018,7,2,Monday
5,12,2,14,2017,11,2,Thursday
3,14,7,21,2017,8,29,Tuesday
2,10,14,24,2018,3,10,Saturday
1,36,-5,31,2018,1,29,Monday
2,6,31,37,2017,2,1,Wednseday
3,14,13,27,2018,1,5,Friday
4,15,16,31,2017,8,25,Friday
4,8,11,19,2018,7,20,Friday
4,13,18,31,2017,12,30,Saturday
3,5,12,17,2018,5,18,Friday
3,10,16,26,2018,7,27,Friday
0,11,6,17,2018,8,3,Friday
5,19,8,27,2017,7,20,Thursday
3,40,-8,32,2017,11,24,Friday
1,13,11,24,2018,1,23,Tuesday
2,15,13,28,2018,2,15,Thursday
2,10,20,30,2018,2,20,Tuesday
2,6,11,17,2018,1,9,Tuesday
2,12,17,29,2018,1,21,Sunday
0,7,18,25,2018,7,5,Thursday
0,1,8,9,2018,4,25,Wednseday
5,19,23,42,2017,8,4,Friday
0,14,10,24,2018,3,12,Monday
0,4,21,25,2017,3,24,Friday
1,5,9,14,2018,8,13,Monday
1,21,7,28,2018,5,14,Monday
3,23,0,23,2017,7,4,Tuesday
6,11,3,14,2018,7,26,Thursday
1,12,20,32,2018,1,8,Monday
4,7,12,19,2017,12,8,Friday
5,22,1,23,2017,11,26,Sunday
1,6,21,27,2018,6,7,Thursday
0,1,11,12,2017,10,18,Wednseday
5,9,20,29,2018,7,4,Wednseday
1,15,5,20,2018,5,17,Thursday
2,38,-15,23,2018,2,17,Saturday
15,28,10,38,2017,5,2,Tuesday
0,1,15,16,2018,4,11,Wednseday
1,3,12,15,2017,11,23,Thursday
1,8,15,23,2017,3,21,Tuesday
1,15,18,33,2017,8,10,Thursday
0,10,16,26,2017,4,7,Friday
1,10,19,29,2017,7,11,Tuesday
4,15,13,28,2018,2,2,Friday
2,9,28,37,2017,9,19,Tuesday
2,11,19,30,2017,7,2,Sunday
1,8,11,19,2018,7,26,Thursday
1,2,12,14,2017,6,5,Monday
0,6,26,32,2017,11,24,Friday
4,26,1,27,2017,6,2,Friday
6,13,23,36,2018,1,3,Wednseday
2,10,19,29,2018,7,22,Sunday
1,9,13,22,2017,8,3,Thursday
4,6,12,18,2018,3,31,Saturday
1,4,14,18,2017,11,30,Thursday
3,5,11,16,2017,7,23,Sunday
4,16,30,46,2018,6,2,Saturday
5,14,24,38,2018,1,12,Friday
2,7,13,20,2017,8,10,Thursday
12,17,2,19,2017,9,17,Sunday
0,8,16,24,2017,6,13,Tuesday
3,23,7,30,2017,2,19,Sunday
1,7,22,29,2018,6,4,Monday
2,13,13,26,2017,11,1,Wednseday
1,8,44,52,2018,6,3,Sunday
5,6,8,14,2018,4,18,Wednseday
6,35,-7,28,2017,11,29,Wednseday
1,11,16,27,2017,12,15,Friday
3,10,12,22,2018,5,13,Sunday
2,6,15,21,2018,4,5,Thursday
3,12,7,19,2017,10,22,Sunday
1,12,17,29,2017,6,1,Thursday
2,9,23,32,2018,6,25,Monday
2,7,6,13,2017,7,8,Saturday
4,13,16,29,2018,6,14,Thursday
3,9,14,23,2017,5,29,Monday
1,19,8,27,2018,4,18,Wednseday
6,7,6,13,2017,6,28,Wednseday
7,20,8,28,2017,10,25,Wednseday
5,7,9,16,2017,9,27,Wednseday
3,26,-2,24,2017,11,24,Friday
1,10,14,24,2017,12,5,Tuesday
4,6,29,35,2018,1,25,Thursday
3,13,9,22,2017,7,4,Tuesday
2,4,13,17,2017,3,27,Monday
2,9,17,26,2017,12,20,Wednseday
2,11,14,25,2018,4,14,Saturday
7,11,-5,6,2018,8,3,Friday
0,5,20,25,2017,12,1,Friday
1,19,10,29,2017,11,30,Thursday
4,8,23,31,2018,6,10,Sunday
2,26,-1,25,2017,12,17,Sunday
4,7,14,21,2018,2,22,Thursday
1,8,14,22,2017,7,19,Wednseday
2,15,9,24,2018,3,5,Monday
1,3,19,22,2018,6,25,Monday
1,8,7,15,2018,5,10,Thursday
1,8,8,16,2018,7,23,Monday
1,9,12,21,2017,10,17,Tuesday
1,7,15,22,2017,5,8,Monday
1,14,17,31,2017,5,30,Tuesday
2,6,18,24,2017,10,28,Saturday
1,2,8,10,2018,7,10,Tuesday
3,16,7,23,2017,5,13,Saturday
4,5,11,16,2017,7,23,Sunday
2,54,-10,44,2018,4,2,Monday
2,5,11,16,2017,11,29,Wednseday
2,15,-7,8,2018,8,15,Wednseday
2,11,6,17,2018,3,4,Sunday
4,17,10,27,2017,11,24,Friday
4,7,11,18,2018,7,19,Thursday
2,19,12,31,2017,12,16,Saturday
2,7,24,31,2018,5,12,Saturday
6,12,27,39,2017,2,2,Thursday
5,12,15,27,2017,10,18,Wednseday
5,10,9,19,2017,3,3,Friday
1,5,23,28,2017,6,26,Monday
14,18,6,24,2017,10,6,Friday
0,2,11,13,2018,7,3,Tuesday
5,20,3,23,2018,2,28,Wednseday
1,15,16,31,2017,12,4,Monday
1,12,11,23,2017,6,7,Wednseday
0,6,15,21,2018,2,15,Thursday
1,8,16,24,2018,4,16,Monday
1,7,9,16,2017,9,20,Wednseday
1,8,19,27,2017,2,22,Wednseday
3,9,11,20,2017,2,28,Tuesday
2,8,22,30,2018,4,15,Sunday
11,18,13,31,2018,8,10,Friday
1,19,22,41,2017,10,12,Thursday
1,10,0,10,2017,9,12,Tuesday
1,7,5,12,2018,4,5,Thursday
7,24,18,42,2017,4,21,Friday
4,11,6,17,2018,8,17,Friday
3,23,0,23,2017,9,16,Saturday
2,24,13,37,2017,4,30,Sunday
4,5,13,18,2018,1,5,Friday
1,6,23,29,2017,8,3,Thursday
4,15,16,31,2017,7,10,Monday
6,17,14,31,2018,1,5,Friday
3,4,21,25,2017,2,13,Monday
13,22,4,26,2018,3,25,Sunday
6,9,-3,6,2018,8,4,Saturday
2,16,8,24,2017,12,11,Monday
5,10,10,20,2017,7,1,Saturday
7,17,11,28,2018,4,9,Monday
3,11,14,25,2017,7,8,Saturday
4,13,9,22,2017,10,19,Thursday
4,10,14,24,2017,8,11,Friday
2,5,26,31,2018,6,30,Saturday
1,15,12,27,2018,8,2,Thursday
1,9,7,16,2017,11,21,Tuesday
3,27,8,35,2018,3,21,Wednseday
6,10,10,20,2018,2,9,Friday
1,6,20,26,2017,3,9,Thursday
1,7,21,28,2017,4,6,Thursday
2,19,2,21,2018,2,14,Wednseday
1,11,10,21,2018,7,30,Monday
6,22,1,23,2018,1,24,Wednseday
8,15,5,20,2018,5,9,Wednseday
3,16,8,24,2018,5,18,Friday
1,7,22,29,2018,1,31,Wednseday
3,11,13,24,2018,2,13,Tuesday
3,4,8,12,2018,3,2,Friday
1,5,8,13,2017,5,16,Tuesday
5,12,12,24,2018,1,21,Sunday
4,9,12,21,2017,11,2,Thursday
1,5,14,19,2017,9,14,Thursday
7,11,11,22,2017,6,1,Thursday
0,20,-7,13,2017,7,20,Thursday
1,4,8,12,2018,3,1,Thursday
1,3,9,12,2017,8,27,Sunday
1,4,9,13,2017,8,3,Thursday
2,3,7,10,2017,10,17,Tuesday
5,19,12,31,2017,9,15,Friday
2,3,10,13,2017,5,6,Saturday
2,9,7,16,2018,3,7,Wednseday
9,14,15,29,2017,8,14,Monday
1,21,6,27,2018,4,12,Thursday
3,5,8,13,2018,7,21,Saturday
4,12,12,24,2017,12,3,Sunday
2,3,17,20,2017,12,26,Tuesday
2,24,13,37,2017,12,16,Saturday
2,5,8,13,2018,5,9,Wednseday
3,5,5,10,2018,8,3,Friday
11,25,6,31,2017,2,25,Saturday
2,9,16,25,2017,6,10,Saturday
1,2,18,20,2017,12,27,Wednseday
1,2,12,14,2017,11,27,Monday
1,15,18,33,2018,6,20,Wednseday
3,20,10,30,2018,1,31,Wednseday
3,5,13,18,2018,4,30,Monday
2,5,11,16,2018,8,19,Sunday
4,17,15,32,2017,7,15,Saturday
3,13,18,31,2017,2,17,Friday
3,18,-3,15,2017,7,23,Sunday
10,11,7,18,2018,4,6,Friday
4,18,5,23,2017,3,4,Saturday
1,3,22,25,2018,1,14,Sunday
2,6,10,16,2018,8,18,Saturday
2,11,1,12,2018,8,5,Sunday
3,13,12,25,2018,3,17,Saturday
6,13,12,25,2018,3,29,Thursday
1,5,17,22,2018,7,8,Sunday
0,13,14,27,2017,3,10,Friday
3,9,13,22,2017,10,16,Monday
1,20,8,28,2018,7,10,Tuesday
1,22,7,29,2017,12,12,Tuesday
1,4,17,21,2017,8,21,Monday
4,12,13,25,2018,2,10,Saturday
3,6,4,10,2018,8,24,Friday
5,6,6,12,2018,4,4,Wednseday
7,19,8,27,2018,2,14,Wednseday
4,15,9,24,2017,3,19,Sunday
0,6,20,26,2017,10,5,Thursday
6,19,10,29,2018,4,18,Wednseday
1,3,6,9,2018,8,7,Tuesday
1,4,16,20,2018,5,24,Thursday
1,7,12,19,2018,5,17,Thursday
1,7,7,14,2018,8,20,Monday
4,15,17,32,2017,10,2,Monday
3,18,6,24,2017,11,6,Monday
9,16,7,23,2018,1,30,Tuesday
1,7,17,24,2017,4,10,Monday
3,18,2,20,2017,11,24,Friday
2,16,13,29,2017,2,20,Monday
1,7,28,35,2018,1,17,Wednseday
1,24,-7,17,2018,5,20,Sunday
3,15,5,20,2018,8,3,Friday
2,11,25,36,2018,8,12,Sunday
0,6,15,21,2017,10,26,Thursday
2,8,14,22,2017,8,15,Tuesday
1,19,9,28,2018,4,11,Wednseday
1,6,12,18,2018,8,23,Thursday
6,23,-4,19,2018,5,17,Thursday
3,4,12,16,2017,10,28,Saturday
8,18,26,44,2018,5,20,Sunday
1,11,20,31,2017,5,8,Monday
3,11,23,34,2018,6,1,Friday
1,6,16,22,2017,7,26,Wednseday
2,42,-20,22,2017,8,7,Monday
4,18,23,41,2018,3,8,Thursday
4,5,6,11,2018,6,7,Thursday
6,15,26,41,2018,6,12,Tuesday
6,20,20,40,2017,3,23,Thursday
5,15,12,27,2017,9,20,Wednseday
1,12,15,27,2017,6,7,Wednseday
4,12,16,28,2018,1,12,Friday
2,18,0,18,2018,4,1,Sunday
1,8,3,11,2017,9,10,Sunday
1,78,-49,29,2017,11,29,Wednseday
1,18,16,34,2017,12,5,Tuesday
5,14,6,20,2017,11,24,Friday
4,5,10,15,2018,2,25,Sunday
1,19,15,34,2017,7,13,Thursday
1,2,15,17,2018,1,9,Tuesday
1,13,13,26,2018,2,28,Wednseday
1,5,0,5,2018,8,15,Wednseday
1,4,2,6,2018,8,7,Tuesday
2,3,21,24,2018,1,7,Sunday
2,14,23,37,2018,5,28,Monday
3,5,6,11,2018,4,1,Sunday
1,5,14,19,2018,5,6,Sunday
1,8,-2,6,2018,8,8,Wednseday
4,22,18,40,2017,9,21,Thursday
6,11,3,14,2017,11,23,Thursday
3,8,20,28,2018,2,26,Monday
2,12,17,29,2017,3,1,Wednseday
5,8,6,14,2018,2,23,Friday
5,16,7,23,2017,11,1,Wednseday
3,4,22,26,2018,6,2,Saturday
8,17,6,23,2017,11,27,Monday
1,15,7,22,2017,7,13,Thursday
1,7,14,21,2018,8,13,Monday
15,20,1,21,2018,8,7,Tuesday
7,12,35,47,2018,6,6,Wednseday
3,19,19,38,2017,12,8,Friday
2,9,15,24,2017,9,25,Monday
4,23,-1,22,2018,5,14,Monday
0,7,17,24,2017,4,10,Monday
3,22,9,31,2018,4,22,Sunday
3,19,28,47,2017,6,3,Saturday
7,16,6,22,2017,5,16,Tuesday
1,7,21,28,2018,6,5,Tuesday
4,14,5,19,2017,11,5,Sunday
3,7,7,14,2018,8,6,Monday
4,11,16,27,2018,4,26,Thursday
2,12,21,33,2017,6,17,Saturday
0,6,33,39,2018,4,27,Friday
1,7,22,29,2017,5,16,Tuesday
0,9,21,30,2018,4,17,Tuesday
1,6,20,26,2017,5,18,Thursday
3,11,23,34,2017,12,8,Friday
2,23,6,29,2018,2,27,Tuesday
1,14,16,30,2018,5,7,Monday
1,5,25,30,2018,7,25,Wednseday
5,15,9,24,2018,7,29,Sunday
1,19,3,22,2017,4,19,Wednseday
4,10,15,25,2018,1,20,Saturday
10,16,29,45,2018,5,29,Tuesday
10,19,4,23,2017,9,16,Saturday
1,9,21,30,2017,10,4,Wednseday
2,6,18,24,2018,4,22,Sunday
4,11,12,23,2018,3,5,Monday
4,7,9,16,2017,5,15,Monday
5,21,12,33,2017,5,4,Thursday
4,20,8,28,2017,11,10,Friday
4,19,8,27,2017,11,25,Saturday
4,19,8,27,2017,6,23,Friday
2,8,10,18,2017,7,3,Monday
4,20,11,31,2017,12,15,Friday
2,11,15,26,2018,3,25,Sunday
11,19,5,24,2017,10,15,Sunday
6,14,30,44,2018,5,30,Wednseday
3,11,14,25,2017,8,25,Friday
9,11,6,17,2017,3,27,Monday
4,25,1,26,2018,4,12,Thursday
5,12,14,26,2017,8,11,Friday
1,9,9,18,2017,9,11,Monday
1,7,9,16,2018,8,20,Monday
5,31,-9,22,2017,11,26,Sunday
3,12,13,25,2018,4,7,Saturday
1,7,9,16,2018,8,6,Monday
2,3,2,5,2018,7,28,Saturday
1,2,18,20,2018,7,3,Tuesday
3,19,9,28,2018,3,26,Monday
2,7,1,8,2018,8,1,Wednseday
2,15,14,29,2018,5,14,Monday
0,13,15,28,2018,7,20,Friday
3,6,13,19,2018,8,11,Saturday
3,14,6,20,2017,11,25,Saturday
1,23,-7,16,2017,11,21,Tuesday
4,44,-15,29,2018,2,27,Tuesday
6,12,12,24,2017,9,2,Saturday
4,18,7,25,2017,6,3,Saturday
4,16,6,22,2017,5,15,Monday
2,6,14,20,2017,12,20,Wednseday
5,21,5,26,2017,12,13,Wednseday
3,9,-2,7,2018,8,7,Tuesday
1,2,10,12,2017,8,27,Sunday
1,5,16,21,2018,6,28,Thursday
11,17,8,25,2017,11,11,Saturday
1,6,17,23,2018,4,24,Tuesday
2,8,15,23,2018,4,24,Tuesday
3,16,15,31,2018,2,11,Sunday
2,35,5,40,2018,1,17,Wednseday
6,9,22,31,2018,5,29,Tuesday
1,26,-8,18,2018,3,1,Thursday
6,17,-4,13,2017,7,4,Tuesday
0,5,27,32,2018,7,6,Friday
4,13,17,30,2018,2,24,Saturday
2,15,9,24,2017,7,18,Tuesday
4,8,30,38,2017,11,27,Monday
2,9,17,26,2018,4,4,Wednseday
5,9,12,21,2017,8,2,Wednseday
1,2,20,22,2017,12,12,Tuesday
0,4,9,13,2018,8,23,Thursday
2,3,2,5,2018,8,18,Saturday
0,1,9,10,2018,8,10,Friday
4,7,18,25,2017,8,18,Friday
7,8,6,14,2018,5,1,Tuesday
4,13,6,19,2018,3,24,Saturday
1,8,18,26,2017,5,17,Wednseday
2,13,12,25,2018,4,12,Thursday
0,9,22,31,2018,5,29,Tuesday
1,8,24,32,2018,8,12,Sunday
4,35,13,48,2018,3,15,Thursday
3,17,10,27,2017,10,7,Saturday
2,28,-5,23,2017,11,21,Tuesday
2,22,-1,21,2018,2,27,Tuesday
1,26,-4,22,2017,11,23,Thursday
1,15,17,32,2017,9,28,Thursday
1,5,22,27,2018,6,6,Wednseday
3,7,21,28,2017,8,11,Friday
2,18,6,24,2017,11,12,Sunday
6,10,10,20,2017,10,18,Wednseday
3,11,10,21,2018,7,13,Friday
4,8,9,17,2018,8,13,Monday
1,15,14,29,2018,3,5,Monday
1,4,21,25,2017,9,25,Monday
3,12,21,33,2018,6,1,Friday
0,26,-3,23,2018,3,20,Tuesday
4,7,8,15,2017,7,31,Monday
4,31,10,41,2017,4,8,Saturday
3,16,28,44,2017,5,7,Sunday
3,7,16,23,2018,1,22,Monday
1,13,6,19,2017,11,26,Sunday
1,10,18,28,2018,8,6,Monday
8,23,6,29,2017,8,13,Sunday
1,6,6,12,2018,8,23,Thursday
0,5,9,14,2018,7,20,Friday
1,5,16,21,2018,7,16,Monday
0,35,1,36,2017,10,2,Monday
3,24,11,35,2018,2,2,Friday
1,5,16,21,2018,6,14,Thursday
0,1,7,8,2018,5,14,Monday
3,11,13,24,2017,10,7,Saturday
2,12,6,18,2017,11,27,Monday
11,30,21,51,2018,1,20,Saturday
3,9,12,21,2018,7,3,Tuesday
2,9,27,36,2018,1,31,Wednseday
1,2,11,13,2017,5,23,Tuesday
4,18,9,27,2018,5,5,Saturday
3,17,1,18,2017,9,18,Monday
1,12,8,20,2017,5,11,Thursday
46,56,-24,32,2017,2,10,Friday
4,16,6,22,2017,10,2,Monday
7,15,7,22,2018,2,14,Wednseday
2,10,7,17,2018,3,4,Sunday
6,26,0,26,2018,5,3,Thursday
2,9,29,38,2018,6,11,Monday
7,11,10,21,2018,2,13,Tuesday
0,14,13,27,2017,9,26,Tuesday
1,5,28,33,2018,4,29,Sunday
1,2,3,5,2018,8,12,Sunday
1,2,9,11,2018,3,18,Sunday
1,5,17,22,2018,5,6,Sunday
2,45,-22,23,2018,1,16,Tuesday
5,8,8,16,2018,5,9,Wednseday
21,30,-7,23,2017,3,13,Monday
6,8,20,28,2017,5,5,Friday
4,6,8,14,2017,11,10,Friday
5,8,7,15,2018,8,15,Wednseday
7,14,19,33,2018,1,17,Wednseday
1,13,15,28,2017,12,27,Wednseday
1,5,15,20,2018,6,28,Thursday
2,12,11,23,2018,7,2,Monday
4,16,10,26,2018,4,28,Saturday
1,2,12,14,2017,11,27,Monday
4,20,7,27,2017,3,31,Friday
1,16,4,20,2017,9,15,Friday
9,30,10,40,2017,2,12,Sunday
2,3,10,13,2017,6,20,Tuesday
3,14,14,28,2017,2,28,Tuesday
1,6,20,26,2018,3,14,Wednseday
1,8,10,18,2017,6,26,Monday
4,6,20,26,2018,1,11,Thursday
6,20,-1,19,2018,3,15,Thursday
1,17,19,36,2018,5,22,Tuesday
5,19,6,25,2017,7,9,Sunday
8,13,7,20,2017,11,8,Wednseday
3,7,16,23,2017,11,18,Saturday
3,7,7,14,2018,7,27,Friday
1,2,11,13,2018,5,2,Wednseday
2,6,14,20,2017,11,8,Wednseday
1,9,11,20,2017,11,8,Wednseday
6,9,46,55,2016,10,8,Saturday
17,20,35,55,2016,10,4,Tuesday
2,20,0,20,2017,5,10,Wednseday
0,10,19,29,2018,7,10,Tuesday
2,35,-12,23,2018,3,12,Monday
1,10,14,24,2017,7,25,Tuesday
1,5,0,5,2018,8,16,Thursday
2,5,17,22,2018,6,20,Wednseday
4,6,14,20,2018,2,10,Saturday
6,14,10,24,2017,11,17,Friday
1,21,13,34,2018,2,20,Tuesday
1,7,16,23,2018,4,10,Tuesday
6,15,7,22,2017,7,18,Tuesday
1,10,3,13,2018,3,28,Wednseday
14,19,2,21,2017,3,10,Friday
1,44,-1,43,2017,3,20,Monday
6,25,9,34,2017,6,3,Saturday
3,13,16,29,2017,10,3,Tuesday
3,7,14,21,2017,11,24,Friday
2,5,19,24,2018,6,30,Saturday
5,15,7,22,2017,11,2,Thursday
1,8,28,36,2018,5,6,Sunday
3,6,13,19,2018,5,4,Friday
3,8,14,22,2017,6,11,Sunday
1,9,16,25,2018,4,23,Monday
2,3,27,30,2017,8,12,Saturday
3,14,13,27,2017,12,15,Friday
7,14,7,21,2017,9,15,Friday
5,16,10,26,2018,4,11,Wednseday
10,13,13,26,2018,6,8,Friday
4,7,20,27,2017,7,20,Thursday
1,18,6,24,2018,3,19,Monday
3,23,8,31,2017,12,4,Monday
1,5,13,18,2018,7,29,Sunday
17,22,-6,16,2017,12,5,Tuesday
4,13,8,21,2017,9,14,Thursday
1,2,12,14,2018,6,28,Thursday
11,12,8,20,2017,5,18,Thursday
3,18,8,26,2017,2,5,Sunday
5,18,8,26,2018,1,10,Wednseday
2,7,13,20,2018,5,1,Tuesday
2,8,15,23,2017,8,6,Sunday
4,12,10,22,2017,7,20,Thursday
3,14,21,35,2018,2,6,Tuesday
1,2,12,14,2017,11,28,Tuesday
2,5,20,25,2017,3,26,Sunday
0,9,12,21,2017,10,9,Monday
1,12,17,29,2018,3,22,Thursday
8,33,-2,31,2017,9,10,Sunday
2,9,19,28,2017,12,18,Monday
2,7,22,29,2017,7,26,Wednseday
3,6,34,40,2017,1,20,Friday
5,6,7,13,2017,6,28,Wednseday
1,4,14,18,2017,8,28,Monday
1,12,0,12,2018,3,7,Wednseday
2,30,8,38,2018,4,15,Sunday
1,17,14,31,2018,4,17,Tuesday
3,7,14,21,2017,10,20,Friday
15,25,6,31,2018,2,11,Sunday
1,9,14,23,2017,3,14,Tuesday
6,11,15,26,2018,4,13,Friday
1,14,14,28,2017,12,6,Wednseday
1,8,17,25,2018,7,5,Thursday
1,8,15,23,2017,9,13,Wednseday
4,11,14,25,2018,1,26,Friday
0,6,29,35,2018,6,14,Thursday
2,33,5,38,2018,4,21,Saturday
2,50,-19,31,2018,1,9,Tuesday
0,1,11,12,2018,8,23,Thursday
5,25,1,26,2018,2,24,Saturday
18,27,7,34,2018,3,15,Thursday
3,11,14,25,2018,4,14,Saturday
4,36,-7,29,2017,6,15,Thursday
1,16,12,28,2018,3,6,Tuesday
1,10,20,30,2017,10,8,Sunday
11,17,8,25,2018,2,4,Sunday
2,5,21,26,2018,6,23,Saturday
0,1,26,27,2018,6,6,Wednseday
4,20,15,35,2018,1,16,Tuesday
2,21,2,23,2018,5,7,Monday
4,11,16,27,2018,1,25,Thursday
5,13,12,25,2017,5,11,Thursday
0,3,12,15,2018,4,30,Monday
1,19,10,29,2018,5,16,Wednseday
3,5,23,28,2018,6,22,Friday
5,7,20,27,2017,2,9,Thursday
2,7,16,23,2018,6,27,Wednseday
1,4,25,29,2017,5,22,Monday
2,10,28,38,2018,8,5,Sunday
1,6,13,19,2018,8,15,Wednseday
1,4,25,29,2017,8,28,Monday
1,20,0,20,2018,4,4,Wednseday
0,14,15,29,2017,5,24,Wednseday
2,6,12,18,2017,6,11,Sunday
3,13,25,38,2017,9,8,Friday
1,2,15,17,2017,12,12,Tuesday
7,11,15,26,2017,3,24,Friday
1,10,12,22,2018,1,29,Monday
2,3,12,15,2018,7,1,Sunday
4,11,2,13,2018,8,17,Friday
6,7,7,14,2018,2,21,Wednseday
6,8,6,14,2018,2,9,Friday
1,23,12,35,2017,8,16,Wednseday
3,32,-5,27,2018,3,13,Tuesday
6,13,10,23,2018,4,24,Tuesday
6,9,7,16,2017,6,13,Tuesday
20,22,0,22,2017,4,26,Wednseday
4,18,15,33,2017,12,8,Friday
3,13,11,24,2017,11,24,Friday
1,7,0,7,2018,8,23,Thursday
6,38,-8,30,2018,2,13,Tuesday
1,7,13,20,2018,4,25,Wednseday
1,8,22,30,2018,5,7,Monday
6,30,-1,29,2018,3,4,Sunday
2,10,7,17,2017,9,11,Monday
1,5,12,17,2017,8,13,Sunday
5,39,-8,31,2018,3,16,Friday
6,20,5,25,2017,5,25,Thursday
3,23,11,34,2018,1,27,Saturday
2,5,15,20,2017,6,24,Saturday
3,12,15,27,2017,11,14,Tuesday
11,20,19,39,2018,1,26,Friday
2,3,6,9,2018,5,13,Sunday
3,21,9,30,2018,5,14,Monday
4,15,27,42,2018,1,5,Friday
4,20,9,29,2017,9,14,Thursday
1,3,6,9,2018,5,21,Monday
3,8,13,21,2017,3,7,Tuesday
14,18,27,45,2017,5,8,Monday
7,15,8,23,2017,12,4,Monday
7,10,11,21,2018,1,16,Tuesday
3,9,20,29,2018,3,12,Monday
1,8,9,17,2017,12,11,Monday
1,9,41,50,2018,6,5,Tuesday
1,8,17,25,2018,1,22,Monday
2,13,14,27,2018,2,28,Wednseday
1,7,13,20,2017,5,23,Tuesday
1,2,10,12,2017,10,22,Sunday
1,38,-3,35,2017,8,1,Tuesday
2,9,10,19,2018,8,11,Saturday
2,13,10,23,2017,10,4,Wednseday
20,28,7,35,2017,12,22,Friday
0,3,18,21,2018,1,19,Friday
0,8,21,29,2017,1,26,Thursday
1,7,9,16,2018,4,2,Monday
3,11,19,30,2018,1,21,Sunday
0,11,17,28,2018,5,14,Monday
3,8,16,24,2017,6,11,Sunday
8,19,16,35,2017,8,23,Wednseday
2,3,12,15,2018,7,8,Sunday
1,27,-10,17,2018,5,22,Tuesday
1,20,3,23,2017,11,29,Wednseday
3,13,11,24,2017,5,19,Friday
1,20,16,36,2017,12,13,Wednseday
1,29,-7,22,2017,10,31,Tuesday
2,3,2,5,2018,7,28,Saturday
5,20,12,32,2017,7,20,Thursday
1,9,11,20,2018,2,21,Wednseday
10,17,22,39,2017,4,30,Sunday
3,39,-15,24,2018,3,23,Friday
1,4,4,8,2018,8,6,Monday
2,10,16,26,2017,8,5,Saturday
2,15,14,29,2017,11,27,Monday
0,2,16,18,2017,11,30,Thursday
2,7,21,28,2017,5,29,Monday
1,14,9,23,2017,10,17,Tuesday
2,19,24,43,2018,6,5,Tuesday
2,3,5,8,2018,5,22,Tuesday
2,10,20,30,2017,4,22,Saturday
1,13,13,26,2018,5,10,Thursday
2,16,16,32,2017,3,26,Sunday
3,8,11,19,2018,8,3,Friday
2,10,19,29,2018,4,30,Monday
2,10,24,34,2017,2,4,Saturday
1,8,21,29,2018,1,7,Sunday
0,1,16,17,2018,1,9,Tuesday
2,9,10,19,2017,9,2,Saturday
5,23,13,36,2018,1,10,Wednseday
6,11,28,39,2017,1,5,Thursday
4,10,8,18,2017,12,1,Friday
3,10,7,17,2017,9,17,Sunday
10,27,0,27,2018,7,17,Tuesday
5,12,13,25,2017,5,5,Friday
2,5,10,15,2018,1,15,Monday
2,24,2,26,2018,3,11,Sunday
4,20,15,35,2017,12,7,Thursday
4,5,2,7,2018,8,16,Thursday
2,21,0,21,2018,5,14,Monday
1,2,12,14,2018,6,19,Tuesday
2,11,18,29,2017,3,5,Sunday
1,6,25,31,2018,8,21,Tuesday
2,29,0,29,2017,12,20,Wednseday
3,4,8,12,2017,10,20,Friday
0,10,15,25,2017,12,1,Friday
5,7,12,19,2018,4,20,Friday
3,15,9,24,2017,12,4,Monday
1,41,-14,27,2017,1,31,Tuesday
6,10,18,28,2018,5,1,Tuesday
2,9,9,18,2017,6,19,Monday
4,10,8,18,2018,2,5,Monday
4,11,18,29,2018,6,21,Thursday
3,4,9,13,2017,7,28,Friday
1,20,-2,18,2018,3,8,Thursday
1,3,13,16,2018,6,12,Tuesday
5,25,8,33,2017,11,25,Saturday
3,9,13,22,2017,11,5,Sunday
6,8,11,19,2018,4,4,Wednseday
2,4,12,16,2018,7,9,Monday
2,9,16,25,2017,8,19,Saturday
2,15,9,24,2017,10,29,Sunday
1,8,27,35,2018,6,12,Tuesday
3,16,12,28,2017,8,8,Tuesday
1,13,16,29,2017,7,4,Tuesday
4,11,14,25,2018,7,20,Friday
1,3,13,16,2018,4,24,Tuesday
1,4,28,32,2018,6,24,Sunday
1,12,24,36,2017,5,7,Sunday
3,7,10,17,2018,1,2,Tuesday
2,5,21,26,2018,6,2,Saturday
4,17,14,31,2017,2,18,Saturday
1,13,13,26,2017,10,5,Thursday
1,3,10,13,2017,8,15,Tuesday
1,12,11,23,2017,12,6,Wednseday
2,8,9,17,2017,11,20,Monday
4,12,22,34,2018,2,16,Friday
2,9,17,26,2017,12,13,Wednseday
3,28,-4,24,2018,5,15,Tuesday
1,3,13,16,2017,5,21,Sunday
6,7,2,9,2018,8,14,Tuesday
2,5,18,23,2017,3,26,Sunday
4,14,13,27,2017,9,29,Friday
4,26,5,31,2018,7,9,Monday
0,4,17,21,2017,11,3,Friday
4,26,20,46,2017,2,18,Saturday
7,8,6,14,2018,4,25,Wednseday
3,14,7,21,2017,11,14,Tuesday
4,13,20,33,2017,12,15,Friday
2,7,13,20,2017,11,14,Tuesday
6,14,12,26,2017,12,14,Thursday
1,8,22,30,2018,7,1,Sunday
4,27,4,31,2018,3,10,Saturday
4,17,15,32,2018,2,10,Saturday
3,9,21,30,2018,7,16,Monday
2,8,10,18,2018,2,26,Monday
1,8,20,28,2018,6,20,Wednseday
3,21,12,33,2017,12,8,Friday
3,9,15,24,2017,11,4,Saturday
1,9,20,29,2018,1,4,Thursday
3,7,15,22,2018,1,2,Tuesday
1,27,-5,22,2018,3,20,Tuesday
10,23,-1,22,2017,9,17,Sunday
6,14,29,43,2017,4,26,Wednseday
1,6,14,20,2017,3,23,Thursday
0,3,7,10,2018,7,20,Friday
2,16,19,35,2017,3,20,Monday
1,11,16,27,2018,4,26,Thursday
10,15,16,31,2017,7,21,Friday
1,13,17,30,2017,10,24,Tuesday
2,5,11,16,2017,12,4,Monday
1,26,0,26,2018,3,16,Friday
2,36,-20,16,2018,1,3,Wednseday
6,13,14,27,2017,10,11,Wednseday
3,4,9,13,2017,9,2,Saturday
3,9,24,33,2017,5,27,Saturday
1,3,14,17,2018,4,2,Monday
1,9,8,17,2018,3,11,Sunday
30,30,-4,26,2017,3,4,Saturday
7,9,7,16,2017,9,13,Wednseday
1,12,13,25,2017,6,25,Sunday
2,5,6,11,2018,8,25,Saturday
2,3,16,19,2018,4,14,Saturday
2,7,20,27,2017,2,8,Wednseday
0,3,3,6,2018,8,3,Friday
0,1,19,20,2018,5,24,Thursday
2,31,-2,29,2018,2,25,Sunday
3,13,14,27,2018,5,11,Friday
8,17,12,29,2017,7,10,Monday
0,28,-1,27,2017,12,6,Wednseday
37,66,-31,35,2017,5,15,Monday
6,19,7,26,2017,5,18,Thursday
10,24,10,34,2017,9,23,Saturday
3,14,12,26,2018,2,23,Friday
9,36,12,48,2018,3,10,Saturday
6,10,3,13,2018,8,7,Tuesday
1,8,14,22,2017,6,27,Tuesday
4,10,14,24,2017,12,11,Monday
0,7,30,37,2018,5,16,Wednseday
1,22,8,30,2018,1,10,Wednseday
5,6,17,23,2017,12,23,Saturday
1,5,8,13,2017,8,3,Thursday
4,5,20,25,2017,11,25,Saturday
2,4,20,24,2017,7,23,Sunday
0,1,14,15,2018,8,14,Tuesday
6,8,17,25,2018,1,4,Thursday
1,7,15,22,2017,11,21,Tuesday
1,7,-1,6,2018,8,7,Tuesday
1,13,6,19,2018,8,9,Thursday
3,11,8,19,2018,4,29,Sunday
5,7,14,21,2018,6,8,Friday
4,7,1,8,2018,8,2,Thursday
2,7,13,20,2017,11,7,Tuesday
4,12,9,21,2017,10,19,Thursday
8,10,12,22,2018,6,20,Wednseday
3,6,0,6,2018,8,7,Tuesday
2,15,9,24,2018,3,12,Monday
0,4,5,9,2017,5,15,Monday
0,8,24,32,2017,7,3,Monday
1,3,13,16,2017,10,3,Tuesday
2,16,6,22,2017,5,28,Sunday
2,8,15,23,2017,12,6,Wednseday
2,6,24,30,2017,11,5,Sunday
2,24,21,45,2018,6,2,Saturday
2,19,-7,12,2017,7,9,Sunday
1,9,14,23,2018,7,18,Wednseday
2,20,8,28,2017,11,1,Wednseday
1,6,3,9,2018,8,7,Tuesday
5,25,4,29,2018,3,8,Thursday
7,13,8,21,2017,11,13,Monday
2,6,31,37,2018,6,5,Tuesday
3,5,5,10,2018,7,16,Monday
3,9,6,15,2018,7,30,Monday
17,26,28,54,2018,6,2,Saturday
9,15,40,55,2016,10,5,Wednseday
4,20,10,30,2017,5,13,Saturday
2,16,3,19,2018,5,19,Saturday
1,5,4,9,2018,8,15,Wednseday
3,7,18,25,2018,5,11,Friday
3,7,10,17,2017,10,10,Tuesday
0,11,27,38,2017,10,23,Monday
2,4,8,12,2017,10,22,Sunday
6,20,9,29,2018,2,14,Wednseday
0,7,15,22,2018,7,5,Thursday
1,22,5,27,2018,2,22,Thursday
3,39,-14,25,2018,2,16,Friday
1,7,9,16,2018,4,2,Monday
2,37,-1,36,2018,3,11,Sunday
0,3,18,21,2018,5,8,Tuesday
2,18,4,22,2018,2,20,Tuesday
1,8,18,26,2018,6,24,Sunday
5,8,19,27,2017,2,9,Thursday
7,28,1,29,2017,11,23,Thursday
5,7,10,17,2018,1,19,Friday
4,5,8,13,2018,3,22,Thursday
3,16,22,38,2017,8,7,Monday
3,12,20,32,2017,9,23,Saturday
5,5,7,12,2018,3,15,Thursday
3,12,20,32,2017,12,1,Friday
5,26,-6,20,2018,7,13,Friday
2,23,7,30,2018,3,17,Saturday
3,6,19,25,2017,9,30,Saturday
3,13,6,19,2018,3,24,Saturday
2,4,12,16,2018,1,8,Monday
2,3,15,18,2018,2,26,Monday
4,11,17,28,2017,12,1,Friday
7,13,13,26,2017,9,14,Thursday
1,7,22,29,2018,6,21,Thursday
7,8,-1,7,2018,8,3,Friday
1,2,13,15,2018,6,13,Wednseday
21,22,3,25,2018,1,15,Monday
1,2,11,13,2017,10,24,Tuesday
2,9,8,17,2018,8,13,Monday
4,10,24,34,2017,4,8,Saturday
1,16,16,32,2018,2,1,Thursday
4,20,12,32,2017,9,7,Thursday
0,18,10,28,2018,2,1,Thursday
1,7,18,25,2017,2,23,Thursday
1,13,10,23,2018,6,26,Tuesday
1,13,12,25,2017,12,17,Sunday
11,12,13,25,2017,6,1,Thursday
3,14,4,18,2017,9,16,Saturday
1,8,8,16,2018,4,2,Monday
2,14,10,24,2018,3,19,Monday
1,10,13,23,2017,7,16,Sunday
7,9,7,16,2017,5,9,Tuesday
7,14,15,29,2017,8,30,Wednseday
6,12,9,21,2018,7,18,Wednseday
3,54,-17,37,2018,4,15,Sunday
19,25,21,46,2018,6,3,Sunday
1,2,26,28,2017,7,17,Monday
1,4,19,23,2017,10,15,Sunday
2,10,16,26,2018,8,19,Sunday
5,17,10,27,2017,5,13,Saturday
2,3,6,9,2018,8,14,Tuesday
1,15,11,26,2017,11,9,Thursday
7,30,-9,21,2018,5,9,Wednseday
4,11,26,37,2018,7,23,Monday
2,12,-1,11,2018,3,11,Sunday
3,7,19,26,2018,7,20,Friday
1,5,31,36,2018,6,6,Wednseday
5,13,17,30,2017,8,2,Wednseday
1,7,17,24,2018,6,26,Tuesday
0,8,21,29,2017,6,8,Thursday
6,18,14,32,2017,7,22,Saturday
1,7,29,36,2018,6,21,Thursday
1,5,16,21,2017,6,7,Wednseday
9,25,14,39,2017,8,21,Monday
3,5,8,13,2017,6,17,Saturday
2,28,0,28,2018,5,14,Monday
3,5,16,21,2018,8,24,Friday
2,8,23,31,2018,1,21,Sunday
2,14,10,24,2018,3,10,Saturday
17,27,17,44,2018,7,17,Tuesday
2,4,9,13,2018,3,27,Tuesday
3,10,21,31,2018,6,26,Tuesday
1,2,13,15,2017,8,14,Monday
1,3,7,10,2018,5,7,Monday
1,9,16,25,2018,6,18,Monday
1,8,15,23,2017,8,21,Monday
6,15,9,24,2017,10,20,Friday
6,24,-3,21,2018,2,23,Friday
6,10,3,13,2018,8,7,Tuesday
2,10,17,27,2018,3,10,Saturday
2,7,31,38,2018,6,5,Tuesday
1,13,4,17,2018,5,22,Tuesday
5,14,12,26,2018,3,3,Saturday
4,7,15,22,2017,4,20,Thursday
3,9,14,23,2018,1,22,Monday
1,9,21,30,2018,7,3,Tuesday
2,6,7,13,2017,11,1,Wednseday
6,7,8,15,2018,5,3,Thursday
2,4,9,13,2018,7,28,Saturday
1,2,11,13,2017,6,21,Wednseday
3,10,17,27,2017,8,4,Friday
1,11,17,28,2018,6,7,Thursday
2,15,7,22,2017,10,23,Monday
4,15,8,23,2018,2,12,Monday
4,6,7,13,2018,3,23,Friday
1,6,6,12,2018,8,5,Sunday
1,5,13,18,2018,4,6,Friday
5,16,11,27,2017,5,20,Saturday
5,6,7,13,2018,8,1,Wednseday
3,10,15,25,2018,6,16,Saturday
1,9,15,24,2017,3,27,Monday
1,8,24,32,2017,12,4,Monday
1,14,13,27,2017,4,18,Tuesday
4,29,-3,26,2018,4,12,Thursday
1,14,18,32,2017,5,8,Monday
5,14,6,20,2018,3,1,Thursday
3,18,12,30,2017,8,19,Saturday
2,22,7,29,2017,12,6,Wednseday
4,6,19,25,2017,5,5,Friday
4,13,30,43,2017,1,19,Thursday
1,9,21,30,2018,6,26,Tuesday
4,22,10,32,2017,8,3,Thursday
2,14,21,35,2017,5,22,Monday
5,12,15,27,2018,8,17,Friday
2,23,6,29,2017,12,6,Wednseday
2,16,18,34,2017,12,26,Tuesday
2,8,13,21,2018,4,2,Monday
4,7,11,18,2018,2,1,Thursday
4,10,14,24,2018,5,6,Sunday
1,8,28,36,2018,6,21,Thursday
2,12,18,30,2017,10,4,Wednseday
2,9,12,21,2017,3,8,Wednseday
2,10,29,39,2017,3,4,Saturday
6,11,14,25,2018,6,9,Saturday
7,30,-8,22,2018,3,27,Tuesday
11,24,13,37,2017,2,25,Saturday
12,46,-21,25,2017,11,24,Friday
1,19,8,27,2017,10,25,Wednseday
2,16,10,26,2018,5,16,Wednseday
0,6,21,27,2018,1,30,Tuesday
3,7,18,25,2018,7,6,Friday
6,26,-5,21,2018,3,2,Friday
1,3,13,16,2017,12,4,Monday
0,13,38,51,2017,1,18,Wednseday
3,7,16,23,2018,6,11,Monday
4,7,7,14,2017,11,23,Thursday
6,28,8,36,2017,10,31,Tuesday
34,36,6,42,2018,6,28,Thursday
3,11,27,38,2018,1,23,Tuesday
6,17,16,33,2017,6,2,Friday
0,2,6,8,2018,8,15,Wednseday
1,5,20,25,2017,8,6,Sunday
2,7,8,15,2018,8,8,Wednseday
2,12,11,23,2018,3,4,Sunday
3,21,13,34,2018,1,12,Friday
4,16,23,39,2017,2,16,Thursday
1,26,15,41,2018,1,9,Tuesday
1,9,21,30,2018,6,20,Wednseday
4,17,8,25,2017,11,10,Friday
0,2,10,12,2018,5,17,Thursday
1,13,11,24,2018,5,15,Tuesday
5,8,9,17,2018,2,16,Friday
1,14,16,30,2017,11,6,Monday
2,6,23,29,2018,1,3,Wednseday
1,9,30,39,2018,6,4,Monday
3,5,9,14,2018,7,20,Friday
1,8,12,20,2018,3,21,Wednseday
1,16,19,35,2018,6,11,Monday
1,9,15,24,2018,2,19,Monday
7,14,14,28,2017,11,29,Wednseday
8,9,21,30,2018,1,8,Monday
0,5,15,20,2017,10,19,Thursday
4,7,7,14,2017,11,24,Friday
1,5,7,12,2017,11,22,Wednseday
3,8,15,23,2017,10,8,Sunday
3,11,13,24,2017,11,24,Friday
2,22,1,23,2018,5,14,Monday
1,43,-20,23,2018,1,29,Monday
1,7,21,28,2017,4,11,Tuesday
6,6,17,23,2017,6,10,Saturday
3,4,12,16,2018,7,28,Saturday
6,13,27,40,2017,9,27,Wednseday
3,9,12,21,2017,5,29,Monday
1,22,13,35,2017,5,25,Thursday
7,50,-26,24,2018,2,16,Friday
5,16,6,22,2017,11,9,Thursday
1,3,28,31,2018,5,13,Sunday
0,9,20,29,2017,2,21,Tuesday
8,18,6,24,2018,1,29,Monday
2,15,14,29,2017,11,14,Tuesday
2,18,0,18,2017,4,23,Sunday
2,6,14,20,2017,7,18,Tuesday
1,9,8,17,2017,10,1,Sunday
12,25,8,33,2017,11,24,Friday
4,10,14,24,2018,1,21,Sunday
1,4,10,14,2018,8,13,Monday
6,34,2,36,2017,12,13,Wednseday
3,39,-11,28,2018,3,19,Monday
1,8,10,18,2018,4,9,Monday
4,15,6,21,2018,2,23,Friday
3,16,7,23,2017,11,26,Sunday
2,19,11,30,2018,1,6,Saturday
1,24,10,34,2018,1,12,Friday
8,12,11,23,2018,1,24,Wednseday
2,10,14,24,2018,1,28,Sunday
1,7,11,18,2017,9,4,Monday
3,9,21,30,2018,4,21,Saturday
3,19,14,33,2018,5,19,Saturday
4,5,8,13,2017,8,19,Saturday
2,16,15,31,2017,12,18,Monday
2,13,17,30,2018,5,8,Tuesday
6,22,2,24,2018,1,30,Tuesday
3,14,26,40,2018,8,3,Friday
5,9,11,20,2017,9,6,Wednseday
5,24,1,25,2017,4,28,Friday
3,11,2,13,2018,8,14,Tuesday
2,26,11,37,2018,5,27,Sunday
5,12,16,28,2017,8,2,Wednseday
3,4,6,10,2018,7,21,Saturday
5,10,9,19,2017,11,17,Friday
5,17,9,26,2018,3,3,Saturday
2,7,13,20,2017,11,14,Tuesday
6,15,6,21,2018,2,28,Wednseday
1,15,16,31,2018,2,6,Tuesday
0,5,9,14,2018,8,15,Wednseday
1,13,10,23,2017,6,6,Tuesday
5,13,20,33,2018,1,13,Saturday
5,8,25,33,2017,4,19,Wednseday
5,27,7,34,2018,1,6,Saturday
13,26,1,27,2017,11,2,Thursday
2,12,17,29,2017,2,22,Wednseday
4,39,-15,24,2018,2,23,Friday
4,11,17,28,2018,1,22,Monday
1,7,21,28,2018,2,1,Thursday
2,10,11,21,2018,2,26,Monday
1,6,18,24,2017,12,12,Tuesday
5,10,14,24,2018,5,4,Friday
11,15,18,33,2018,6,28,Thursday
1,3,17,20,2018,7,3,Tuesday
2,6,21,27,2018,8,18,Saturday
2,3,11,14,2018,2,21,Wednseday
2,14,16,30,2017,6,12,Monday
1,9,34,43,2018,6,6,Wednseday
6,15,9,24,2017,10,10,Tuesday
7,21,-2,19,2018,5,16,Wednseday
1,2,6,8,2018,7,11,Wednseday
1,14,9,23,2017,9,26,Tuesday
1,6,8,14,2018,8,23,Thursday
9,14,24,38,2018,3,13,Tuesday
1,2,5,7,2018,8,6,Monday
1,12,7,19,2018,3,1,Thursday
1,12,17,29,2017,8,10,Thursday
5,14,12,26,2018,1,12,Friday
2,5,28,33,2017,5,27,Saturday
2,9,23,32,2017,9,23,Saturday
2,12,48,60,2017,11,25,Saturday
2,3,13,16,2018,7,3,Tuesday
6,25,-1,24,2017,11,17,Friday
1,5,27,32,2017,4,6,Thursday
0,5,10,15,2018,7,18,Wednseday
3,9,14,23,2018,1,14,Sunday
1,7,19,26,2018,4,11,Wednseday
3,7,17,24,2018,6,22,Friday
1,14,14,28,2018,3,15,Thursday
2,16,10,26,2018,8,1,Wednseday
11,12,20,32,2018,5,21,Monday
4,7,19,26,2017,7,22,Saturday
6,13,24,37,2018,1,23,Tuesday
4,20,22,42,2018,4,20,Friday
5,14,15,29,2017,5,10,Wednseday
2,8,11,19,2017,8,27,Sunday
34,39,21,60,2018,1,6,Saturday
3,32,-10,22,2018,3,4,Sunday
6,11,17,28,2017,8,17,Thursday
3,4,2,6,2018,8,10,Friday
5,11,14,25,2017,5,4,Thursday
2,16,3,19,2018,4,1,Sunday
3,6,13,19,2018,5,18,Friday
1,14,12,26,2017,11,2,Thursday
1,2,8,10,2018,4,2,Monday
4,15,10,25,2017,9,29,Friday
2,15,15,30,2018,2,5,Monday
1,14,11,25,2018,5,24,Thursday
2,8,13,21,2018,1,17,Wednseday
4,30,11,41,2017,2,18,Saturday
1,22,7,29,2018,2,13,Tuesday
2,8,9,17,2018,8,6,Monday
4,11,18,29,2017,10,26,Thursday
3,22,6,28,2017,12,12,Tuesday
3,6,14,20,2017,7,22,Saturday
2,3,7,10,2018,3,19,Monday
11,38,0,38,2018,4,27,Friday
7,10,8,18,2018,4,30,Monday
2,38,9,47,2017,8,12,Saturday
3,17,3,20,2017,11,24,Friday
1,6,22,28,2018,4,26,Thursday
10,17,4,21,2017,5,5,Friday
2,15,14,29,2017,11,14,Tuesday
1,6,8,14,2018,8,1,Wednseday
2,10,13,23,2017,9,6,Wednseday
2,23,11,34,2017,12,12,Tuesday
1,12,10,22,2017,8,30,Wednseday
1,4,26,30,2017,4,23,Sunday
1,12,9,21,2018,5,9,Wednseday
4,7,0,7,2018,8,9,Thursday
8,11,20,31,2018,7,15,Sunday
4,25,2,27,2017,11,25,Saturday
1,16,15,31,2017,9,24,Sunday
9,13,14,27,2017,9,9,Saturday
0,20,-1,19,2018,5,3,Thursday
0,11,4,15,2018,8,14,Tuesday
7,10,6,16,2018,8,20,Monday
1,4,25,29,2017,2,9,Thursday
1,12,18,30,2018,2,7,Wednseday
1,15,13,28,2018,1,25,Thursday
2,14,17,31,2018,4,16,Monday
2,7,23,30,2017,10,18,Wednseday
4,23,14,37,2017,12,16,Saturday
1,28,7,35,2018,4,9,Monday
2,9,18,27,2018,3,24,Saturday
2,10,17,27,2018,1,27,Saturday
1,8,12,20,2017,6,20,Tuesday
23,30,-5,25,2018,7,8,Sunday
0,8,19,27,2017,9,5,Tuesday
1,11,11,22,2017,9,4,Monday
19,25,0,25,2017,12,1,Friday
3,43,-11,32,2018,3,12,Monday
1,4,18,22,2017,7,13,Thursday
1,11,7,18,2018,6,10,Sunday
0,5,36,41,2017,1,11,Wednseday
3,7,14,21,2018,1,16,Tuesday
3,11,10,21,2017,11,13,Monday
1,6,20,26,2017,5,18,Thursday
1,4,13,17,2017,12,3,Sunday
2,3,13,16,2018,5,5,Saturday
1,9,24,33,2018,8,8,Wednseday
1,5,9,14,2018,2,21,Wednseday
8,15,12,27,2018,8,15,Wednseday
1,6,19,25,2018,6,28,Thursday
3,15,21,36,2018,7,8,Sunday
1,6,17,23,2018,6,19,Tuesday
2,6,10,16,2018,1,31,Wednseday
9,14,23,37,2017,1,31,Tuesday
1,5,15,20,2018,2,20,Tuesday
3,23,6,29,2017,12,12,Tuesday
2,5,15,20,2018,8,25,Saturday
1,2,8,10,2018,4,9,Monday
5,10,15,25,2018,4,20,Friday
3,14,9,23,2018,4,30,Monday
2,8,2,10,2018,7,30,Monday
2,5,5,10,2018,8,4,Saturday
1,7,15,22,2017,7,19,Wednseday
1,20,0,20,2018,2,21,Wednseday
4,15,11,26,2018,7,26,Thursday
2,11,14,25,2018,4,2,Monday
1,8,21,29,2018,1,8,Monday
6,25,15,40,2017,11,24,Friday
6,16,14,30,2017,11,1,Wednseday
3,16,10,26,2017,12,10,Sunday
2,8,14,22,2017,5,17,Wednseday
4,8,14,22,2017,2,26,Sunday
1,11,17,28,2017,7,25,Tuesday
3,19,13,32,2018,1,5,Friday
4,5,13,18,2018,1,5,Friday
2,24,6,30,2017,11,26,Sunday
3,14,8,22,2017,3,28,Tuesday
4,12,21,33,2018,5,5,Saturday
2,11,12,23,2018,2,14,Wednseday
6,34,-2,32,2018,1,19,Friday
1,21,13,34,2018,1,18,Thursday
2,33,-6,27,2017,11,18,Saturday
2,9,26,35,2017,10,30,Monday
2,4,28,32,2018,7,1,Sunday
1,3,21,24,2018,6,4,Monday
1,8,28,36,2018,6,5,Tuesday
1,12,19,31,2017,7,17,Monday
1,10,13,23,2018,7,24,Tuesday
1,2,22,24,2018,6,5,Tuesday
1,11,24,35,2017,11,21,Tuesday
1,2,8,10,2017,9,12,Tuesday
1,12,15,27,2017,9,20,Wednseday
1,8,16,24,2018,7,24,Tuesday
1,9,31,40,2018,1,17,Wednseday
3,12,22,34,2018,2,2,Friday
6,20,10,30,2018,1,27,Saturday
6,15,15,30,2017,7,18,Tuesday
2,13,18,31,2018,1,6,Saturday
4,12,12,24,2017,11,12,Sunday
1,13,20,33,2017,6,1,Thursday
2,18,9,27,2017,9,30,Saturday
1,8,7,15,2018,8,15,Wednseday
4,15,10,25,2017,8,17,Thursday
4,10,14,24,2018,1,27,Saturday
4,10,13,23,2017,11,12,Sunday
0,4,4,8,2018,8,9,Thursday
12,26,17,43,2017,5,24,Wednseday
1,14,26,40,2018,6,6,Wednseday
1,13,15,28,2017,12,21,Thursday
5,12,13,25,2018,2,24,Saturday
4,24,11,35,2017,9,25,Monday
1,5,20,25,2018,6,28,Thursday
3,4,13,17,2018,4,7,Saturday
5,10,15,25,2017,12,1,Friday
1,16,8,24,2018,1,29,Monday
4,10,15,25,2018,4,8,Sunday
3,12,20,32,2017,5,26,Friday
8,6,15,21,2017,3,22,Wednseday
2,9,16,25,2017,9,2,Saturday
3,4,4,8,2018,7,23,Monday
2,15,-5,10,2018,6,19,Tuesday
6,14,14,28,2017,6,13,Tuesday
1,6,7,13,2017,11,16,Thursday
7,24,-1,23,2018,5,9,Wednseday
3,10,13,23,2017,7,16,Sunday
2,10,31,41,2018,6,2,Saturday
1,3,14,17,2018,4,29,Sunday
6,8,15,23,2017,4,5,Wednseday
5,18,10,28,2018,4,6,Friday
1,7,12,19,2017,11,16,Thursday
1,8,33,41,2018,5,9,Wednseday
10,17,23,40,2017,10,27,Friday
4,11,10,21,2017,8,11,Friday
5,10,9,19,2018,4,13,Friday
1,9,26,35,2017,3,21,Tuesday
2,13,13,26,2017,11,1,Wednseday
2,10,17,27,2018,4,7,Saturday
1,19,1,20,2018,2,15,Thursday
4,14,23,37,2017,3,11,Saturday
0,9,17,26,2018,4,26,Thursday
2,9,14,23,2018,1,28,Sunday
3,13,13,26,2018,1,10,Wednseday
2,10,20,30,2017,12,18,Monday
5,12,12,24,2017,9,9,Saturday
7,17,19,36,2018,5,29,Tuesday
0,13,26,39,2017,12,21,Thursday
2,12,17,29,2018,5,23,Wednseday
4,36,-8,28,2018,1,11,Thursday
0,1,13,14,2017,11,27,Monday
2,19,12,31,2017,12,9,Saturday
4,7,18,25,2018,4,9,Monday
1,8,8,16,2018,8,15,Wednseday
3,18,12,30,2017,12,16,Saturday
3,11,18,29,2018,3,26,Monday
1,5,6,11,2018,7,26,Thursday
2,8,20,28,2018,1,23,Tuesday
2,5,9,14,2018,2,15,Thursday
1,23,0,23,2017,5,3,Wednseday
1,7,21,28,2018,7,2,Monday
3,7,12,19,2017,9,1,Friday
2,17,7,24,2018,2,27,Tuesday
0,13,11,24,2018,1,9,Tuesday
4,39,-19,20,2018,3,9,Friday
4,8,24,32,2017,9,28,Thursday
2,3,13,16,2017,5,21,Sunday
1,16,9,25,2017,3,9,Thursday
2,7,12,19,2017,9,6,Wednseday
1,5,6,11,2018,8,20,Monday
3,11,13,24,2017,4,21,Friday
7,8,0,8,2018,8,22,Wednseday
0,9,23,32,2018,5,28,Monday
3,13,11,24,2017,11,28,Tuesday
2,9,20,29,2018,4,8,Sunday
3,9,31,40,2018,4,14,Saturday
6,16,8,24,2017,10,3,Tuesday
3,11,22,33,2018,6,8,Friday
8,14,15,29,2018,7,9,Monday
2,8,16,24,2017,7,11,Tuesday
5,8,43,51,2016,10,10,Monday
2,27,-4,23,2018,4,25,Wednseday
1,6,14,20,2017,10,24,Tuesday
2,19,0,19,2018,3,31,Saturday
2,7,23,30,2018,4,23,Monday
0,6,16,22,2018,2,21,Wednseday
3,12,22,34,2018,1,12,Friday
1,8,15,23,2018,5,2,Wednseday
1,9,16,25,2017,6,12,Monday
2,10,3,13,2018,3,27,Tuesday
2,4,13,17,2017,12,3,Sunday
3,7,17,24,2017,11,24,Friday
7,32,-8,24,2017,11,20,Monday
5,7,13,20,2017,12,28,Thursday
1,27,-8,19,2017,11,22,Wednseday
2,6,12,18,2017,9,16,Saturday
2,11,15,26,2018,4,8,Sunday
1,17,22,39,2017,2,12,Sunday
0,24,4,28,2018,1,23,Tuesday
4,5,6,11,2018,8,18,Saturday
15,37,-11,26,2018,3,1,Thursday
6,15,11,26,2017,11,1,Wednseday
6,11,14,25,2018,7,20,Friday
2,3,7,10,2018,6,10,Sunday
1,11,13,24,2017,7,10,Monday
5,13,21,34,2017,11,16,Thursday
1,15,13,28,2018,2,5,Monday
2,3,13,16,2018,1,30,Tuesday
3,10,12,22,2017,5,23,Tuesday
1,4,14,18,2017,8,7,Monday
4,10,28,38,2017,12,3,Sunday
1,13,16,29,2018,2,7,Wednseday
1,7,21,28,2017,7,12,Wednseday
4,7,14,21,2017,8,24,Thursday
5,11,8,19,2017,11,19,Sunday
1,7,18,25,2017,6,5,Monday
3,17,15,32,2018,4,6,Friday
5,11,17,28,2018,1,4,Thursday
4,11,16,27,2017,8,18,Friday
1,20,6,26,2017,8,9,Wednseday
2,3,9,12,2018,6,13,Wednseday
6,8,10,18,2018,3,1,Thursday
2,40,-21,19,2017,5,14,Sunday
1,10,12,22,2017,11,20,Monday
3,29,1,30,2017,7,11,Tuesday
2,9,13,22,2017,10,18,Wednseday
1,43,-25,18,2018,3,4,Sunday
1,9,7,16,2018,3,6,Tuesday
6,7,9,16,2018,7,4,Wednseday
4,5,9,14,2018,8,16,Thursday
1,12,3,15,2017,9,13,Wednseday
2,8,21,29,2018,7,4,Wednseday
2,15,10,25,2017,2,6,Monday
2,37,-4,33,2018,4,7,Saturday
2,8,24,32,2017,7,24,Monday
3,30,6,36,2017,12,4,Monday
1,8,14,22,2018,2,13,Tuesday
4,5,9,14,2017,6,9,Friday
5,12,21,33,2017,10,6,Friday
2,7,16,23,2017,5,30,Tuesday
2,8,10,18,2018,5,6,Sunday
6,35,-2,33,2018,1,3,Wednseday
7,9,9,18,2017,9,28,Thursday
2,9,14,23,2018,1,17,Wednseday
2,11,14,25,2018,2,17,Saturday
8,20,13,33,2018,2,8,Thursday
5,26,5,31,2017,11,25,Saturday
1,16,14,30,2018,5,21,Monday
1,5,26,31,2018,6,11,Monday
2,4,12,16,2017,7,26,Wednseday
1,18,14,32,2017,10,5,Thursday
0,1,8,9,2018,6,11,Monday
4,10,20,30,2018,6,16,Saturday
5,15,13,28,2017,11,6,Monday
4,10,8,18,2017,11,13,Monday
1,8,14,22,2018,2,14,Wednseday
2,10,27,37,2018,6,6,Wednseday
4,25,8,33,2018,2,23,Friday
2,9,16,25,2017,12,2,Saturday
2,12,14,26,2018,2,14,Wednseday
4,17,16,33,2017,5,5,Friday
7,19,13,32,2017,11,10,Friday
2,7,21,28,2018,8,14,Tuesday
2,15,10,25,2018,8,12,Sunday
1,7,15,22,2017,7,18,Tuesday
4,17,16,33,2017,4,9,Sunday
6,7,3,10,2018,8,7,Tuesday
5,13,12,25,2017,2,25,Saturday
6,20,22,42,2017,8,17,Thursday
1,9,24,33,2018,5,3,Thursday
4,9,12,21,2018,7,19,Thursday
2,10,21,31,2018,1,23,Tuesday
4,6,14,20,2018,6,22,Friday
2,11,10,21,2018,6,25,Monday
1,20,2,22,2018,7,18,Wednseday
9,13,9,22,2018,2,13,Tuesday
2,12,18,30,2017,11,12,Sunday
2,34,-15,19,2018,2,18,Sunday
3,14,8,22,2018,5,13,Sunday
2,8,-1,7,2018,8,15,Wednseday
2,8,28,36,2017,4,10,Monday
1,6,13,19,2017,4,26,Wednseday
2,6,18,24,2017,7,29,Saturday
6,10,10,20,2018,8,7,Tuesday
3,7,25,32,2018,5,12,Saturday
4,13,19,32,2017,7,28,Friday
4,23,1,24,2017,11,25,Saturday
2,10,13,23,2017,5,21,Sunday
1,8,17,25,2017,5,4,Thursday
2,4,10,14,2017,11,20,Monday
1,20,13,33,2017,2,2,Thursday
6,7,0,7,2018,8,10,Friday
3,5,8,13,2017,7,14,Friday
5,12,12,24,2017,7,14,Friday
9,16,1,17,2018,3,4,Sunday
2,9,8,17,2018,3,26,Monday
1,10,13,23,2018,2,7,Wednseday
2,17,15,32,2018,1,8,Monday
4,13,18,31,2017,7,8,Saturday
1,23,6,29,2017,3,19,Sunday
2,5,5,10,2018,8,11,Saturday
1,8,13,21,2018,7,26,Thursday
1,12,10,22,2017,6,22,Thursday
2,8,24,32,2017,4,30,Sunday
2,8,15,23,2017,1,31,Tuesday
2,16,15,31,2018,6,24,Sunday
1,3,25,28,2017,3,21,Tuesday
3,4,9,13,2018,3,24,Saturday
2,14,6,20,2018,3,21,Wednseday
1,8,17,25,2017,6,1,Thursday
1,13,10,23,2017,6,6,Tuesday
4,8,31,39,2017,1,20,Friday
1,23,-3,20,2018,2,22,Thursday
4,15,27,42,2018,6,15,Friday
1,7,27,34,2017,8,2,Wednseday
2,30,-1,29,2017,8,21,Monday
2,36,-6,30,2017,7,19,Wednseday
7,20,7,27,2018,3,28,Wednseday
1,11,11,22,2017,11,30,Thursday
6,11,7,18,2017,11,30,Thursday
2,13,20,33,2017,12,24,Sunday
4,8,12,20,2017,11,16,Thursday
1,17,6,23,2017,6,18,Sunday
1,6,6,12,2018,8,2,Thursday
1,7,17,24,2017,10,10,Tuesday
1,3,18,21,2017,6,5,Monday
2,11,18,29,2017,12,18,Monday
2,8,14,22,2017,4,10,Monday
2,4,15,19,2017,5,21,Sunday
2,3,9,12,2017,10,29,Sunday
12,23,13,36,2017,2,19,Sunday
3,15,10,25,2017,11,24,Friday
0,5,21,26,2017,5,26,Friday
6,20,3,23,2018,3,21,Wednseday
4,4,8,12,2018,3,31,Saturday
0,6,25,31,2018,5,28,Monday
0,5,18,23,2018,4,11,Wednseday
1,4,7,11,2017,5,15,Monday
2,86,-50,36,2017,12,6,Wednseday
2,5,4,9,2018,8,22,Wednseday
4,6,12,18,2018,6,8,Friday
3,13,14,27,2017,11,24,Friday
1,11,8,19,2018,5,10,Thursday
0,6,23,29,2017,9,28,Thursday
0,15,16,31,2018,6,4,Monday
1,30,-5,25,2018,4,16,Monday
2,4,14,18,2017,3,6,Monday
4,21,11,32,2018,2,18,Sunday
5,12,16,28,2018,4,25,Wednseday
5,17,1,18,2017,7,14,Friday
2,3,8,11,2018,7,8,Sunday
1,9,13,22,2017,7,25,Tuesday
1,11,17,28,2018,5,7,Monday
8,8,12,20,2018,2,28,Wednseday
0,13,20,33,2018,6,22,Friday
1,14,20,34,2017,4,18,Tuesday
4,6,20,26,2018,6,21,Thursday
7,21,7,28,2018,2,12,Monday
2,3,12,15,2017,6,11,Sunday
2,3,0,3,2018,8,7,Tuesday
3,10,21,31,2018,5,12,Saturday
0,1,4,5,2018,8,1,Wednseday
5,12,11,23,2017,6,7,Wednseday
1,21,1,22,2018,2,28,Wednseday
18,21,5,26,2017,7,27,Thursday
8,21,28,49,2017,2,8,Wednseday
2,14,11,25,2017,6,3,Saturday
4,9,22,31,2018,6,24,Sunday
1,15,11,26,2018,5,24,Thursday
1,7,12,19,2018,5,10,Thursday
4,26,7,33,2017,2,16,Thursday
3,17,11,28,2017,8,1,Tuesday
3,9,15,24,2018,2,27,Tuesday
2,9,14,23,2018,8,14,Tuesday
2,21,13,34,2018,1,17,Wednseday
8,22,8,30,2018,4,16,Monday
6,14,13,27,2017,5,30,Tuesday
10,35,-2,33,2017,12,1,Friday
2,7,14,21,2018,2,13,Tuesday
2,12,12,24,2017,8,12,Saturday
2,49,-27,22,2018,2,28,Wednseday
3,10,21,31,2018,8,13,Monday
6,15,8,23,2018,4,11,Wednseday
14,26,6,32,2018,4,19,Thursday
6,10,39,49,2018,7,3,Tuesday
4,8,-5,3,2018,8,6,Monday
1,8,35,43,2018,4,22,Sunday
2,5,7,12,2017,9,16,Saturday
2,4,14,18,2017,8,27,Sunday
1,6,7,13,2017,9,5,Tuesday
3,6,12,18,2018,6,30,Saturday
6,16,5,21,2017,11,1,Wednseday
6,7,7,14,2018,2,21,Wednseday
1,9,28,37,2018,3,26,Monday
1,25,-1,24,2018,1,29,Monday
3,18,14,32,2018,6,22,Friday
5,6,6,12,2018,6,14,Thursday
21,29,-2,27,2018,7,12,Thursday
3,35,0,35,2018,4,20,Friday
4,8,11,19,2018,8,2,Thursday
4,9,15,24,2018,8,5,Sunday
3,6,18,24,2017,6,17,Saturday
4,18,-1,17,2018,8,11,Saturday
1,6,15,21,2017,3,9,Thursday
1,6,20,26,2018,6,28,Thursday
5,12,20,32,2017,5,19,Friday
1,34,7,41,2018,4,11,Wednseday
10,19,6,25,2018,2,24,Saturday
3,6,13,19,2018,7,7,Saturday
8,19,23,42,2017,6,14,Wednseday
15,20,15,35,2018,5,24,Thursday
4,14,28,42,2018,6,7,Thursday
1,6,16,22,2018,5,10,Thursday
6,17,-3,14,2018,8,1,Wednseday
8,14,7,21,2018,8,15,Wednseday
1,7,17,24,2018,4,10,Tuesday
2,9,17,26,2017,12,2,Saturday
1,14,15,29,2018,2,8,Thursday
1,7,17,24,2018,7,24,Tuesday
1,8,12,20,2017,7,26,Wednseday
8,29,-4,25,2018,2,22,Thursday
1,11,18,29,2017,2,9,Thursday
0,1,9,10,2018,3,6,Tuesday
3,24,-6,18,2018,3,5,Monday
3,18,14,32,2017,12,1,Friday
2,15,13,28,2018,4,24,Tuesday
6,12,23,35,2018,5,10,Thursday
1,6,17,23,2018,4,10,Tuesday
4,7,18,25,2018,8,17,Friday
3,9,17,26,2018,6,24,Sunday
4,11,14,25,2018,8,11,Saturday
4,10,8,18,2017,9,18,Monday
1,2,27,29,2017,1,31,Tuesday
3,11,10,21,2017,9,18,Monday
4,6,11,17,2017,7,8,Saturday
0,2,12,14,2018,7,11,Wednseday
1,7,4,11,2018,8,6,Monday
2,12,9,21,2017,3,8,Wednseday
9,15,-1,14,2017,11,13,Monday
3,7,8,15,2017,11,26,Sunday
1,9,14,23,2017,3,5,Sunday
10,14,20,34,2018,5,18,Friday
2,8,37,45,2018,6,10,Sunday
4,14,9,23,2017,4,3,Monday
4,6,14,20,2017,11,24,Friday
4,7,13,20,2018,2,23,Friday
5,19,13,32,2017,11,24,Friday
2,3,8,11,2017,11,20,Monday
3,8,14,22,2017,9,5,Tuesday
1,3,23,26,2017,9,24,Sunday
0,8,25,33,2017,10,5,Thursday
2,8,10,18,2018,3,25,Sunday
6,23,5,28,2018,1,23,Tuesday
1,13,8,21,2017,3,13,Monday
8,17,6,23,2017,9,17,Sunday
1,8,15,23,2018,7,18,Wednseday
1,9,34,43,2018,6,5,Tuesday
1,10,12,22,2017,5,23,Tuesday
1,8,11,19,2017,8,27,Sunday
3,15,7,22,2018,4,11,Wednseday
3,16,11,27,2018,2,2,Friday
6,24,-1,23,2018,3,4,Sunday
1,2,11,13,2017,8,22,Tuesday
2,6,19,25,2017,9,30,Saturday
0,4,11,15,2018,8,13,Monday
5,15,11,26,2017,11,9,Thursday
5,10,22,32,2017,3,24,Friday
1,2,11,13,2017,10,24,Tuesday
10,24,3,27,2017,11,14,Tuesday
1,8,19,27,2017,5,25,Thursday
2,9,18,27,2017,8,1,Tuesday
3,5,8,13,2017,10,21,Saturday
3,7,18,25,2018,6,29,Friday
5,12,21,33,2017,12,15,Friday
2,6,6,12,2018,8,11,Saturday
0,1,13,14,2018,5,2,Wednseday
2,11,17,28,2017,7,24,Monday
1,31,0,31,2018,1,23,Tuesday
1,11,31,42,2018,6,14,Thursday
8,11,11,22,2017,8,20,Sunday
3,6,26,32,2017,9,23,Saturday
0,2,9,11,2018,7,23,Monday
26,33,-11,22,2018,7,5,Thursday
4,11,24,35,2017,10,5,Thursday
1,11,12,23,2017,6,5,Monday
5,14,25,39,2018,6,28,Thursday
2,18,8,26,2017,12,17,Sunday
2,16,22,38,2018,3,3,Saturday
2,9,16,25,2018,3,18,Sunday
4,8,17,25,2018,4,22,Sunday
1,14,21,35,2017,8,14,Monday
1,4,9,13,2017,8,24,Thursday
1,13,28,41,2017,2,8,Wednseday
5,12,9,21,2018,2,22,Thursday
2,35,-7,28,2017,9,12,Tuesday
7,13,19,32,2017,11,3,Friday
4,13,20,33,2017,8,24,Thursday
4,8,21,29,2017,5,22,Monday
2,24,-3,21,2017,11,21,Tuesday
1,4,19,23,2018,4,23,Monday
1,15,18,33,2017,5,17,Wednseday
1,6,34,40,2018,5,9,Wednseday
5,8,5,13,2017,8,17,Thursday
1,8,12,20,2017,11,16,Thursday
1,16,19,35,2017,11,29,Wednseday
2,5,21,26,2017,2,19,Sunday
1,9,14,23,2018,1,22,Monday
10,20,14,34,2017,8,1,Tuesday
5,12,6,18,2018,5,10,Thursday
5,22,3,25,2017,10,13,Friday
1,7,13,20,2017,7,12,Wednseday
1,2,13,15,2017,7,18,Tuesday
2,10,15,25,2017,10,9,Monday
2,3,7,10,2018,6,10,Sunday
2,7,3,10,2018,4,9,Monday
1,2,10,12,2017,11,5,Sunday
4,7,11,18,2018,8,17,Friday
1,4,6,10,2018,8,5,Sunday
6,21,6,27,2017,10,3,Tuesday
1,6,14,20,2018,3,27,Tuesday
3,13,18,31,2017,2,18,Saturday
2,9,13,22,2018,7,29,Sunday
1,8,24,32,2018,6,3,Sunday
2,7,15,22,2017,5,22,Monday
4,11,14,25,2017,12,30,Saturday
4,7,17,24,2018,8,3,Friday
19,28,-9,19,2018,2,28,Wednseday
3,22,5,27,2018,2,27,Tuesday
1,6,14,20,2017,11,28,Tuesday
1,8,11,19,2017,11,12,Sunday
7,16,15,31,2017,11,28,Tuesday
2,8,22,30,2017,5,28,Sunday
9,28,-6,22,2018,3,5,Monday
17,20,19,39,2017,2,3,Friday
1,5,14,19,2017,6,18,Sunday
1,7,7,14,2018,8,9,Thursday
1,6,7,13,2018,8,1,Wednseday
3,10,20,30,2018,6,19,Tuesday
0,7,16,23,2018,8,14,Tuesday
2,9,9,18,2018,3,3,Saturday
5,11,15,26,2017,6,15,Thursday
6,20,17,37,2018,1,9,Tuesday
10,25,-2,23,2017,12,23,Saturday
1,3,14,17,2018,4,23,Monday
1,16,12,28,2018,4,12,Thursday
2,7,14,21,2017,4,25,Tuesday
1,7,13,20,2018,7,31,Tuesday
2,10,14,24,2017,7,29,Saturday
1,5,8,13,2018,8,23,Thursday
6,20,1,21,2018,3,15,Thursday
7,14,10,24,2017,2,28,Tuesday
5,5,22,27,2018,3,30,Friday
4,11,9,20,2018,7,27,Friday
1,13,11,24,2018,1,23,Tuesday
6,23,-1,22,2018,1,16,Tuesday
1,15,20,35,2017,12,4,Monday
14,36,8,44,2018,2,6,Tuesday
7,10,27,37,2017,2,13,Monday
1,16,1,17,2018,5,20,Sunday
2,15,23,38,2018,6,18,Monday
4,16,8,24,2017,5,20,Saturday
1,11,32,43,2017,3,27,Monday
3,6,6,12,2018,8,10,Friday
7,15,21,36,2018,1,11,Thursday
3,14,26,40,2018,6,1,Friday
1,3,11,14,2018,7,30,Monday
3,7,19,26,2018,6,16,Saturday
0,11,27,38,2018,5,28,Monday
1,5,28,33,2018,6,20,Wednseday
14,26,-5,21,2017,4,6,Thursday
1,4,14,18,2017,7,31,Monday
1,26,1,27,2017,8,24,Thursday
6,20,9,29,2017,11,16,Thursday
1,2,17,19,2017,8,9,Wednseday
2,13,16,29,2018,6,20,Wednseday
4,13,13,26,2017,9,15,Friday
4,32,-2,30,2018,2,10,Saturday
4,15,15,30,2018,2,4,Sunday
3,6,18,24,2017,4,14,Friday
5,8,19,27,2018,4,5,Thursday
2,8,14,22,2018,7,17,Tuesday
1,2,8,10,2018,7,24,Tuesday
3,12,18,30,2018,7,14,Saturday
1,9,19,28,2018,8,8,Wednseday
1,50,-26,24,2017,12,18,Monday
4,16,15,31,2018,7,9,Monday
6,19,7,26,2018,7,18,Wednseday
1,5,8,13,2018,8,9,Thursday
1,5,32,37,2017,1,22,Sunday
6,14,6,20,2017,11,24,Friday
6,43,-11,32,2017,4,14,Friday
3,6,20,26,2018,6,22,Friday
10,17,8,25,2017,4,22,Saturday
9,19,5,24,2017,7,22,Saturday
6,28,3,31,2017,10,10,Tuesday
2,17,13,30,2018,1,20,Saturday
4,12,13,25,2018,6,28,Thursday
3,4,15,19,2018,5,18,Friday
1,24,14,38,2018,2,25,Sunday
35,55,-13,42,2017,12,15,Friday
1,50,-16,34,2018,3,8,Thursday
1,8,18,26,2017,5,11,Thursday
6,10,10,20,2017,11,24,Friday
1,2,6,8,2018,8,20,Monday
0,6,30,36,2018,6,6,Wednseday
5,10,14,24,2017,4,8,Saturday
1,8,14,22,2017,6,28,Wednseday
2,25,8,33,2018,3,11,Sunday
5,10,21,31,2017,5,6,Saturday
3,4,18,22,2017,12,31,Sunday
1,5,12,17,2018,3,4,Sunday
5,8,25,33,2018,4,8,Sunday
1,6,15,21,2017,3,7,Tuesday
1,9,20,29,2018,1,10,Wednseday
7,15,8,23,2018,3,27,Tuesday
8,14,24,38,2018,3,12,Monday
0,6,11,17,2017,3,21,Tuesday
1,7,18,25,2018,7,16,Monday
2,57,-32,25,2017,7,17,Monday
1,6,27,33,2017,4,5,Wednseday
2,7,15,22,2017,9,19,Tuesday
5,22,3,25,2017,11,18,Saturday
1,21,7,28,2018,6,19,Tuesday
2,5,7,12,2018,3,14,Wednseday
1,18,11,29,2018,7,9,Monday
5,10,23,33,2017,12,1,Friday
1,4,26,30,2018,8,26,Sunday
3,20,6,26,2017,11,25,Saturday
2,15,27,42,2017,8,16,Wednseday
2,7,9,16,2018,2,7,Wednseday
1,18,16,34,2018,1,11,Thursday
3,7,14,21,2018,5,7,Monday
2,12,27,39,2018,3,26,Monday
1,2,3,5,2018,8,22,Wednseday
2,3,8,11,2018,6,9,Saturday
2,23,23,46,2018,1,8,Monday
2,19,0,19,2017,11,12,Sunday
3,11,7,18,2017,9,9,Saturday
6,13,13,26,2017,4,28,Friday
1,20,14,34,2017,10,5,Thursday
8,20,2,22,2017,9,19,Tuesday
1,7,7,14,2018,8,15,Wednseday
3,18,23,41,2017,5,6,Saturday
1,10,5,15,2017,5,23,Tuesday
2,3,6,9,2018,8,18,Saturday
3,9,18,27,2018,6,16,Saturday
1,2,3,5,2018,8,8,Wednseday
1,8,25,33,2018,1,31,Wednseday
3,18,16,34,2018,1,13,Saturday
5,13,19,32,2017,12,1,Friday
2,21,0,21,2017,10,16,Monday
1,9,28,37,2018,5,6,Sunday
2,6,12,18,2017,12,10,Sunday
0,1,13,14,2017,8,3,Thursday
1,9,27,36,2017,1,30,Monday
3,12,19,31,2017,11,25,Saturday
3,5,16,21,2018,1,12,Friday
2,14,18,32,2018,1,15,Monday
2,11,13,24,2018,8,11,Saturday
1,4,9,13,2018,3,23,Friday
1,16,10,26,2018,5,2,Wednseday
4,6,32,38,2017,12,23,Saturday
5,18,10,28,2018,3,28,Wednseday
1,3,9,12,2018,3,15,Thursday
4,18,7,25,2017,11,24,Friday
2,4,13,17,2018,4,28,Saturday
4,11,23,34,2017,12,30,Saturday
1,7,28,35,2017,5,16,Tuesday
6,11,10,21,2018,4,26,Thursday
0,5,8,13,2018,2,28,Wednseday
2,7,11,18,2017,10,30,Monday
1,11,11,22,2017,7,13,Thursday
4,7,21,28,2017,4,6,Thursday
2,9,23,32,2017,9,24,Sunday
1,15,13,28,2018,5,10,Thursday
1,2,11,13,2018,8,15,Wednseday
1,6,10,16,2017,9,12,Tuesday
2,16,8,24,2018,5,19,Saturday
3,7,17,24,2018,4,27,Friday
2,3,10,13,2017,10,28,Saturday
6,12,20,32,2017,11,11,Saturday
1,4,18,22,2018,6,21,Thursday
1,2,7,9,2018,7,9,Monday
2,5,20,25,2018,6,18,Monday
2,15,22,37,2018,4,22,Sunday
4,28,-3,25,2018,3,9,Friday
4,11,8,19,2018,5,3,Thursday
3,15,12,27,2018,1,23,Tuesday
1,3,19,22,2017,8,28,Monday
6,14,19,33,2018,2,14,Wednseday
3,41,-10,31,2018,1,16,Tuesday
2,31,-6,25,2017,11,25,Saturday
2,3,15,18,2017,7,23,Sunday
3,22,-5,17,2018,5,12,Saturday
2,9,25,34,2018,7,21,Saturday
6,7,6,13,2018,4,27,Friday
1,4,7,11,2018,8,26,Sunday
4,11,22,33,2018,2,22,Thursday
0,6,15,21,2018,5,16,Wednseday
3,5,11,16,2018,7,7,Saturday
1,2,13,15,2017,7,19,Wednseday
5,7,5,12,2018,5,18,Friday
3,4,12,16,2018,6,10,Sunday
3,14,19,33,2017,6,9,Friday
2,6,15,21,2018,1,11,Thursday
2,12,15,27,2018,1,13,Saturday
1,2,2,4,2018,7,29,Sunday
3,7,11,18,2018,8,18,Saturday
1,15,14,29,2018,4,19,Thursday
1,29,-3,26,2018,2,22,Thursday
3,30,-14,16,2018,1,31,Wednseday
0,10,15,25,2017,6,16,Friday
6,17,6,23,2017,10,18,Wednseday
3,12,12,24,2018,3,30,Friday
3,15,2,17,2017,9,12,Tuesday
2,16,8,24,2018,2,17,Saturday
4,12,10,22,2018,3,29,Thursday
6,12,23,35,2018,1,10,Wednseday
4,10,10,20,2018,3,16,Friday
5,45,-21,24,2017,11,24,Friday
3,5,18,23,2017,7,23,Sunday
11,19,21,40,2017,3,23,Thursday
0,11,14,25,2018,8,9,Thursday
1,10,34,44,2018,5,29,Tuesday
4,13,7,20,2017,6,30,Friday
4,11,16,27,2018,1,5,Friday
1,4,20,24,2018,5,14,Monday
0,6,14,20,2017,11,22,Wednseday
2,6,18,24,2017,9,2,Saturday
2,14,11,25,2018,3,19,Monday
3,7,17,24,2017,12,11,Monday
2,10,13,23,2018,7,17,Tuesday
7,22,5,27,2018,1,3,Wednseday
1,2,12,14,2018,2,26,Monday
2,8,19,27,2017,12,26,Tuesday
4,10,23,33,2018,6,9,Saturday
0,6,21,27,2018,7,27,Friday
1,7,16,23,2018,1,16,Tuesday
8,11,18,29,2017,12,25,Monday
4,9,16,25,2017,9,25,Monday
0,10,9,19,2018,7,27,Friday
7,23,21,44,2018,2,12,Monday
4,19,6,25,2017,2,25,Saturday
5,6,23,29,2017,10,26,Thursday
4,26,3,29,2018,1,4,Thursday
1,6,15,21,2017,9,13,Wednseday
1,9,6,15,2018,8,22,Wednseday
1,3,16,19,2017,7,23,Sunday
2,16,21,37,2018,2,3,Saturday
1,21,1,22,2017,8,28,Monday
2,10,22,32,2017,5,8,Monday
4,15,14,29,2018,3,5,Monday
0,7,15,22,2018,4,12,Thursday
1,2,18,20,2017,6,28,Wednseday
1,16,23,39,2018,3,4,Sunday
12,17,13,30,2018,4,21,Saturday
0,9,26,35,2017,12,18,Monday
1,5,14,19,2017,3,16,Thursday
2,8,30,38,2018,7,29,Sunday
3,8,6,14,2018,3,26,Monday
6,11,13,24,2018,2,9,Friday
1,13,9,22,2017,4,19,Wednseday
1,7,21,28,2017,1,23,Monday
6,19,21,40,2017,4,13,Thursday
3,18,5,23,2018,2,20,Tuesday
1,14,13,27,2018,2,13,Tuesday
3,17,9,26,2018,2,11,Sunday
4,14,18,32,2017,2,9,Thursday
2,8,18,26,2017,6,11,Sunday
1,6,15,21,2018,2,20,Tuesday
2,6,25,31,2017,2,18,Saturday
2,22,1,23,2018,5,19,Saturday
6,14,24,38,2018,3,6,Tuesday
3,17,17,34,2018,1,6,Saturday
1,8,15,23,2018,1,3,Wednseday
0,6,21,27,2018,6,6,Wednseday
2,5,20,25,2018,7,22,Sunday
1,5,17,22,2017,8,2,Wednseday
1,26,6,32,2018,3,25,Sunday
5,10,20,30,2018,4,11,Wednseday
1,8,36,44,2018,7,1,Sunday
1,4,19,23,2018,6,18,Monday
0,12,21,33,2018,2,2,Friday
2,27,6,33,2018,1,31,Wednseday
6,18,10,28,2017,11,3,Friday
7,9,14,23,2018,3,27,Tuesday
1,14,8,22,2018,8,9,Thursday
2,7,23,30,2018,1,1,Monday
1,6,16,22,2017,5,9,Tuesday
3,4,29,33,2018,6,1,Friday
4,11,11,22,2017,11,16,Thursday
1,19,8,27,2017,12,7,Thursday
1,21,-5,16,2018,3,5,Monday
5,11,12,23,2018,2,11,Sunday
3,5,9,14,2017,11,24,Friday
3,18,3,21,2018,3,26,Monday
6,16,4,20,2017,9,5,Tuesday
1,5,23,28,2018,4,23,Monday
6,13,5,18,2017,6,1,Thursday
1,5,9,14,2018,7,25,Wednseday
2,4,28,32,2017,8,19,Saturday
2,15,8,23,2018,3,12,Monday
3,10,28,38,2017,6,2,Friday
1,7,5,12,2018,5,2,Wednseday
16,24,15,39,2017,8,7,Monday
1,16,18,34,2017,3,14,Tuesday
6,9,10,19,2018,3,28,Wednseday
3,12,21,33,2017,11,24,Friday
1,36,-14,22,2018,2,25,Sunday
0,2,25,27,2017,2,8,Wednseday
1,5,14,19,2017,5,21,Sunday
1,7,6,13,2018,3,28,Wednseday
1,3,13,16,2017,12,5,Tuesday
1,2,9,11,2018,6,17,Sunday
7,18,7,25,2017,9,8,Friday
3,16,22,38,2018,1,30,Tuesday
1,6,23,29,2018,6,19,Tuesday
1,8,14,22,2017,6,28,Wednseday
6,10,24,34,2018,1,31,Wednseday
1,8,20,28,2018,1,22,Monday
8,12,15,27,2018,4,11,Wednseday
2,10,21,31,2017,3,25,Saturday
2,6,27,33,2018,1,17,Wednseday
3,12,14,26,2018,3,24,Saturday
2,4,14,18,2017,3,5,Sunday
2,5,18,23,2018,6,23,Saturday
1,13,13,26,2017,10,5,Thursday
1,11,12,23,2017,7,24,Monday
2,30,1,31,2018,2,24,Saturday
2,7,9,16,2018,7,24,Tuesday
3,7,13,20,2017,11,10,Friday
1,6,21,27,2018,8,14,Tuesday
26,32,-4,28,2017,3,23,Thursday
1,7,15,22,2018,5,1,Tuesday
3,7,16,23,2018,5,5,Saturday
1,27,2,29,2018,1,31,Wednseday
3,22,8,30,2017,9,17,Sunday
1,11,11,22,2017,5,1,Monday
1,5,18,23,2017,8,6,Sunday
2,3,14,17,2018,1,7,Sunday
3,7,5,12,2018,3,7,Wednseday
2,15,3,18,2018,3,25,Sunday
1,11,9,20,2018,7,12,Thursday
5,10,14,24,2018,4,29,Sunday
3,9,14,23,2018,2,20,Tuesday
5,25,-5,20,2017,4,21,Friday
4,9,9,18,2018,8,13,Monday
1,9,13,22,2017,8,9,Wednseday
2,5,19,24,2018,7,7,Saturday
11,32,3,35,2018,1,26,Friday
5,6,13,19,2018,1,12,Friday
2,16,6,22,2018,3,6,Tuesday
4,17,-1,16,2017,10,2,Monday
2,10,22,32,2017,3,25,Saturday
2,16,8,24,2018,4,9,Monday
2,14,23,37,2017,5,31,Wednseday
1,2,12,14,2018,7,30,Monday
6,13,15,28,2017,11,1,Wednseday
4,9,15,24,2017,8,19,Saturday
4,9,32,41,2018,6,2,Saturday
1,2,5,7,2018,8,22,Wednseday
3,5,15,20,2018,5,18,Friday
1,9,15,24,2018,6,17,Sunday
12,21,4,25,2018,3,8,Thursday
3,5,7,12,2018,5,12,Saturday
6,14,11,25,2017,11,24,Friday
1,13,19,32,2018,4,5,Thursday
1,6,21,27,2017,2,14,Tuesday
5,15,13,28,2017,9,21,Thursday
1,2,10,12,2018,3,7,Wednseday
2,8,27,35,2017,5,15,Monday
1,6,8,14,2018,7,10,Tuesday
3,9,21,30,2017,4,29,Saturday
5,18,6,24,2017,6,4,Sunday
1,19,11,30,2018,2,4,Sunday
0,7,22,29,2018,6,19,Tuesday
1,10,41,51,2017,1,17,Tuesday
2,5,3,8,2018,8,22,Wednseday
10,11,8,19,2018,6,15,Friday
3,10,23,33,2018,6,22,Friday
4,13,20,33,2018,4,12,Thursday
2,5,8,13,2017,8,23,Wednseday
1,18,10,28,2018,1,1,Monday
3,10,18,28,2018,6,15,Friday
2,10,13,23,2017,4,18,Tuesday
2,17,1,18,2017,9,18,Monday
1,4,11,15,2018,7,22,Sunday
3,11,14,25,2017,2,27,Monday
2,8,14,22,2018,2,26,Monday
1,23,5,28,2017,3,8,Wednseday
6,9,27,36,2018,2,28,Wednseday
0,16,12,28,2017,9,19,Tuesday
5,31,6,37,2017,12,30,Saturday
12,16,34,50,2017,3,5,Sunday
3,4,21,25,2018,6,1,Friday
1,10,42,52,2018,5,27,Sunday
1,6,14,20,2017,10,18,Wednseday
3,20,8,28,2018,8,3,Friday
0,2,4,6,2018,8,28,Tuesday
7,17,13,30,2017,12,11,Monday
1,19,2,21,2018,1,12,Friday
6,14,13,27,2017,5,9,Tuesday
3,9,16,25,2018,6,16,Saturday
1,6,8,14,2018,7,31,Tuesday
6,29,-8,21,2018,2,14,Wednseday
2,4,19,23,2017,8,22,Tuesday
1,5,23,28,2018,5,31,Thursday
1,17,18,35,2018,1,30,Tuesday
1,14,16,30,2017,9,13,Wednseday
4,7,46,53,2016,10,8,Saturday
1,4,24,28,2017,8,14,Monday
3,4,16,20,2017,12,16,Saturday
4,14,11,25,2018,5,4,Friday
2,12,13,25,2018,2,25,Sunday
13,18,0,18,2018,7,26,Thursday
1,12,10,22,2018,2,14,Wednseday
1,3,19,22,2017,11,8,Wednseday
4,6,13,19,2017,11,30,Thursday
1,2,10,12,2017,11,5,Sunday
2,3,12,15,2018,5,20,Sunday
2,19,6,25,2017,4,30,Sunday
3,12,14,26,2018,4,21,Saturday
1,14,8,22,2017,8,31,Thursday
9,18,10,28,2017,10,30,Monday
1,60,-29,31,2018,3,4,Sunday
1,6,14,20,2017,5,18,Thursday
5,32,-2,30,2018,3,18,Sunday
15,56,-22,34,2018,3,1,Thursday
2,6,3,9,2018,8,21,Tuesday
3,13,12,25,2017,10,13,Friday
4,11,16,27,2017,2,2,Thursday
2,6,23,29,2018,1,31,Wednseday
17,21,-4,17,2017,11,20,Monday
4,13,28,41,2017,4,28,Friday
2,13,16,29,2017,11,15,Wednseday
2,12,20,32,2018,5,27,Sunday
4,13,10,23,2017,11,12,Sunday
0,3,17,20,2018,3,23,Friday
8,9,1,10,2017,9,11,Monday
3,12,9,21,2017,11,21,Tuesday
8,13,28,41,2018,6,6,Wednseday
3,4,9,13,2018,4,7,Saturday
4,12,22,34,2018,5,4,Friday
1,14,9,23,2017,5,31,Wednseday
3,9,9,18,2017,7,17,Monday
6,15,7,22,2017,5,18,Thursday
2,23,-2,21,2017,3,1,Wednseday
2,12,13,25,2018,1,7,Sunday
1,2,11,13,2017,10,25,Wednseday
9,13,7,20,2017,10,18,Wednseday
5,10,17,27,2017,6,29,Thursday
1,2,6,8,2018,7,30,Monday
0,13,16,29,2017,12,5,Tuesday
2,27,0,27,2018,3,10,Saturday
10,17,42,59,2018,7,21,Saturday
2,7,13,20,2018,7,18,Wednseday
1,29,-16,13,2017,7,13,Thursday
2,7,10,17,2018,7,17,Tuesday
1,2,19,21,2018,6,27,Wednseday
1,2,25,27,2018,6,6,Wednseday
1,8,9,17,2018,4,8,Sunday
3,22,-3,19,2017,11,26,Sunday
7,23,20,43,2017,4,11,Tuesday
2,13,3,16,2018,8,14,Tuesday
2,25,-7,18,2017,4,23,Sunday
5,29,-2,27,2017,11,22,Wednseday
4,5,11,16,2018,6,9,Saturday
3,8,6,14,2018,8,13,Monday
0,3,19,22,2018,6,19,Tuesday
5,26,-1,25,2017,12,1,Friday
6,16,16,32,2017,10,7,Saturday
1,13,19,32,2018,7,12,Thursday
1,4,18,22,2018,4,16,Monday
2,23,6,29,2018,2,14,Wednseday
7,15,7,22,2017,7,24,Monday
6,12,8,20,2017,11,10,Friday
3,4,9,13,2017,5,26,Friday
1,25,-1,24,2017,10,29,Sunday
1,6,11,17,2017,9,5,Tuesday
5,34,-9,25,2017,11,17,Friday
4,18,7,25,2018,3,3,Saturday
3,9,9,18,2018,4,16,Monday
3,5,9,14,2018,1,26,Friday
3,11,18,29,2018,2,11,Sunday
1,6,14,20,2018,2,15,Thursday
2,9,15,24,2017,3,20,Monday
1,16,4,20,2017,11,23,Thursday
3,5,8,13,2018,3,30,Friday
2,14,15,29,2018,1,24,Wednseday
3,19,12,31,2018,5,20,Sunday
1,21,4,25,2018,4,16,Monday
2,4,0,4,2018,8,20,Monday
2,14,20,34,2017,7,19,Wednseday
1,10,12,22,2017,3,28,Tuesday
1,7,14,21,2017,10,31,Tuesday
10,21,16,37,2018,1,16,Tuesday
1,4,17,21,2017,5,29,Monday
1,5,7,12,2018,3,15,Thursday
1,21,10,31,2017,12,19,Tuesday
5,17,13,30,2018,2,10,Saturday
5,20,18,38,2017,12,16,Saturday
2,17,15,32,2018,4,23,Monday
7,27,9,36,2017,4,18,Tuesday
5,38,-6,32,2017,12,4,Monday
4,17,9,26,2018,2,16,Friday
6,9,26,35,2017,2,7,Tuesday
4,7,8,15,2018,1,15,Monday
7,14,18,32,2017,8,11,Friday
1,4,11,15,2018,7,9,Monday
30,36,-10,26,2017,12,20,Wednseday
2,9,13,22,2017,11,12,Sunday
1,20,0,20,2017,11,23,Thursday
2,6,8,14,2017,11,28,Tuesday
2,12,11,23,2017,8,23,Wednseday
4,21,25,46,2018,6,8,Friday
5,22,5,27,2018,1,25,Thursday
5,6,1,7,2018,8,15,Wednseday
1,17,1,18,2018,3,19,Monday
1,6,15,21,2017,4,6,Thursday
4,11,15,26,2017,12,16,Saturday
7,9,5,14,2018,2,12,Monday
1,4,1,5,2018,8,3,Friday
3,10,47,57,2017,1,30,Monday
6,12,11,23,2017,6,7,Wednseday
1,17,10,27,2018,3,27,Tuesday
1,6,16,22,2018,2,1,Thursday
7,15,7,22,2018,2,8,Thursday
5,8,8,16,2018,4,4,Wednseday
0,4,14,18,2018,7,19,Thursday
1,9,14,23,2017,5,21,Sunday
1,12,10,22,2017,8,9,Wednseday
5,9,10,19,2017,9,6,Wednseday
0,8,18,26,2017,6,14,Wednseday
1,17,-7,10,2017,9,12,Tuesday
1,15,14,29,2018,2,8,Thursday
5,9,39,48,2017,6,24,Saturday
3,4,17,21,2017,6,2,Friday
6,20,18,38,2018,5,19,Saturday
5,14,11,25,2018,3,15,Thursday
2,12,10,22,2017,10,25,Wednseday
9,12,35,47,2018,5,30,Wednseday
3,9,16,25,2017,10,29,Sunday
1,9,23,32,2018,2,5,Monday
1,43,-13,30,2018,3,27,Tuesday
2,12,18,30,2018,2,5,Monday
2,9,15,24,2018,8,18,Saturday
2,8,14,22,2017,3,29,Wednseday
7,12,11,23,2017,11,11,Saturday
4,7,18,25,2017,8,17,Thursday
6,9,15,24,2017,5,13,Saturday
6,10,7,17,2017,9,5,Tuesday
4,13,20,33,2017,8,18,Friday
5,10,18,28,2017,10,6,Friday
3,5,9,14,2017,11,24,Friday
1,8,19,27,2017,2,2,Thursday
5,13,14,27,2017,5,24,Wednseday
3,6,27,33,2017,2,17,Friday
4,12,13,25,2018,3,3,Saturday
1,4,10,14,2018,3,22,Thursday
3,4,15,19,2017,11,18,Saturday
11,18,3,21,2018,7,19,Thursday
4,10,16,26,2017,8,25,Friday
1,2,11,13,2018,8,15,Wednseday
1,3,12,15,2018,1,18,Thursday
3,26,-2,24,2017,5,21,Sunday
1,7,14,21,2018,7,23,Monday
3,5,12,17,2017,10,1,Sunday
4,10,14,24,2018,3,31,Saturday
4,12,12,24,2017,11,25,Saturday
2,9,17,26,2018,4,11,Wednseday
5,18,21,39,2017,7,8,Saturday
4,37,-18,19,2018,3,17,Saturday
1,9,8,17,2018,3,26,Monday
4,6,14,20,2017,3,23,Thursday
7,24,8,32,2017,10,6,Friday
3,11,13,24,2017,5,19,Friday
6,11,16,27,2017,7,14,Friday
4,14,19,33,2018,3,15,Thursday
2,15,2,17,2018,3,6,Tuesday
1,5,23,28,2018,7,4,Wednseday
2,14,16,30,2018,2,6,Tuesday
3,8,10,18,2018,3,18,Sunday
4,13,12,25,2017,4,20,Thursday
2,6,24,30,2018,1,7,Sunday
2,11,15,26,2017,12,9,Saturday
1,14,9,23,2018,2,20,Tuesday
2,25,-1,24,2018,1,21,Sunday
1,2,8,10,2018,6,19,Tuesday
1,13,14,27,2017,1,26,Thursday
2,8,10,18,2017,11,6,Monday
6,18,10,28,2017,5,2,Tuesday
3,9,20,29,2018,2,6,Tuesday
3,24,-1,23,2017,4,24,Monday
2,3,13,16,2018,5,20,Sunday
4,17,14,31,2017,5,26,Friday
1,6,17,23,2017,6,6,Tuesday
4,10,13,23,2018,5,5,Saturday
1,7,15,22,2017,10,3,Tuesday
1,6,21,27,2017,1,5,Thursday
1,6,13,19,2018,8,1,Wednseday
0,1,3,4,2018,7,30,Monday
2,11,11,22,2018,3,20,Tuesday
4,13,9,22,2017,6,22,Thursday
2,10,22,32,2018,7,28,Saturday
1,2,16,18,2017,12,10,Sunday
2,7,23,30,2018,6,16,Saturday
4,11,11,22,2017,11,30,Thursday
3,14,18,32,2018,5,21,Monday
1,2,25,27,2018,6,6,Wednseday
4,23,-3,20,2018,4,7,Saturday
4,5,19,24,2017,5,20,Saturday
4,4,17,21,2018,3,19,Monday
5,6,12,18,2018,4,15,Sunday
3,47,-13,34,2018,5,1,Tuesday
4,10,16,26,2017,12,1,Friday
1,13,2,15,2018,1,17,Wednseday
3,10,16,26,2018,7,14,Saturday
0,9,13,22,2017,10,17,Tuesday
5,36,-13,23,2018,5,13,Sunday
1,20,1,21,2018,5,17,Thursday
4,9,9,18,2018,3,31,Saturday
0,1,13,14,2017,8,17,Thursday
6,10,16,26,2017,9,22,Friday
10,14,12,26,2018,8,10,Friday
7,13,20,33,2017,7,5,Wednseday
1,6,9,15,2018,5,1,Tuesday
1,7,13,20,2017,8,9,Wednseday
4,10,15,25,2018,3,16,Friday
33,39,-18,21,2018,3,2,Friday
2,15,7,22,2017,10,17,Tuesday
5,10,21,31,2017,6,9,Friday
2,11,15,26,2017,12,9,Saturday
1,6,14,20,2017,11,7,Tuesday
1,3,6,9,2018,8,26,Sunday
4,7,5,12,2018,8,18,Saturday
2,7,29,36,2018,5,15,Tuesday
3,13,21,34,2018,2,3,Saturday
2,7,14,21,2018,7,31,Tuesday
4,6,12,18,2017,10,14,Saturday
1,16,5,21,2018,2,27,Tuesday
3,9,17,26,2018,2,11,Sunday
3,15,19,34,2017,12,12,Tuesday
3,9,16,25,2018,1,15,Monday
7,10,-3,7,2018,8,10,Friday
2,10,14,24,2017,11,21,Tuesday
4,16,21,37,2018,2,3,Saturday
0,7,25,32,2018,5,28,Monday
1,15,36,51,2018,6,3,Sunday
0,12,22,34,2018,6,1,Friday
7,9,13,22,2017,9,27,Wednseday
1,2,11,13,2018,6,13,Wednseday
3,10,6,16,2018,7,28,Saturday
1,12,3,15,2018,7,18,Wednseday
4,8,17,25,2018,5,4,Friday
1,31,-9,22,2018,3,25,Sunday
1,11,11,22,2018,4,5,Thursday
2,15,18,33,2017,4,26,Wednseday
1,7,18,25,2018,4,19,Thursday
3,10,43,53,2017,1,27,Friday
1,3,11,14,2018,5,21,Monday
0,3,15,18,2018,4,27,Friday
14,41,41,82,2018,1,10,Wednseday
4,18,-1,17,2018,6,8,Friday
2,3,12,15,2018,2,25,Sunday
1,15,9,24,2017,11,13,Monday
2,5,16,21,2018,2,14,Wednseday
2,3,1,4,2018,7,29,Sunday
4,15,11,26,2017,11,25,Saturday
1,2,20,22,2017,12,13,Wednseday
2,9,11,20,2017,8,1,Tuesday
5,12,9,21,2018,2,15,Thursday
1,4,20,24,2018,1,21,Sunday
1,8,16,24,2018,4,15,Sunday
0,10,10,20,2018,7,20,Friday
1,7,14,21,2018,4,26,Thursday
3,6,25,31,2018,6,29,Friday
1,6,21,27,2018,6,26,Tuesday
6,14,11,25,2017,11,10,Friday
2,5,12,17,2018,4,1,Sunday
1,6,14,20,2018,3,15,Thursday
2,14,9,23,2018,3,26,Monday
0,6,15,21,2018,8,16,Thursday
2,7,22,29,2017,2,7,Tuesday
0,14,12,26,2017,9,29,Friday
5,17,3,20,2017,11,29,Wednseday
6,27,7,34,2017,12,29,Friday
2,10,29,39,2017,2,11,Saturday
1,7,6,13,2018,8,22,Wednseday
2,6,11,17,2018,5,12,Saturday
1,20,14,34,2017,9,26,Tuesday
2,7,16,23,2018,4,30,Monday
0,7,7,14,2018,8,3,Friday
4,14,17,31,2017,2,10,Friday
1,3,11,14,2018,8,27,Monday
2,6,17,23,2017,8,29,Tuesday
1,7,14,21,2017,9,19,Tuesday
5,15,10,25,2017,5,4,Thursday
3,29,-7,22,2017,11,27,Monday
0,19,1,20,2018,3,14,Wednseday
1,7,14,21,2018,4,16,Monday
3,11,9,20,2017,11,11,Saturday
1,7,21,28,2018,6,13,Wednseday
2,8,32,40,2017,1,25,Wednseday
1,8,10,18,2018,6,10,Sunday
1,3,38,41,2017,2,7,Tuesday
11,16,8,24,2017,11,25,Saturday
2,8,49,57,2018,3,4,Sunday
0,6,22,28,2018,8,17,Friday
3,4,12,16,2018,2,24,Saturday
1,2,1,3,2018,8,6,Monday
2,28,-8,20,2018,3,8,Thursday
3,9,15,24,2018,1,27,Saturday
4,8,14,22,2017,6,22,Thursday
2,14,14,28,2018,5,2,Wednseday
1,9,20,29,2018,1,3,Wednseday
1,7,9,16,2018,4,3,Tuesday
1,15,29,44,2018,5,28,Monday
1,9,16,25,2018,2,15,Thursday
2,3,6,9,2018,4,23,Monday
4,7,14,21,2017,3,10,Friday
6,12,13,25,2017,8,31,Thursday
1,8,8,16,2018,4,2,Monday
2,8,16,24,2017,5,1,Monday
1,3,13,16,2018,6,26,Tuesday
2,3,22,25,2018,4,14,Saturday
1,3,7,10,2017,5,14,Sunday
6,25,4,29,2017,11,16,Thursday
2,3,20,23,2018,1,22,Monday
1,25,9,34,2017,9,21,Thursday
3,13,21,34,2017,9,22,Friday
4,10,9,19,2017,11,18,Saturday
0,10,22,32,2018,4,27,Friday
1,3,20,23,2017,4,10,Monday
2,13,1,14,2018,3,21,Wednseday
12,15,4,19,2018,7,19,Thursday
1,19,9,28,2018,2,1,Thursday
1,2,3,5,2018,8,22,Wednseday
6,10,8,18,2018,5,11,Friday
0,1,10,11,2018,5,14,Monday
2,4,28,32,2018,6,3,Sunday
1,16,14,30,2018,1,10,Wednseday
1,15,13,28,2018,3,14,Wednseday
4,20,9,29,2017,12,14,Thursday
1,8,16,24,2017,3,5,Sunday
2,3,2,5,2018,8,5,Sunday
6,12,15,27,2017,10,4,Wednseday
3,6,12,18,2018,6,8,Friday
1,15,8,23,2017,12,6,Wednseday
1,29,11,40,2017,1,15,Sunday
8,68,-40,28,2017,11,13,Monday
2,3,11,14,2018,4,25,Wednseday
3,24,-3,21,2018,3,2,Friday
1,9,23,32,2017,4,9,Sunday
2,7,23,30,2017,8,1,Tuesday
3,18,12,30,2017,4,16,Sunday
0,17,11,28,2017,12,12,Tuesday
1,7,17,24,2018,6,19,Tuesday
1,2,6,8,2018,5,9,Wednseday
1,14,-2,12,2018,8,2,Thursday
1,9,17,26,2017,7,26,Wednseday
3,12,13,25,2018,1,20,Saturday
8,12,12,24,2018,4,29,Sunday
2,11,11,22,2018,3,12,Monday
0,16,14,30,2017,12,20,Wednseday
1,9,14,23,2018,5,2,Wednseday
1,9,7,16,2018,4,9,Monday
1,17,1,18,2017,9,18,Monday
8,12,27,39,2018,7,1,Sunday
2,14,14,28,2018,2,13,Tuesday
4,7,2,9,2018,6,11,Monday
15,15,5,20,2018,1,25,Thursday
2,14,26,40,2018,8,4,Saturday
1,7,18,25,2017,6,1,Thursday
1,8,15,23,2017,5,24,Wednseday
4,6,8,14,2017,11,24,Friday
2,24,-7,17,2018,3,4,Sunday
3,16,4,20,2018,3,20,Tuesday
2,16,14,30,2017,7,15,Saturday
6,14,0,14,2017,10,31,Tuesday
4,13,14,27,2017,7,15,Saturday
1,14,6,20,2017,11,28,Tuesday
1,10,20,30,2017,2,5,Sunday
5,7,8,15,2018,7,18,Wednseday
11,25,14,39,2018,3,2,Friday
3,13,13,26,2017,3,31,Friday
5,18,6,24,2017,11,24,Friday
3,8,18,26,2018,5,11,Friday
3,11,27,38,2018,6,11,Monday
2,30,-7,23,2017,8,22,Tuesday
2,12,11,23,2017,5,24,Wednseday
8,22,-1,21,2017,11,8,Wednseday
0,1,12,13,2018,3,28,Wednseday
1,9,16,25,2017,11,5,Sunday
6,8,6,14,2018,7,26,Thursday
0,6,14,20,2017,7,20,Thursday
4,9,11,20,2017,7,21,Friday
1,2,18,20,2017,9,27,Wednseday
4,7,35,42,2018,6,8,Friday
7,8,6,14,2018,2,19,Monday
1,11,31,42,2018,6,4,Monday
3,14,11,25,2018,4,30,Monday
2,3,8,11,2017,7,31,Monday
2,8,20,28,2018,1,22,Monday
2,8,28,36,2018,6,5,Tuesday
1,14,15,29,2018,2,21,Wednseday
8,11,3,14,2017,10,9,Monday
2,9,11,20,2017,11,25,Saturday
4,7,11,18,2017,9,8,Friday
0,1,13,14,2017,11,8,Wednseday
2,16,6,22,2017,8,2,Wednseday
4,6,14,20,2018,6,14,Thursday
3,7,31,38,2017,1,27,Friday
3,23,3,26,2018,3,11,Sunday
2,16,17,33,2018,1,13,Saturday
3,10,20,30,2017,12,16,Saturday
1,10,40,50,2017,1,30,Monday
0,6,17,23,2018,4,17,Tuesday
1,19,3,22,2017,5,1,Monday
3,24,3,27,2017,5,6,Saturday
4,12,19,31,2017,8,20,Sunday
4,9,13,22,2018,3,4,Sunday
3,10,33,43,2018,6,3,Sunday
2,8,10,18,2017,12,18,Monday
4,12,9,21,2018,4,5,Thursday
4,12,14,26,2017,7,6,Thursday
5,20,4,24,2017,8,5,Saturday
1,19,16,35,2018,1,17,Wednseday
1,9,14,23,2017,10,25,Wednseday
1,4,14,18,2017,10,22,Sunday
1,9,7,16,2017,9,18,Monday
2,5,18,23,2018,7,8,Sunday
1,5,15,20,2017,12,13,Wednseday
1,4,2,6,2018,8,16,Thursday
2,12,6,18,2018,4,1,Sunday
1,8,8,16,2018,8,8,Wednseday
2,24,1,25,2018,4,30,Monday
4,11,21,32,2018,4,19,Thursday
3,9,16,25,2017,9,24,Sunday
0,13,17,30,2017,10,10,Tuesday
6,13,21,34,2018,6,7,Thursday
19,35,3,38,2017,4,8,Saturday
1,25,-8,17,2017,9,18,Monday
3,8,16,24,2017,7,3,Monday
9,16,14,30,2017,9,5,Tuesday
3,7,19,26,2017,7,14,Friday
0,10,11,21,2017,3,13,Monday
3,9,19,28,2018,4,30,Monday
1,2,9,11,2018,6,24,Sunday
4,12,20,32,2017,11,2,Thursday
1,13,23,36,2018,6,20,Wednseday
2,5,24,29,2017,5,28,Sunday
1,7,15,22,2017,7,27,Thursday
0,8,27,35,2018,5,14,Monday
0,7,5,12,2018,7,20,Friday
0,7,13,20,2017,8,15,Tuesday
3,15,10,25,2018,3,26,Monday
1,7,17,24,2017,7,4,Tuesday
2,10,12,22,2018,4,23,Monday
0,11,13,24,2018,2,9,Friday
3,12,84,96,2017,12,16,Saturday
2,3,12,15,2018,6,10,Sunday
3,10,11,21,2017,6,6,Tuesday
8,24,12,36,2017,7,5,Wednseday
2,36,-13,23,2018,2,19,Monday
2,3,8,11,2017,10,15,Sunday
1,14,31,45,2018,5,28,Monday
2,11,18,29,2017,12,19,Tuesday
2,6,27,33,2017,6,17,Saturday
4,9,15,24,2018,2,11,Sunday
1,26,-1,25,2018,2,19,Monday
7,10,4,14,2017,6,2,Friday
0,12,15,27,2017,12,22,Friday
5,13,11,24,2018,3,23,Friday
1,8,20,28,2018,1,18,Thursday
1,9,12,21,2017,6,13,Tuesday
4,16,13,29,2017,3,27,Monday
5,7,19,26,2017,4,12,Wednseday
1,19,8,27,2018,2,8,Thursday
1,15,7,22,2018,5,14,Monday
3,5,5,10,2018,8,11,Saturday
0,3,17,20,2018,6,13,Wednseday
7,37,-13,24,2018,2,24,Saturday
3,7,20,27,2017,2,18,Saturday
0,6,19,25,2018,4,13,Friday
5,7,8,15,2018,5,9,Wednseday
4,5,7,12,2018,3,17,Saturday
4,19,15,34,2018,6,1,Friday
2,22,19,41,2017,8,22,Tuesday
6,12,15,27,2018,1,26,Friday
2,30,-3,27,2018,4,17,Tuesday
0,5,21,26,2018,7,27,Friday
0,13,15,28,2018,4,18,Wednseday
4,23,2,25,2018,3,12,Monday
2,17,8,25,2018,4,23,Monday
4,15,13,28,2017,9,11,Monday
1,5,17,22,2017,5,17,Wednseday
4,6,22,28,2017,3,31,Friday
1,6,8,14,2018,7,27,Friday
8,19,2,21,2018,1,17,Wednseday
2,23,17,40,2018,4,11,Wednseday
3,12,18,30,2017,4,15,Saturday
1,15,7,22,2017,10,3,Tuesday
2,13,10,23,2018,7,24,Tuesday
1,5,14,19,2017,3,2,Thursday
0,13,9,22,2018,1,16,Tuesday
1,9,14,23,2017,7,23,Sunday
3,9,15,24,2017,12,19,Tuesday
3,24,-6,18,2018,3,9,Friday
1,6,21,27,2017,2,9,Thursday
0,4,15,19,2017,3,10,Friday
2,8,9,17,2018,7,23,Monday
3,6,12,18,2018,1,27,Saturday
4,7,10,17,2017,12,11,Monday
3,10,22,32,2017,12,10,Sunday
7,15,10,25,2018,2,9,Friday
1,4,9,13,2017,9,7,Thursday
1,2,13,15,2018,1,17,Wednseday
3,38,-14,24,2017,5,12,Friday
4,12,19,31,2018,8,10,Friday
5,12,14,26,2018,4,27,Friday
3,10,16,26,2017,9,22,Friday
1,21,8,29,2018,4,23,Monday
4,16,6,22,2017,8,14,Monday
3,14,13,27,2017,8,18,Friday
2,16,14,30,2018,2,20,Tuesday
3,7,11,18,2017,5,15,Monday
28,30,4,34,2017,8,22,Tuesday
1,4,31,35,2017,5,29,Monday
2,11,14,25,2018,4,7,Saturday
5,15,11,26,2017,12,24,Sunday
2,8,9,17,2017,10,1,Sunday
2,8,15,23,2018,5,2,Wednseday
9,10,19,29,2018,2,27,Tuesday
3,11,14,25,2018,1,5,Friday
1,8,15,23,2017,6,5,Monday
3,11,5,16,2018,3,5,Monday
1,4,1,5,2018,8,2,Thursday
9,31,-7,24,2017,11,27,Monday
4,16,11,27,2017,12,23,Saturday
5,13,12,25,2017,11,24,Friday
1,21,10,31,2017,4,18,Tuesday
1,20,3,23,2017,5,30,Tuesday
3,7,14,21,2017,3,6,Monday
2,25,3,28,2017,12,5,Tuesday
4,16,17,33,2017,9,14,Thursday
3,10,22,32,2017,8,12,Saturday
0,18,7,25,2018,5,3,Thursday
1,3,11,14,2018,8,27,Monday
4,11,16,27,2017,6,1,Thursday
2,14,12,26,2017,8,2,Wednseday
3,12,24,36,2018,4,15,Sunday
0,6,14,20,2017,6,30,Friday
2,10,19,29,2018,4,30,Monday
7,13,13,26,2017,5,19,Friday
3,13,16,29,2017,11,14,Tuesday
3,21,-5,16,2018,3,12,Monday
2,11,23,34,2017,12,9,Saturday
9,35,-8,27,2018,2,14,Wednseday
1,16,15,31,2018,1,16,Tuesday
7,13,16,29,2017,12,21,Thursday
3,11,14,25,2018,3,25,Sunday
2,6,18,24,2018,6,30,Saturday
1,2,9,11,2017,5,8,Monday
3,8,14,22,2017,10,23,Monday
3,13,13,26,2017,9,8,Friday
8,17,11,28,2018,2,13,Tuesday
5,16,17,33,2017,3,22,Wednseday
2,9,11,20,2018,7,31,Tuesday
13,26,6,32,2017,10,7,Saturday
0,7,14,21,2018,8,7,Tuesday
1,27,0,27,2018,2,28,Wednseday
2,16,24,40,2018,6,2,Saturday
2,3,9,12,2018,8,19,Sunday
5,12,21,33,2017,3,22,Wednseday
9,12,39,51,2016,10,5,Wednseday
1,6,18,24,2018,5,15,Tuesday
1,11,15,26,2017,7,13,Thursday
1,9,15,24,2017,10,29,Sunday
1,2,12,14,2018,7,2,Monday
2,3,9,12,2017,6,25,Sunday
4,5,28,33,2017,3,16,Thursday
1,23,16,39,2017,12,21,Thursday
6,10,6,16,2018,1,14,Sunday
3,11,14,25,2018,4,16,Monday
2,8,15,23,2018,4,17,Tuesday
4,12,24,36,2018,6,7,Thursday
1,5,23,28,2018,1,4,Thursday
1,8,33,41,2017,1,18,Wednseday
2,10,11,21,2018,1,24,Wednseday
2,14,11,25,2017,4,3,Monday
7,14,3,17,2017,9,4,Monday
7,28,1,29,2017,12,12,Tuesday
1,5,20,25,2018,4,15,Sunday
6,10,9,19,2018,4,28,Saturday
1,11,14,25,2017,6,15,Thursday
4,6,14,20,2017,12,29,Friday
3,7,16,23,2017,12,4,Monday
1,19,7,26,2017,10,18,Wednseday
1,6,14,20,2017,5,16,Tuesday
5,17,11,28,2018,1,17,Wednseday
5,33,-10,23,2018,4,22,Sunday
2,3,8,11,2018,3,26,Monday
5,7,15,22,2017,9,21,Thursday
5,8,8,16,2018,1,31,Wednseday
4,12,14,26,2017,4,28,Friday
3,9,10,19,2018,8,18,Saturday
4,29,2,31,2017,11,13,Monday
3,16,7,23,2017,7,9,Sunday
8,10,13,23,2017,6,14,Wednseday
9,16,25,41,2017,6,7,Wednseday
2,8,14,22,2017,3,28,Tuesday
1,9,22,31,2018,1,14,Sunday
7,10,14,24,2018,4,30,Monday
0,5,5,10,2018,3,19,Monday
1,17,17,34,2018,5,1,Tuesday
1,3,13,16,2017,7,23,Sunday
1,21,3,24,2018,5,15,Tuesday
4,12,19,31,2018,1,14,Sunday
1,4,39,43,2018,7,10,Tuesday
2,8,7,15,2018,7,18,Wednseday
3,11,10,21,2018,7,23,Monday
14,20,5,25,2017,8,17,Thursday
1,8,13,21,2017,3,14,Tuesday
2,14,21,35,2017,8,7,Monday
2,20,3,23,2018,5,16,Wednseday
0,25,3,28,2018,3,9,Friday
2,3,10,13,2018,5,5,Saturday
2,7,17,24,2017,7,17,Monday
2,6,7,13,2018,8,7,Tuesday
2,16,7,23,2018,1,30,Tuesday
1,12,16,28,2018,5,24,Thursday
1,17,12,29,2018,5,21,Monday
3,11,14,25,2018,1,27,Saturday
3,15,9,24,2018,3,18,Sunday
1,6,20,26,2017,9,21,Thursday
2,7,21,28,2018,6,26,Tuesday
1,21,1,22,2018,3,20,Tuesday
0,15,21,36,2017,9,26,Tuesday
5,11,15,26,2018,6,29,Friday
1,3,8,11,2017,7,3,Monday
2,12,17,29,2018,1,7,Sunday
1,11,7,18,2018,3,8,Thursday
4,17,17,34,2018,1,6,Saturday
4,10,16,26,2018,8,4,Saturday
1,12,15,27,2018,3,28,Wednseday
2,34,-9,25,2018,3,1,Thursday
5,7,20,27,2017,12,23,Saturday
2,5,12,17,2018,4,28,Saturday
2,11,9,20,2018,8,4,Saturday
1,13,17,30,2018,6,20,Wednseday
1,4,10,14,2018,7,19,Thursday
2,3,2,5,2018,7,28,Saturday
2,16,8,24,2018,4,16,Monday
1,9,18,27,2018,1,4,Thursday
1,40,-18,22,2018,3,14,Wednseday
2,8,10,18,2017,7,10,Monday
3,12,18,30,2017,3,18,Saturday
3,15,0,15,2018,7,31,Tuesday
10,24,-8,16,2018,1,21,Sunday
4,21,2,23,2017,2,27,Monday
3,9,7,16,2018,8,19,Sunday
2,10,15,25,2018,3,17,Saturday
4,10,20,30,2018,6,23,Saturday
4,9,9,18,2018,3,2,Friday
1,8,16,24,2018,4,16,Monday
2,14,14,28,2017,7,12,Wednseday
0,6,16,22,2017,10,18,Wednseday
7,33,20,53,2018,2,16,Friday
4,17,14,31,2018,8,3,Friday
2,13,22,35,2017,6,14,Wednseday
1,10,13,23,2017,8,13,Sunday
4,7,12,19,2018,7,20,Friday
3,9,13,22,2018,1,16,Tuesday
3,4,13,17,2017,9,22,Friday
3,5,6,11,2018,8,17,Friday
3,10,27,37,2018,1,8,Monday
4,8,8,16,2018,7,16,Monday
3,8,32,40,2018,6,8,Friday
5,10,2,12,2018,8,1,Wednseday
1,9,14,23,2018,1,3,Wednseday
1,7,11,18,2018,7,16,Monday
1,3,1,4,2018,8,13,Monday
5,7,14,21,2017,6,1,Thursday
1,11,16,27,2018,2,8,Thursday
1,13,10,23,2017,7,9,Sunday
5,11,24,35,2017,12,28,Thursday
11,21,8,29,2017,12,7,Thursday
4,9,5,14,2018,8,9,Thursday
4,26,8,34,2018,1,26,Friday
6,23,6,29,2018,2,28,Wednseday
1,22,6,28,2017,12,7,Thursday
4,6,37,43,2017,4,6,Thursday
4,14,12,26,2017,9,8,Friday
20,26,20,46,2017,12,21,Thursday
4,15,2,17,2018,5,20,Sunday
1,22,13,35,2018,4,10,Tuesday
1,22,12,34,2017,12,7,Thursday
2,7,5,12,2018,3,17,Saturday
0,8,29,37,2017,2,6,Monday
2,6,14,20,2017,11,7,Tuesday
1,14,20,34,2018,3,15,Thursday
15,15,52,67,2016,10,10,Monday
0,14,17,31,2018,5,11,Friday
4,7,20,27,2017,5,12,Friday
1,2,10,12,2017,8,20,Sunday
4,10,7,17,2018,2,17,Saturday
1,9,20,29,2018,6,24,Sunday
8,15,3,18,2018,7,29,Sunday
7,16,12,28,2017,3,15,Wednseday
7,17,13,30,2018,6,12,Tuesday
2,6,16,22,2017,9,27,Wednseday
1,12,13,25,2018,7,23,Monday
0,11,3,14,2017,6,8,Thursday
0,5,17,22,2017,9,27,Wednseday
2,8,18,26,2018,7,4,Wednseday
4,14,13,27,2018,6,22,Friday
7,11,10,21,2017,10,13,Friday
0,9,16,25,2017,2,13,Monday
1,6,16,22,2017,11,23,Thursday
3,13,22,35,2017,5,16,Tuesday
2,35,-7,28,2017,12,12,Tuesday
3,10,16,26,2017,11,19,Sunday
1,2,11,13,2018,5,15,Tuesday
1,2,13,15,2018,6,27,Wednseday
0,7,28,35,2018,6,29,Friday
6,11,12,23,2018,8,14,Tuesday
1,68,-60,8,2018,7,11,Wednseday
3,4,7,11,2017,8,28,Monday
6,84,-56,28,2018,2,9,Friday
3,14,11,25,2017,6,5,Monday
2,6,34,40,2017,2,18,Saturday
5,12,11,23,2017,10,11,Wednseday
5,13,17,30,2018,7,14,Saturday
3,29,9,38,2017,12,15,Friday
3,5,19,24,2017,6,30,Friday
21,25,-12,13,2018,4,5,Thursday
11,20,5,25,2017,12,1,Friday
11,12,5,17,2018,7,15,Sunday
7,20,18,38,2017,7,22,Saturday
3,10,19,29,2018,4,1,Sunday
2,4,15,19,2017,3,25,Saturday
2,9,13,22,2018,7,8,Sunday
2,12,18,30,2017,5,7,Sunday
2,11,11,22,2017,7,24,Monday
3,44,-13,31,2017,8,6,Sunday
3,21,5,26,2018,3,17,Saturday
3,8,16,24,2017,8,11,Friday
6,19,11,30,2018,2,17,Saturday
4,7,11,18,2017,5,8,Monday
0,15,13,28,2017,12,6,Wednseday
3,8,20,28,2017,9,5,Tuesday
3,16,21,37,2017,7,11,Tuesday
0,8,31,39,2018,6,14,Thursday
1,2,13,15,2017,8,1,Tuesday
7,16,4,20,2018,3,20,Tuesday
1,7,19,26,2018,8,9,Thursday
6,9,3,12,2018,8,4,Saturday
0,1,12,13,2017,7,20,Thursday
2,37,-8,29,2018,2,5,Monday
2,3,23,26,2018,6,2,Saturday
2,3,20,23,2017,5,16,Tuesday
2,27,4,31,2018,4,10,Tuesday
9,17,5,22,2018,7,9,Monday
6,11,10,21,2017,6,1,Thursday
3,5,12,17,2018,2,17,Saturday
4,16,7,23,2018,3,25,Sunday
3,19,4,23,2018,1,22,Monday
15,27,11,38,2018,4,24,Tuesday
1,21,2,23,2017,8,29,Tuesday
16,19,32,51,2016,10,5,Wednseday
1,11,11,22,2017,8,17,Thursday
7,16,18,34,2017,12,19,Tuesday
7,12,8,20,2017,8,9,Wednseday
3,22,14,36,2018,3,19,Monday
1,14,8,22,2018,3,21,Wednseday
3,4,15,19,2018,4,21,Saturday
7,17,7,24,2017,6,19,Monday
1,12,8,20,2017,7,6,Thursday
2,11,15,26,2017,9,24,Sunday
56,56,-31,25,2018,2,19,Monday
1,10,14,24,2017,10,16,Monday
1,9,28,37,2017,9,27,Wednseday
3,8,6,14,2018,2,20,Tuesday
3,7,18,25,2018,1,27,Saturday
23,31,11,42,2018,5,15,Tuesday
1,79,-52,27,2018,4,3,Tuesday
6,22,0,22,2018,5,10,Thursday
3,10,7,17,2017,3,20,Monday
38,59,13,72,2018,1,7,Sunday
3,9,5,14,2017,6,7,Wednseday
3,4,7,11,2018,7,8,Sunday
1,5,21,26,2018,4,18,Wednseday
1,13,18,31,2017,9,25,Monday
2,22,0,22,2018,3,7,Wednseday
4,10,8,18,2018,5,25,Friday
1,6,20,26,2018,6,21,Thursday
4,7,6,13,2017,8,18,Friday
4,12,16,28,2018,6,29,Friday
1,5,10,15,2018,7,22,Sunday
1,5,17,22,2017,11,30,Thursday
3,35,-13,22,2018,3,4,Sunday
2,7,9,16,2018,8,6,Monday
1,11,15,26,2017,8,13,Sunday
1,16,20,36,2017,11,20,Monday
5,18,4,22,2017,11,27,Monday
4,30,-2,28,2018,2,19,Monday
4,27,-2,25,2017,11,25,Saturday
7,21,11,32,2017,8,4,Friday
2,4,18,22,2017,12,24,Sunday
12,28,0,28,2018,7,12,Thursday
5,11,14,25,2018,6,28,Thursday
0,6,28,34,2017,6,29,Thursday
2,3,8,11,2017,6,26,Monday
6,19,16,35,2017,4,26,Wednseday
5,13,21,34,2018,1,3,Wednseday
3,12,14,26,2018,1,21,Sunday
0,10,17,27,2017,5,5,Friday
7,20,9,29,2018,7,4,Wednseday
4,11,7,18,2018,6,8,Friday
2,6,25,31,2018,3,13,Tuesday
2,3,13,16,2018,6,9,Saturday
2,10,12,22,2017,8,7,Monday
1,7,23,30,2018,6,11,Monday
6,14,19,33,2018,3,28,Wednseday
2,15,17,32,2018,2,25,Sunday
5,7,11,18,2018,3,1,Thursday
1,4,13,17,2018,6,18,Monday
1,11,17,28,2017,7,6,Thursday
2,3,2,5,2018,8,25,Saturday
2,8,13,21,2017,7,10,Monday
1,6,17,23,2017,10,3,Tuesday
11,17,3,20,2017,11,24,Friday
3,10,25,35,2018,7,13,Friday
1,4,3,7,2018,8,23,Thursday
3,17,1,18,2018,5,21,Monday
1,15,9,24,2017,9,17,Sunday
3,16,14,30,2017,10,28,Saturday
1,2,10,12,2017,11,19,Sunday
1,2,21,23,2018,4,24,Tuesday
2,23,1,24,2017,11,26,Sunday
11,21,10,31,2017,3,17,Friday
5,17,6,23,2017,11,11,Saturday
2,4,21,25,2018,4,23,Monday
3,6,26,32,2018,5,5,Saturday
4,11,8,19,2018,7,13,Friday
0,11,17,28,2017,11,10,Friday
0,17,2,19,2018,6,29,Friday
8,12,25,37,2017,12,10,Sunday
2,11,12,23,2017,4,22,Saturday
4,4,14,18,2017,9,30,Saturday
2,16,25,41,2017,4,4,Tuesday
1,3,7,10,2017,10,17,Tuesday
3,4,13,17,2018,5,4,Friday
5,15,18,33,2017,8,30,Wednseday
0,11,8,19,2018,4,5,Thursday
5,13,14,27,2017,12,7,Thursday
2,6,17,23,2017,9,26,Tuesday
0,1,30,31,2018,1,9,Tuesday
1,5,14,19,2018,5,24,Thursday
7,21,11,32,2017,12,1,Friday
1,5,13,18,2018,8,5,Sunday
2,41,-15,26,2018,2,28,Wednseday
6,19,15,34,2017,5,11,Thursday
17,28,3,31,2018,2,9,Friday
4,10,10,20,2018,5,4,Friday
3,7,21,28,2018,2,2,Friday
1,8,27,35,2018,1,3,Wednseday
1,8,28,36,2018,1,14,Sunday
1,4,27,31,2018,6,18,Monday
1,10,14,24,2018,1,15,Monday
5,41,-9,32,2018,1,20,Saturday
3,14,10,24,2017,9,19,Tuesday
1,5,9,14,2018,7,18,Wednseday
4,27,6,33,2018,2,15,Thursday
5,8,13,21,2017,3,1,Wednseday
3,8,15,23,2017,3,12,Sunday
1,8,29,37,2018,1,28,Sunday
2,12,23,35,2018,1,3,Wednseday
1,5,8,13,2018,3,28,Wednseday
4,13,17,30,2017,11,18,Saturday
5,11,14,25,2017,4,1,Saturday
4,24,-2,22,2018,4,23,Monday
2,17,7,24,2017,9,16,Saturday
1,29,-3,26,2018,2,21,Wednseday
1,9,29,38,2017,1,24,Tuesday
7,11,8,19,2018,6,7,Thursday
2,16,13,29,2018,3,19,Monday
2,7,15,22,2017,3,28,Tuesday
1,14,7,21,2018,2,20,Tuesday
1,20,4,24,2017,12,19,Tuesday
4,7,20,27,2017,1,19,Thursday
3,22,21,43,2018,3,26,Monday
2,10,20,30,2018,2,26,Monday
0,3,9,12,2018,3,2,Friday
2,3,13,16,2018,1,21,Sunday
1,2,1,3,2018,8,28,Tuesday
2,22,16,38,2017,1,23,Monday
3,7,18,25,2018,6,30,Saturday
6,13,8,21,2017,10,13,Friday
5,17,13,30,2018,5,5,Saturday
2,8,15,23,2017,5,21,Sunday
2,7,4,11,2018,8,6,Monday
1,12,18,30,2018,5,6,Sunday
2,10,13,23,2017,8,16,Wednseday
5,12,14,26,2018,3,15,Thursday
1,8,19,27,2018,7,5,Thursday
1,22,8,30,2018,2,5,Monday
2,4,7,11,2018,3,11,Sunday
6,21,13,34,2017,11,30,Thursday
2,7,13,20,2017,11,28,Tuesday
1,17,17,34,2018,2,27,Tuesday
4,8,26,34,2017,7,6,Thursday
2,7,9,16,2018,2,7,Wednseday
6,13,20,33,2018,5,26,Saturday
1,8,75,83,2017,9,20,Wednseday
1,2,28,30,2018,7,2,Monday
6,8,15,23,2017,7,4,Tuesday
1,21,12,33,2017,12,27,Wednseday
1,21,8,29,2018,3,28,Wednseday
1,14,11,25,2017,12,25,Monday
2,6,20,26,2018,1,13,Saturday
1,7,4,11,2018,8,6,Monday
18,25,1,26,2017,11,10,Friday
2,12,27,39,2018,6,9,Saturday
5,11,9,20,2017,9,7,Thursday
4,10,7,17,2017,9,4,Monday
3,12,13,25,2017,3,3,Friday
4,11,13,24,2018,8,3,Friday
2,7,14,21,2017,5,30,Tuesday
2,9,11,20,2017,7,8,Saturday
2,23,0,23,2018,3,18,Sunday
4,9,12,21,2018,1,15,Monday
0,16,15,31,2018,1,30,Tuesday
1,9,14,23,2017,10,16,Monday
3,12,9,21,2018,7,13,Friday
3,5,15,20,2017,11,24,Friday
5,13,8,21,2018,2,15,Thursday
5,17,14,31,2017,5,28,Sunday
1,3,19,22,2017,4,10,Monday
2,14,42,56,2018,3,12,Monday
2,3,10,13,2017,7,15,Saturday
1,10,12,22,2017,8,14,Monday
5,21,25,46,2018,2,22,Thursday
40,85,-15,70,2018,1,8,Monday
1,2,14,16,2018,1,29,Monday
1,2,14,16,2018,1,8,Monday
3,31,18,49,2018,5,25,Friday
3,10,22,32,2018,4,13,Friday
1,16,0,16,2018,3,5,Monday
1,9,20,29,2018,1,9,Tuesday
2,3,10,13,2018,3,20,Tuesday
2,10,16,26,2017,12,16,Saturday
0,11,20,31,2017,12,8,Friday
3,10,10,20,2017,8,26,Saturday
3,18,4,22,2018,5,7,Monday
5,6,11,17,2018,4,13,Friday
1,7,19,26,2018,7,5,Thursday
2,7,1,8,2018,8,8,Wednseday
1,6,13,19,2018,7,19,Thursday
1,2,7,9,2018,8,5,Sunday
7,19,7,26,2018,1,10,Wednseday
1,7,16,23,2018,8,20,Monday
1,8,6,14,2018,1,9,Tuesday
3,10,12,22,2017,9,5,Tuesday
10,20,34,54,2018,7,28,Saturday
2,14,18,32,2017,7,20,Thursday
5,11,28,39,2018,6,9,Saturday
2,55,-28,27,2018,3,24,Saturday
0,4,4,8,2018,8,6,Monday
2,7,15,22,2018,1,29,Monday
3,7,12,19,2017,9,1,Friday
4,12,10,22,2017,11,30,Thursday
1,2,12,14,2017,10,30,Monday
1,6,8,14,2018,7,19,Thursday
1,13,9,22,2017,8,3,Thursday
3,13,11,24,2018,2,17,Saturday
4,10,4,14,2017,11,24,Friday
2,7,20,27,2017,9,6,Wednseday
1,5,21,26,2017,8,20,Sunday
2,11,20,31,2018,6,30,Saturday
4,17,9,26,2017,11,5,Sunday
5,12,14,26,2017,12,7,Thursday
1,15,0,15,2018,5,14,Monday
1,6,15,21,2018,6,14,Thursday
4,7,-2,5,2018,8,3,Friday
3,8,7,15,2018,1,23,Tuesday
6,14,20,34,2018,1,31,Wednseday
4,19,10,29,2017,6,22,Thursday
3,11,14,25,2018,8,3,Friday
3,12,12,24,2017,11,17,Friday
0,5,22,27,2018,6,15,Friday
4,6,33,39,2018,6,22,Friday
4,10,10,20,2017,5,18,Thursday
2,8,22,30,2018,7,23,Monday
2,10,11,21,2018,5,8,Tuesday
1,14,9,23,2018,5,21,Monday
5,19,20,39,2017,12,23,Saturday
1,8,14,22,2018,1,16,Tuesday
5,12,12,24,2017,7,16,Sunday
1,8,7,15,2017,10,10,Tuesday
16,32,-3,29,2017,4,9,Sunday
5,20,14,34,2017,3,15,Wednseday
1,28,-6,22,2018,3,20,Tuesday
0,13,19,32,2018,5,10,Thursday
3,16,13,29,2018,8,12,Sunday
3,12,6,18,2018,8,3,Friday
2,8,6,14,2018,8,13,Monday
1,8,41,49,2017,7,25,Tuesday
2,8,14,22,2017,3,12,Sunday
1,6,9,15,2018,1,25,Thursday
5,16,7,23,2018,7,29,Sunday
5,8,11,19,2017,10,11,Wednseday
1,9,12,21,2018,3,19,Monday
1,6,17,23,2018,1,23,Tuesday
0,9,13,22,2017,9,12,Tuesday
5,13,8,21,2017,11,24,Friday
4,9,10,19,2017,7,2,Sunday
1,13,13,26,2018,4,11,Wednseday
2,7,21,28,2018,7,2,Monday
1,30,-13,17,2018,5,21,Monday
2,5,9,14,2018,2,19,Monday
6,13,21,34,2018,1,3,Wednseday
4,11,23,34,2018,2,10,Saturday
2,5,21,26,2018,6,2,Saturday
7,29,8,37,2018,4,25,Wednseday
2,14,3,17,2017,3,7,Tuesday
1,6,14,20,2017,7,12,Wednseday
3,13,11,24,2017,7,14,Friday
3,13,19,32,2017,10,13,Friday
5,16,11,27,2017,10,18,Wednseday
8,28,1,29,2017,4,19,Wednseday
6,15,14,29,2018,1,2,Tuesday
5,11,17,28,2017,4,6,Thursday
9,21,12,33,2017,6,14,Wednseday
3,18,13,31,2018,1,19,Friday
4,22,5,27,2018,1,19,Friday
1,14,14,28,2018,4,18,Wednseday
0,1,12,13,2018,6,21,Thursday
3,12,19,31,2018,7,21,Saturday
7,12,14,26,2017,7,19,Wednseday
6,9,5,14,2017,11,29,Wednseday
6,15,8,23,2017,11,28,Tuesday
2,37,-17,20,2018,3,3,Saturday
3,6,28,34,2018,6,8,Friday
5,6,8,14,2018,2,21,Wednseday
7,26,0,26,2018,2,14,Wednseday
1,10,10,20,2018,2,21,Wednseday
2,22,7,29,2017,12,14,Thursday
2,16,15,31,2017,6,17,Saturday
1,3,10,13,2017,8,15,Tuesday
1,6,16,22,2017,9,28,Thursday
10,11,7,18,2017,10,6,Friday
2,15,12,27,2017,4,18,Tuesday
1,11,24,35,2017,6,22,Thursday
4,15,7,22,2017,6,26,Monday
2,10,26,36,2017,2,14,Tuesday
10,11,6,17,2017,10,28,Saturday
7,13,11,24,2017,12,26,Tuesday
0,1,2,3,2018,8,21,Tuesday
5,27,6,33,2017,3,22,Wednseday
2,83,-59,24,2018,3,10,Saturday
2,11,10,21,2018,4,2,Monday
4,7,20,27,2018,3,17,Saturday
4,10,17,27,2017,9,19,Tuesday
1,15,22,37,2018,1,23,Tuesday
1,4,19,23,2018,4,9,Monday
5,6,6,12,2018,3,31,Saturday
1,14,11,25,2017,6,15,Thursday
2,2,10,12,2018,3,25,Sunday
1,7,19,26,2018,4,26,Thursday
1,11,14,25,2017,10,12,Thursday
2,10,14,24,2018,2,26,Monday
2,8,8,16,2018,7,4,Wednseday
1,8,19,27,2018,5,8,Tuesday
1,5,14,19,2018,4,22,Sunday
3,14,11,25,2018,1,8,Monday
2,11,19,30,2017,12,9,Saturday
10,28,-1,27,2017,9,19,Tuesday
1,9,24,33,2017,8,24,Thursday
6,7,6,13,2017,10,10,Tuesday
3,7,20,27,2018,6,15,Friday
17,22,16,38,2017,12,19,Tuesday
3,4,10,14,2018,5,7,Monday
6,20,20,40,2017,5,4,Thursday
3,7,35,42,2017,9,26,Tuesday
3,4,12,16,2018,5,19,Saturday
2,7,15,22,2018,3,21,Wednseday
3,6,15,21,2017,3,3,Friday
3,6,8,14,2017,11,14,Tuesday
2,5,14,19,2017,11,12,Sunday
5,6,9,15,2018,1,24,Wednseday
1,9,11,20,2018,8,14,Tuesday
2,3,5,8,2018,5,8,Tuesday
7,22,1,23,2018,3,27,Tuesday
2,12,30,42,2018,7,25,Wednseday
1,6,14,20,2018,8,2,Thursday
0,12,16,28,2017,12,6,Wednseday
3,10,16,26,2018,1,7,Sunday
1,3,5,8,2018,5,15,Tuesday
0,10,22,32,2018,1,19,Friday
2,14,13,27,2018,6,27,Wednseday
5,50,13,63,2018,3,14,Wednseday
19,22,14,36,2017,4,26,Wednseday
1,2,11,13,2017,8,29,Tuesday
0,11,24,35,2018,1,4,Thursday
0,16,13,29,2017,10,2,Monday
1,4,18,22,2017,3,28,Tuesday
3,10,19,29,2018,4,16,Monday
2,6,14,20,2017,11,14,Tuesday
2,12,21,33,2018,8,8,Wednseday
3,13,8,21,2017,10,31,Tuesday
4,9,7,16,2017,11,26,Sunday
9,11,8,19,2017,11,12,Sunday
5,13,30,43,2017,1,18,Wednseday
18,25,15,40,2018,7,7,Saturday
2,50,-15,35,2018,4,24,Tuesday
3,12,12,24,2017,11,24,Friday
1,7,15,22,2017,7,13,Thursday
0,13,14,27,2017,11,9,Thursday
1,4,26,30,2018,6,25,Monday
7,18,10,28,2017,9,20,Wednseday
1,6,7,13,2018,8,17,Friday
2,8,18,26,2018,4,22,Sunday
2,6,9,15,2018,5,2,Wednseday
3,19,8,27,2017,10,13,Friday
0,22,4,26,2018,2,15,Thursday
5,12,7,19,2018,8,16,Thursday
7,10,11,21,2018,2,13,Tuesday
1,26,-8,18,2018,5,20,Sunday
3,6,13,19,2018,3,16,Friday
1,6,35,41,2017,2,2,Thursday
1,10,28,38,2017,1,24,Tuesday
10,12,14,26,2017,3,11,Saturday
6,20,6,26,2017,10,18,Wednseday
1,4,10,14,2017,11,2,Thursday
2,21,14,35,2017,12,18,Monday
2,13,16,29,2018,2,7,Wednseday
4,24,-4,20,2018,2,16,Friday
1,8,11,19,2018,8,2,Thursday
4,7,13,20,2018,5,12,Saturday
2,18,5,23,2017,10,9,Monday
0,8,13,21,2018,7,25,Wednseday
1,22,4,26,2018,2,7,Wednseday
4,11,26,37,2018,1,27,Saturday
10,110,-88,22,2017,10,22,Sunday
3,38,-11,27,2017,12,15,Friday
1,4,18,22,2018,1,17,Wednseday
9,23,-2,21,2018,2,14,Wednseday
3,31,0,31,2018,1,7,Sunday
1,2,13,15,2018,1,23,Tuesday
1,13,10,23,2018,4,10,Tuesday
0,5,21,26,2017,8,23,Wednseday
2,16,1,17,2018,2,4,Sunday
14,32,7,39,2018,2,5,Monday
3,20,0,20,2018,3,2,Friday
1,10,9,19,2017,9,17,Sunday
3,10,16,26,2017,2,12,Sunday
2,13,11,24,2017,11,19,Sunday
2,14,10,24,2018,3,27,Tuesday
1,15,13,28,2017,8,29,Tuesday
2,6,13,19,2017,6,21,Wednseday
7,14,3,17,2018,5,22,Tuesday
2,2,21,23,2018,4,9,Monday
4,9,13,22,2018,4,29,Sunday
1,7,5,12,2018,8,16,Thursday
1,6,9,15,2018,5,9,Wednseday
3,10,11,21,2018,7,27,Friday
5,27,0,27,2018,1,24,Wednseday
4,7,9,16,2018,4,9,Monday
1,13,2,15,2017,8,29,Tuesday
2,15,5,20,2018,3,29,Thursday
1,16,13,29,2018,4,10,Tuesday
3,13,12,25,2017,3,18,Saturday
6,46,-19,27,2017,11,24,Friday
1,8,15,23,2018,8,6,Monday
1,7,13,20,2017,7,25,Tuesday
3,25,8,33,2018,1,5,Friday
1,13,8,21,2018,3,6,Tuesday
0,11,21,32,2017,9,14,Thursday
2,11,14,25,2018,4,14,Saturday
2,3,25,28,2018,5,15,Tuesday
7,61,-30,31,2017,11,27,Monday
1,13,25,38,2017,12,5,Tuesday
11,14,12,26,2017,6,22,Thursday
9,15,17,32,2018,7,15,Sunday
3,12,8,20,2017,11,25,Saturday
2,7,20,27,2017,7,25,Tuesday
3,15,5,20,2017,11,25,Saturday
1,24,5,29,2018,5,13,Sunday
3,9,15,24,2018,6,9,Saturday
6,13,13,26,2018,7,12,Thursday
2,11,20,31,2017,11,11,Saturday
0,24,10,34,2017,4,28,Friday
2,13,12,25,2018,5,12,Saturday
2,7,12,19,2017,9,6,Wednseday
2,3,10,13,2018,2,28,Wednseday
1,7,4,11,2017,10,9,Monday
2,13,9,22,2018,2,13,Tuesday
2,7,15,22,2018,6,13,Wednseday
15,19,3,22,2018,8,1,Wednseday
7,14,16,30,2017,4,3,Monday
2,62,-28,34,2017,7,12,Wednseday
3,17,15,32,2018,4,27,Friday
1,2,12,14,2018,5,2,Wednseday
2,6,19,25,2018,5,12,Saturday
3,7,13,20,2018,7,27,Friday
7,21,10,31,2017,5,8,Monday
0,4,13,17,2018,6,18,Monday
1,4,10,14,2017,11,9,Thursday
5,8,15,23,2017,5,24,Wednseday
5,7,14,21,2017,3,23,Thursday
13,15,5,20,2017,10,19,Thursday
0,14,8,22,2018,3,26,Monday
2,5,22,27,2018,4,28,Saturday
3,6,18,24,2017,9,15,Friday
5,14,10,24,2018,7,7,Saturday
2,9,11,20,2018,8,4,Saturday
4,6,6,12,2018,3,2,Friday
7,11,6,17,2017,3,21,Tuesday
3,13,36,49,2017,2,3,Friday
2,8,15,23,2017,5,31,Wednseday
5,7,19,26,2017,12,15,Friday
1,10,15,25,2017,11,27,Monday
1,11,13,24,2017,11,27,Monday
0,3,18,21,2018,7,17,Tuesday
5,34,-7,27,2018,2,9,Friday
1,4,18,22,2017,10,30,Monday
1,8,21,29,2017,12,14,Thursday
3,12,20,32,2018,7,27,Friday
2,3,17,20,2017,3,14,Tuesday
2,13,21,34,2018,1,6,Saturday
1,14,20,34,2017,6,8,Thursday
12,47,-20,27,2017,12,22,Friday
1,12,12,24,2017,5,12,Friday
2,4,4,8,2017,10,30,Monday
1,7,21,28,2018,1,10,Wednseday
3,4,2,6,2018,8,3,Friday
1,8,23,31,2018,6,10,Sunday
2,3,9,12,2018,8,25,Saturday
4,7,7,14,2018,7,19,Thursday
10,14,11,25,2017,3,17,Friday
2,11,24,35,2018,2,26,Monday
2,3,12,15,2018,5,6,Sunday
1,8,16,24,2018,4,22,Sunday
3,5,19,24,2017,4,2,Sunday
1,7,16,23,2018,5,14,Monday
5,6,1,7,2018,8,8,Wednseday
7,12,16,28,2018,6,27,Wednseday
2,14,11,25,2018,3,26,Monday
1,4,2,6,2018,8,9,Thursday
1,7,13,20,2017,11,24,Friday
2,20,9,29,2018,1,11,Thursday
2,7,16,23,2018,4,11,Wednseday
3,10,14,24,2017,7,3,Monday
8,15,8,23,2017,5,22,Monday
1,5,16,21,2018,8,8,Wednseday
5,13,14,27,2018,5,10,Thursday
22,27,3,30,2018,2,21,Wednseday
14,17,1,18,2018,7,20,Friday
3,10,35,45,2018,6,1,Friday
2,10,14,24,2018,2,19,Monday
4,13,23,36,2018,7,12,Thursday
6,32,-5,27,2017,12,21,Thursday
2,3,29,32,2017,12,4,Monday
11,47,-9,38,2017,12,23,Saturday
4,5,9,14,2017,5,19,Friday
2,8,16,24,2017,6,11,Sunday
3,9,15,24,2017,5,15,Monday
7,8,5,13,2018,3,21,Wednseday
4,5,12,17,2018,1,7,Sunday
6,12,7,19,2018,3,28,Wednseday
2,6,20,26,2017,3,29,Wednseday
1,9,14,23,2017,5,8,Monday
1,2,13,15,2017,7,12,Wednseday
1,8,21,29,2018,6,20,Wednseday
2,6,15,21,2018,5,15,Tuesday
1,8,26,34,2018,2,6,Tuesday
4,10,16,26,2017,12,16,Saturday
5,15,17,32,2017,8,31,Thursday
1,13,21,34,2017,9,26,Tuesday
1,7,14,21,2017,6,12,Monday
1,4,17,21,2018,1,25,Thursday
8,33,16,49,2017,12,20,Wednseday
0,6,20,26,2017,7,13,Thursday
1,7,13,20,2017,7,6,Thursday
4,12,26,38,2018,7,6,Friday
3,9,7,16,2018,2,13,Tuesday
1,4,9,13,2018,4,26,Thursday
2,12,15,27,2017,10,25,Wednseday
1,11,31,42,2017,6,8,Thursday
4,28,1,29,2017,12,7,Thursday
1,20,8,28,2018,7,25,Wednseday
1,14,12,26,2017,12,20,Wednseday
1,8,34,42,2017,8,16,Wednseday
5,11,15,26,2018,2,22,Thursday
9,14,3,17,2017,10,23,Monday
2,13,9,22,2017,11,14,Tuesday
3,14,1,15,2018,1,17,Wednseday
0,22,3,25,2017,5,4,Thursday
1,27,-10,17,2018,3,6,Tuesday
4,6,21,27,2017,11,3,Friday
1,13,9,22,2017,7,11,Tuesday
5,22,7,29,2018,5,16,Wednseday
1,5,14,19,2018,7,25,Wednseday
2,12,11,23,2017,6,14,Wednseday
2,17,22,39,2017,11,5,Sunday
3,8,8,16,2018,1,8,Monday
3,73,-52,21,2017,11,13,Monday
7,17,7,24,2017,9,15,Friday
6,20,11,31,2018,1,26,Friday
9,15,7,22,2018,7,31,Tuesday
5,12,13,25,2018,2,10,Saturday
1,4,1,5,2018,8,9,Thursday
15,19,4,23,2018,5,9,Wednseday
1,9,26,35,2017,10,5,Thursday
3,5,13,18,2018,1,6,Saturday
5,18,14,32,2018,2,9,Friday
6,14,22,36,2017,8,3,Thursday
5,13,10,23,2018,1,10,Wednseday
1,16,8,24,2018,2,18,Sunday
3,23,1,24,2018,3,19,Monday
4,22,12,34,2018,3,3,Saturday
0,8,14,22,2017,6,20,Tuesday
1,4,11,15,2018,1,25,Thursday
1,4,6,10,2018,8,5,Sunday
1,4,2,6,2018,8,16,Thursday
1,13,7,20,2017,8,29,Tuesday
1,4,17,21,2018,6,21,Thursday
1,12,10,22,2017,6,22,Thursday
13,24,31,55,2017,6,3,Saturday
2,9,21,30,2018,4,18,Wednseday
2,8,15,23,2017,11,12,Sunday
3,6,25,31,2017,2,4,Saturday
1,8,12,20,2017,11,23,Thursday
2,12,11,23,2018,7,23,Monday
1,3,17,20,2017,9,12,Tuesday
6,12,11,23,2018,3,21,Wednseday
2,4,10,14,2018,2,21,Wednseday
3,38,-14,24,2017,11,27,Monday
4,7,33,40,2018,8,17,Friday
6,13,18,31,2018,6,15,Friday
4,36,-7,29,2017,4,13,Thursday
2,3,6,9,2018,8,1,Wednseday
2,6,29,35,2017,2,1,Wednseday
1,7,22,29,2017,2,13,Monday
3,6,10,16,2018,7,21,Saturday
1,4,16,20,2017,7,13,Thursday
1,3,18,21,2018,6,25,Monday
1,23,-2,21,2018,3,6,Tuesday
1,3,15,18,2018,1,29,Monday
1,3,17,20,2017,6,27,Tuesday
6,14,6,20,2017,5,10,Wednseday
2,6,7,13,2018,7,4,Wednseday
4,24,4,28,2018,2,5,Monday
7,9,19,28,2017,4,26,Wednseday
2,9,11,20,2018,2,17,Saturday
3,14,3,17,2018,3,26,Monday
5,8,6,14,2018,8,9,Thursday
1,28,6,34,2018,4,5,Thursday
1,13,16,29,2017,12,5,Tuesday
4,9,21,30,2017,6,19,Monday
2,6,17,23,2017,10,24,Tuesday
3,10,14,24,2017,7,21,Friday
1,7,16,23,2017,5,29,Monday
2,3,2,5,2018,7,28,Saturday
1,7,1,8,2018,7,19,Thursday
1,8,28,36,2018,4,19,Thursday
3,6,19,25,2018,1,20,Saturday
5,12,13,25,2017,9,9,Saturday
6,19,2,21,2018,2,21,Wednseday
9,16,7,23,2017,11,11,Saturday
3,10,19,29,2018,2,5,Monday
2,10,-1,9,2018,7,30,Monday
4,18,10,28,2018,2,12,Monday
4,35,-14,21,2018,2,16,Friday
2,13,15,28,2018,6,20,Wednseday
2,5,12,17,2018,4,8,Sunday
29,37,-8,29,2017,8,23,Wednseday
1,2,11,13,2017,6,28,Wednseday
2,5,18,23,2018,6,23,Saturday
5,18,14,32,2017,8,4,Friday
8,23,-3,20,2017,11,23,Thursday
12,17,9,26,2018,4,27,Friday
3,10,13,23,2017,10,1,Sunday
7,15,16,31,2017,4,4,Tuesday
4,11,16,27,2017,10,26,Thursday
3,9,9,18,2018,8,18,Saturday
0,20,1,21,2018,2,22,Thursday
6,41,-13,28,2017,11,24,Friday
0,28,-2,26,2017,12,7,Thursday
1,8,10,18,2017,9,18,Monday
12,19,9,28,2017,7,7,Friday
9,16,15,31,2018,2,18,Sunday
0,8,21,29,2018,1,3,Wednseday
2,11,22,33,2018,1,27,Saturday
3,5,21,26,2018,4,21,Saturday
5,10,8,18,2018,7,20,Friday
3,37,-6,31,2018,4,29,Sunday
2,15,8,23,2017,6,14,Wednseday
3,6,20,26,2018,6,15,Friday
3,18,8,26,2017,5,19,Friday
1,15,35,50,2017,1,23,Monday
2,15,8,23,2018,2,25,Sunday
2,13,12,25,2018,4,5,Thursday
1,10,17,27,2017,6,6,Tuesday
3,31,0,31,2018,1,14,Sunday
1,15,8,23,2018,1,31,Wednseday
1,8,15,23,2017,11,28,Tuesday
5,7,18,25,2017,8,25,Friday
1,11,21,32,2017,4,27,Thursday
7,19,27,46,2017,4,13,Thursday
2,3,5,8,2018,8,13,Monday
3,4,9,13,2017,8,12,Saturday
1,8,27,35,2018,8,7,Tuesday
2,17,13,30,2017,11,27,Monday
3,6,19,25,2018,4,21,Saturday
3,9,11,20,2018,2,14,Wednseday
2,15,7,22,2017,11,28,Tuesday
1,5,13,18,2018,5,24,Thursday
4,11,14,25,2018,3,10,Saturday
4,10,4,14,2018,8,3,Friday
3,4,9,13,2017,9,1,Friday
4,30,13,43,2018,6,11,Monday
3,24,0,24,2017,11,24,Friday
4,9,9,18,2017,8,7,Monday
4,14,19,33,2018,2,1,Thursday
4,11,10,21,2018,6,8,Friday
6,7,10,17,2018,2,13,Tuesday
9,17,1,18,2018,5,20,Sunday
1,3,2,5,2018,8,15,Wednseday
1,20,3,23,2017,12,6,Wednseday
0,1,5,6,2018,8,21,Tuesday
2,5,15,20,2018,2,22,Thursday
9,22,6,28,2017,9,25,Monday
1,17,19,36,2018,8,13,Monday
4,12,20,32,2017,7,20,Thursday
5,12,12,24,2017,7,28,Friday
1,13,14,27,2017,12,13,Wednseday
14,20,19,39,2018,7,13,Friday
1,8,10,18,2018,3,1,Thursday
2,11,1,12,2017,11,19,Sunday
2,8,5,13,2017,11,1,Wednseday
4,17,4,21,2017,6,15,Thursday
2,31,-13,18,2018,2,26,Monday
0,3,35,38,2018,6,8,Friday
1,9,20,29,2017,12,25,Monday
5,11,14,25,2018,1,11,Thursday
2,7,6,13,2018,2,28,Wednseday
1,7,20,27,2017,9,20,Wednseday
5,15,11,26,2017,11,16,Thursday
5,7,54,61,2017,6,2,Friday
2,4,17,21,2017,2,27,Monday
2,23,18,41,2017,10,14,Saturday
9,13,7,20,2017,11,7,Tuesday
2,3,15,18,2018,3,25,Sunday
1,15,17,32,2018,6,15,Friday
3,16,21,37,2017,7,8,Saturday
7,22,22,44,2017,2,8,Wednseday
2,10,11,21,2018,5,2,Wednseday
6,28,-2,26,2018,2,9,Friday
0,10,25,35,2017,4,10,Monday
6,20,6,26,2017,4,12,Wednseday
4,11,11,22,2017,6,29,Thursday
1,3,10,13,2017,7,6,Thursday
6,56,-31,25,2017,11,24,Friday
3,10,7,17,2018,4,8,Sunday
1,22,22,44,2018,4,3,Tuesday
3,26,5,31,2018,1,19,Friday
4,6,28,34,2017,11,17,Friday
2,10,14,24,2017,11,12,Sunday
5,18,7,25,2018,2,11,Sunday
5,20,10,30,2017,8,19,Saturday
5,12,10,22,2017,6,21,Wednseday
4,19,1,20,2018,2,15,Thursday
0,11,10,21,2018,4,13,Friday
9,11,-7,4,2018,8,6,Monday
4,11,13,24,2017,6,2,Friday
2,11,13,24,2018,1,22,Monday
2,10,31,41,2017,2,7,Tuesday
3,9,14,23,2018,4,17,Tuesday
1,6,10,16,2018,5,2,Wednseday
5,6,12,18,2018,3,18,Sunday
0,9,27,36,2017,1,25,Wednseday
0,2,24,26,2017,8,30,Wednseday
4,11,15,26,2017,12,7,Thursday
4,8,17,25,2018,4,19,Thursday
4,11,24,35,2018,8,17,Friday
0,19,22,41,2018,1,4,Thursday
1,13,7,20,2017,11,28,Tuesday
6,7,11,18,2018,4,27,Friday
8,22,-4,18,2018,3,11,Sunday
6,13,11,24,2017,9,12,Tuesday
2,7,8,15,2018,2,14,Wednseday
2,6,4,10,2017,11,21,Tuesday
2,24,-2,22,2018,2,20,Tuesday
5,17,2,19,2017,11,26,Sunday
1,2,20,22,2018,7,11,Wednseday
9,11,14,25,2017,2,6,Monday
1,7,22,29,2018,1,8,Monday
3,11,8,19,2018,3,16,Friday
1,6,15,21,2017,3,2,Thursday
1,3,1,4,2018,8,20,Monday
1,19,23,42,2018,2,8,Thursday
1,13,2,15,2018,7,10,Tuesday
1,4,4,8,2018,7,19,Thursday
1,6,2,8,2018,7,31,Tuesday
1,2,23,25,2018,6,3,Sunday
10,29,2,31,2018,5,6,Sunday
2,8,14,22,2017,7,24,Monday
3,10,15,25,2018,2,11,Sunday
2,6,7,13,2017,5,23,Tuesday
0,7,18,25,2018,4,27,Friday
1,38,-10,28,2018,2,28,Wednseday
4,8,26,34,2018,1,11,Thursday
4,7,8,15,2018,7,19,Thursday
4,14,33,47,2018,3,8,Thursday
0,3,10,13,2017,7,21,Friday
1,44,-16,28,2018,2,21,Wednseday
2,11,11,22,2017,3,19,Sunday
14,16,9,25,2018,5,18,Friday
5,11,34,45,2018,6,2,Saturday
1,10,14,24,2018,1,22,Monday
1,5,22,27,2017,12,22,Friday
1,2,12,14,2018,2,21,Wednseday
0,3,26,29,2017,7,11,Tuesday
0,2,10,12,2018,4,4,Wednseday
2,3,14,17,2018,2,12,Monday
4,5,7,12,2017,11,19,Sunday
4,23,11,34,2017,12,16,Saturday
3,14,12,26,2017,10,6,Friday
3,12,34,46,2018,5,26,Saturday
3,26,-6,20,2018,5,18,Friday
1,2,14,16,2018,1,3,Wednseday
3,61,-34,27,2017,12,16,Saturday
2,5,17,22,2017,10,22,Sunday
2,4,10,14,2017,6,6,Tuesday
11,22,7,29,2017,11,6,Monday
3,5,9,14,2018,2,16,Friday
3,10,26,36,2018,6,5,Tuesday
4,11,6,17,2018,4,3,Tuesday
2,9,20,29,2018,1,28,Sunday
6,12,27,39,2017,1,5,Thursday
4,19,15,34,2018,4,13,Friday
3,13,14,27,2017,7,7,Friday
1,15,20,35,2018,6,11,Monday
1,27,8,35,2018,6,14,Thursday
1,50,-28,22,2018,2,28,Wednseday
4,7,11,18,2018,5,10,Thursday
3,10,31,41,2018,6,1,Friday
1,2,12,14,2018,7,11,Wednseday
1,2,3,5,2018,8,8,Wednseday
2,16,2,18,2018,3,25,Sunday
3,18,20,38,2017,12,3,Sunday
1,23,-2,21,2018,5,16,Wednseday
3,5,18,23,2017,12,23,Saturday
5,18,24,42,2017,12,11,Monday
7,8,5,13,2018,3,28,Wednseday
4,17,7,24,2017,10,13,Friday
4,18,16,34,2018,5,18,Friday
2,52,-20,32,2018,3,11,Sunday
1,8,14,22,2017,9,11,Monday
0,5,15,20,2017,11,21,Tuesday
2,17,14,31,2018,2,20,Tuesday
1,15,14,29,2017,2,23,Thursday
1,7,28,35,2017,10,18,Wednseday
3,4,8,12,2018,4,7,Saturday
8,11,11,22,2017,5,11,Thursday
3,9,13,22,2018,3,25,Sunday
2,11,16,27,2018,4,5,Thursday
2,4,19,23,2018,5,6,Sunday
4,6,14,20,2018,2,22,Thursday
2,10,20,30,2017,5,28,Sunday
3,4,11,15,2018,2,11,Sunday
4,11,24,35,2018,6,7,Thursday
3,7,12,19,2018,3,16,Friday
19,24,10,34,2018,6,15,Friday
2,3,15,18,2018,4,22,Sunday
2,3,14,17,2017,11,25,Saturday
0,6,15,21,2018,5,11,Friday
2,7,9,16,2018,5,9,Wednseday
9,17,56,73,2018,8,13,Monday
4,21,-3,18,2018,3,2,Friday
1,13,14,27,2018,7,26,Thursday
0,28,-4,24,2018,3,16,Friday
7,13,20,33,2018,2,7,Wednseday
1,6,15,21,2017,3,7,Tuesday
2,15,16,31,2018,2,19,Monday
2,10,21,31,2017,12,16,Saturday
2,8,9,17,2018,5,13,Sunday
1,9,14,23,2018,7,18,Wednseday
3,24,14,38,2017,3,25,Saturday
1,2,10,12,2017,8,6,Sunday
5,15,20,35,2018,1,10,Wednseday
2,25,5,30,2018,2,24,Saturday
4,36,3,39,2018,1,22,Monday
2,11,17,28,2017,10,24,Tuesday
1,10,18,28,2017,10,6,Friday
1,16,14,30,2017,8,1,Tuesday
1,10,14,24,2017,11,26,Sunday
5,44,-18,26,2017,11,25,Saturday
6,7,6,13,2017,7,14,Friday
3,8,10,18,2018,4,30,Monday
4,31,1,32,2018,2,4,Sunday
6,18,8,26,2017,12,29,Friday
3,16,13,29,2017,12,4,Monday
4,7,13,20,2017,7,6,Thursday
1,5,13,18,2017,11,24,Friday
8,24,2,26,2018,2,28,Wednseday
3,10,8,18,2018,3,19,Monday
4,8,21,29,2017,11,16,Thursday
7,14,10,24,2017,11,28,Tuesday
5,20,15,35,2017,12,22,Friday
1,1,13,14,2018,7,2,Monday
1,4,12,16,2018,4,2,Monday
3,9,10,19,2018,5,5,Saturday
1,8,21,29,2018,4,16,Monday
3,39,-13,26,2018,2,24,Saturday
3,10,17,27,2018,1,26,Friday
2,5,41,46,2018,4,21,Saturday
1,11,3,14,2018,8,9,Thursday
3,9,11,20,2018,5,15,Tuesday
1,8,18,26,2017,12,3,Sunday
1,4,32,36,2017,1,23,Monday
2,7,12,19,2018,7,4,Wednseday
6,14,18,32,2018,3,9,Friday
1,11,8,19,2017,11,12,Sunday
4,11,16,27,2018,1,27,Saturday
4,12,20,32,2017,12,22,Friday
1,11,14,25,2018,4,9,Monday
1,11,10,21,2017,11,28,Tuesday
1,14,15,29,2017,12,20,Wednseday
3,11,15,26,2017,4,21,Friday
3,19,5,24,2018,7,14,Saturday
2,5,7,12,2018,7,28,Saturday
6,14,8,22,2017,8,30,Wednseday
2,12,8,20,2018,5,9,Wednseday
2,5,8,13,2018,3,22,Thursday
1,21,6,27,2017,11,16,Thursday
3,17,5,22,2018,8,5,Sunday
3,13,15,28,2017,7,25,Tuesday
3,11,16,27,2018,4,6,Friday
2,9,23,32,2018,1,13,Saturday
3,7,2,9,2018,5,9,Wednseday
4,12,21,33,2017,12,14,Thursday
5,11,21,32,2018,7,13,Friday
10,16,17,33,2018,5,26,Saturday
3,4,7,11,2018,6,17,Sunday
3,21,14,35,2018,1,2,Tuesday
2,7,14,21,2018,8,22,Wednseday
3,8,15,23,2018,4,16,Monday
5,11,13,24,2017,6,17,Saturday
3,18,12,30,2017,5,14,Sunday
1,11,12,23,2018,3,26,Monday
4,13,20,33,2017,6,1,Thursday
25,31,-7,24,2018,3,2,Friday
5,13,13,26,2018,7,18,Wednseday
3,18,8,26,2017,4,14,Friday
1,18,16,34,2017,7,13,Thursday
8,15,-2,13,2018,2,28,Wednseday
2,10,11,21,2018,3,5,Monday
4,22,9,31,2017,11,25,Saturday
2,15,8,23,2017,11,27,Monday
2,5,9,14,2017,11,27,Monday
5,9,17,26,2018,7,18,Wednseday
0,20,0,20,2018,7,13,Friday
7,15,18,33,2017,6,1,Thursday
5,14,7,21,2017,3,8,Wednseday
1,9,26,35,2018,8,6,Monday
8,14,13,27,2017,3,21,Tuesday
1,12,24,36,2018,6,7,Thursday
2,8,23,31,2017,7,16,Sunday
0,6,17,23,2018,4,18,Wednseday
1,9,13,22,2017,7,10,Monday
2,11,13,24,2017,7,29,Saturday
2,9,8,17,2017,9,4,Monday
1,20,1,21,2018,3,13,Tuesday
3,7,10,17,2017,6,30,Friday
3,11,12,23,2017,10,31,Tuesday
3,9,20,29,2018,7,22,Sunday
1,4,13,17,2018,7,16,Monday
1,5,10,15,2018,5,17,Thursday
1,4,20,24,2018,6,17,Sunday
0,7,18,25,2018,8,3,Friday
6,27,5,32,2017,6,30,Friday
5,12,10,22,2018,4,12,Thursday
0,6,7,13,2018,8,23,Thursday
7,11,15,26,2018,2,17,Saturday
8,20,12,32,2018,1,4,Thursday
2,6,19,25,2018,5,5,Saturday
0,2,18,20,2018,4,24,Tuesday
1,2,18,20,2017,12,19,Tuesday
0,31,2,33,2017,12,29,Friday
1,6,14,20,2018,8,1,Wednseday
11,23,22,45,2018,5,27,Sunday
1,8,6,14,2018,7,19,Thursday
3,11,21,32,2017,12,23,Saturday
2,3,21,24,2018,6,4,Monday
3,6,14,20,2018,6,9,Saturday
1,5,0,5,2018,8,16,Thursday
11,13,42,55,2016,10,4,Tuesday
7,32,-9,23,2017,11,27,Monday
2,4,9,13,2018,3,27,Tuesday
1,21,8,29,2018,4,16,Monday
10,17,3,20,2017,9,1,Friday
2,5,18,23,2018,7,7,Saturday
1,8,15,23,2018,1,28,Sunday
15,24,2,26,2017,4,9,Sunday
1,10,19,29,2018,2,6,Tuesday
3,11,13,24,2018,6,22,Friday
2,8,16,24,2017,8,8,Tuesday
4,19,7,26,2017,7,28,Friday
5,13,6,19,2018,3,29,Thursday
0,1,10,11,2017,10,23,Monday
1,14,15,29,2018,2,8,Thursday
5,14,3,17,2018,1,19,Friday
1,3,24,27,2018,7,4,Wednseday
2,16,14,30,2018,6,24,Sunday
8,15,42,57,2018,6,5,Tuesday
4,19,14,33,2018,4,26,Thursday
1,6,13,19,2017,8,30,Wednseday
7,13,16,29,2018,5,9,Wednseday
3,24,0,24,2018,2,2,Friday
4,23,7,30,2018,2,10,Saturday
2,7,18,25,2018,7,30,Monday
4,5,8,13,2018,6,21,Thursday
2,8,23,31,2017,10,29,Sunday
4,5,8,13,2017,7,20,Thursday
2,5,9,14,2018,2,12,Monday
2,12,11,23,2017,9,3,Sunday
2,12,22,34,2017,9,13,Wednseday
3,17,23,40,2018,6,2,Saturday
2,4,14,18,2017,4,23,Sunday
1,4,9,13,2018,6,21,Thursday
13,26,17,43,2018,2,8,Thursday
0,2,12,14,2018,5,8,Tuesday
2,3,8,11,2017,7,3,Monday
8,29,-7,22,2018,3,12,Monday
4,19,14,33,2017,5,4,Thursday
1,30,-12,18,2018,3,11,Sunday
2,3,8,11,2018,4,21,Saturday
0,10,6,16,2018,7,31,Tuesday
1,3,5,8,2018,5,15,Tuesday
4,12,13,25,2018,8,17,Friday
4,17,2,19,2018,3,23,Friday
3,11,15,26,2018,2,3,Saturday
2,7,9,16,2017,9,24,Sunday
5,45,-17,28,2018,4,6,Friday
0,10,21,31,2018,6,26,Tuesday
2,14,8,22,2018,5,2,Wednseday
1,12,22,34,2018,1,3,Wednseday
0,15,6,21,2017,4,4,Tuesday
4,17,2,19,2018,3,16,Friday
4,14,4,18,2017,9,15,Friday
2,6,34,40,2018,4,28,Saturday
1,6,15,21,2017,5,11,Thursday
2,6,12,18,2018,4,5,Thursday
2,12,-1,11,2018,4,1,Sunday
1,13,20,33,2017,12,6,Wednseday
1,14,15,29,2018,2,5,Monday
3,10,14,24,2018,4,27,Friday
4,12,8,20,2017,11,24,Friday
3,18,12,30,2017,11,26,Sunday
1,11,14,25,2017,6,29,Thursday
3,30,-9,21,2018,2,19,Monday
5,15,13,28,2017,11,2,Thursday
9,21,4,25,2018,2,19,Monday
5,17,24,41,2018,6,1,Friday
4,14,9,23,2017,5,22,Monday
1,6,19,25,2017,3,30,Thursday
6,38,-12,26,2017,10,13,Friday
2,6,21,27,2018,5,9,Wednseday
3,4,9,13,2017,5,19,Friday
2,6,15,21,2017,5,2,Tuesday
2,8,9,17,2017,10,23,Monday
14,16,-8,8,2018,5,7,Monday
0,4,26,30,2018,1,16,Tuesday
1,5,18,23,2017,11,22,Wednseday
3,27,4,31,2017,12,8,Friday
4,11,9,20,2018,6,15,Friday
14,23,6,29,2018,7,24,Tuesday
0,14,7,21,2018,3,26,Monday
8,21,7,28,2018,3,26,Monday
1,10,18,28,2018,1,8,Monday
7,12,7,19,2018,5,18,Friday
3,16,7,23,2017,5,20,Saturday
5,8,25,33,2018,6,20,Wednseday
42,44,-16,28,2017,4,11,Tuesday
9,22,14,36,2017,7,17,Monday
2,6,18,24,2018,6,26,Tuesday
1,10,12,22,2017,3,27,Monday
3,11,28,39,2017,2,4,Saturday
3,4,15,19,2018,4,14,Saturday
2,10,14,24,2017,9,3,Sunday
4,38,-4,34,2018,4,28,Saturday
2,5,29,34,2018,5,30,Wednseday
0,5,28,33,2017,2,15,Wednseday
1,7,4,11,2018,8,20,Monday
2,10,20,30,2017,3,27,Monday
2,16,2,18,2018,5,21,Monday
1,3,21,24,2018,6,17,Sunday
4,12,21,33,2018,6,29,Friday
3,16,8,24,2017,4,29,Saturday
7,17,7,24,2017,7,17,Monday
2,8,30,38,2018,6,25,Monday
5,8,12,20,2017,8,9,Wednseday
9,12,14,26,2017,5,6,Saturday
1,7,11,18,2018,8,16,Thursday
3,9,24,33,2018,7,14,Saturday
2,9,7,16,2018,5,7,Monday
3,40,6,46,2018,3,9,Friday
0,7,19,26,2018,4,13,Friday
3,16,28,44,2017,4,30,Sunday
5,11,14,25,2017,6,1,Thursday
5,6,5,11,2018,7,28,Saturday
4,10,15,25,2017,5,26,Friday
5,23,-3,20,2017,8,5,Saturday
1,7,20,27,2018,8,22,Wednseday
1,7,16,23,2018,1,24,Wednseday
7,14,12,26,2017,2,24,Friday
6,17,16,33,2018,1,31,Wednseday
1,3,12,15,2017,6,11,Sunday
5,21,-2,19,2018,3,22,Thursday
9,12,8,20,2017,5,11,Thursday
3,5,9,14,2018,2,28,Wednseday
2,7,12,19,2018,8,15,Wednseday
1,8,4,12,2018,8,9,Thursday
1,7,26,33,2018,8,16,Thursday
8,10,6,16,2018,1,14,Sunday
4,19,5,24,2018,3,4,Sunday
19,21,-8,13,2017,6,17,Saturday
2,10,18,28,2017,8,8,Tuesday
1,4,9,13,2017,6,29,Thursday
12,17,0,17,2018,5,18,Friday
3,18,7,25,2018,2,11,Sunday
1,18,10,28,2017,12,11,Monday
1,3,24,27,2017,2,22,Wednseday
5,12,13,25,2017,3,3,Friday
5,12,10,22,2017,8,10,Thursday
9,18,11,29,2018,2,18,Sunday
3,19,3,22,2018,1,15,Monday
1,8,1,9,2018,8,14,Tuesday
3,4,9,13,2017,11,3,Friday
1,2,12,14,2018,7,4,Wednseday
3,9,15,24,2017,7,15,Saturday
0,10,8,18,2018,7,16,Monday
4,10,16,26,2017,12,29,Friday
0,15,20,35,2018,6,20,Wednseday
1,9,24,33,2018,6,17,Sunday
4,11,8,19,2017,3,17,Friday
2,8,9,17,2017,9,12,Tuesday
2,4,16,20,2018,7,7,Saturday
4,15,7,22,2017,6,22,Thursday
1,8,15,23,2018,4,10,Tuesday
1,9,20,29,2017,8,8,Tuesday
2,7,24,31,2017,2,7,Tuesday
2,7,10,17,2018,1,1,Monday
1,4,19,23,2018,4,15,Sunday
1,6,14,20,2017,7,5,Wednseday
2,15,11,26,2018,1,13,Saturday
1,9,15,24,2018,6,18,Monday
2,8,12,20,2017,7,5,Wednseday
2,7,30,37,2017,4,5,Wednseday
2,8,10,18,2017,12,4,Monday
0,11,18,29,2018,2,8,Thursday
1,10,11,21,2018,5,14,Monday
-4,11,1,12,2018,8,18,Saturday
1,7,25,32,2017,8,7,Monday
9,13,11,24,2017,4,25,Tuesday
1,19,13,32,2017,1,22,Sunday
3,10,14,24,2017,5,16,Tuesday
0,12,9,21,2017,4,25,Tuesday
6,18,41,59,2017,11,25,Saturday
4,18,13,31,2018,3,30,Friday
1,16,3,19,2017,11,26,Sunday
3,24,-8,16,2018,4,2,Monday
2,9,31,40,2017,9,27,Wednseday
5,14,17,31,2018,1,26,Friday
4,19,14,33,2017,4,13,Thursday
3,10,17,27,2017,12,1,Friday
1,12,18,30,2017,11,15,Wednseday
4,7,19,26,2018,6,16,Saturday
1,12,11,23,2017,8,16,Wednseday
1,14,14,28,2018,4,9,Monday
2,11,20,31,2017,10,7,Saturday
0,8,14,22,2017,4,20,Thursday
3,11,15,26,2018,6,8,Friday
3,4,19,23,2018,1,6,Saturday
1,7,4,11,2018,8,13,Monday
3,6,7,13,2017,5,19,Friday
1,3,14,17,2017,4,25,Tuesday
3,10,9,19,2018,3,24,Saturday
1,4,11,15,2018,6,18,Monday
1,6,10,16,2018,7,18,Wednseday
3,6,23,29,2018,3,18,Sunday
4,30,-2,28,2018,1,8,Monday
1,6,16,22,2018,1,10,Wednseday
1,22,1,23,2018,3,20,Tuesday
0,20,34,54,2018,5,17,Thursday
1,9,14,23,2017,8,8,Tuesday
5,47,-19,28,2017,4,28,Friday
3,12,12,24,2017,11,26,Sunday
3,22,-7,15,2017,11,26,Sunday
3,10,22,32,2017,9,22,Friday
1,7,18,25,2018,1,25,Thursday
7,13,12,25,2018,2,9,Friday
5,17,8,25,2017,11,24,Friday
1,8,22,30,2018,6,18,Monday
2,22,0,22,2018,3,26,Monday
5,19,13,32,2017,3,23,Thursday
3,18,5,23,2017,10,17,Tuesday
3,10,16,26,2017,12,1,Friday
4,12,13,25,2017,11,10,Friday
1,9,19,28,2017,6,5,Monday
4,5,10,15,2017,11,12,Sunday
2,4,13,17,2018,1,15,Monday
2,10,19,29,2018,2,7,Wednseday
2,4,19,23,2018,6,18,Monday
3,19,14,33,2018,5,27,Sunday
4,7,13,20,2018,6,15,Friday
3,9,11,20,2017,10,28,Saturday
5,7,17,24,2017,4,28,Friday
5,23,8,31,2018,2,24,Saturday
5,11,14,25,2018,5,3,Thursday
1,4,9,13,2018,3,6,Tuesday
3,12,0,12,2017,11,5,Sunday
2,7,19,26,2017,12,20,Wednseday
3,13,10,23,2018,4,21,Saturday
1,15,1,16,2018,5,21,Monday
4,11,7,18,2018,2,26,Monday
4,13,6,19,2018,3,29,Thursday
2,9,13,22,2017,10,16,Monday
4,13,9,22,2017,5,21,Sunday
3,22,13,35,2017,5,15,Monday
1,2,9,11,2018,6,24,Sunday
1,11,9,20,2018,8,16,Thursday
2,17,11,28,2018,4,16,Monday
1,7,16,23,2018,5,16,Wednseday
2,3,6,9,2018,4,30,Monday
1,8,24,32,2018,4,19,Thursday
1,7,22,29,2018,1,3,Wednseday
0,1,14,15,2018,1,16,Tuesday
1,20,17,37,2017,11,29,Wednseday
1,13,16,29,2017,2,23,Thursday
2,17,6,23,2018,1,10,Wednseday
1,10,31,41,2018,2,27,Tuesday
3,14,13,27,2017,11,24,Friday
12,25,-4,21,2018,8,2,Thursday
1,4,2,6,2018,8,16,Thursday
4,10,16,26,2018,5,11,Friday
2,5,22,27,2018,4,28,Saturday
3,5,16,21,2017,4,7,Friday
2,18,22,40,2018,5,26,Saturday
0,6,20,26,2018,5,2,Wednseday
1,35,-12,23,2018,2,26,Monday
5,26,13,39,2018,3,30,Friday
8,48,-19,29,2018,7,11,Wednseday
1,9,53,62,2018,5,29,Tuesday
6,14,21,35,2017,12,20,Wednseday
4,21,-7,14,2017,11,24,Friday
1,8,8,16,2018,7,23,Monday
4,8,18,26,2017,10,5,Thursday
2,17,19,36,2017,12,11,Monday
12,23,6,29,2017,12,24,Sunday
3,10,8,18,2017,11,6,Monday
5,15,11,26,2017,10,1,Sunday
1,5,22,27,2018,1,25,Thursday
5,9,16,25,2018,5,5,Saturday
0,4,9,13,2017,7,21,Friday
2,5,8,13,2017,10,25,Wednseday
1,5,22,27,2017,12,14,Thursday
1,23,-2,21,2018,4,3,Tuesday
1,5,13,18,2018,5,17,Thursday
2,8,17,25,2017,6,5,Monday
2,31,-4,27,2017,11,25,Saturday
3,40,11,51,2018,1,21,Sunday
7,9,11,20,2017,10,10,Tuesday
2,5,25,30,2018,8,18,Saturday
2,6,24,30,2017,8,15,Tuesday
1,2,8,10,2017,10,16,Monday
1,7,17,24,2018,1,22,Monday
3,31,-4,27,2017,5,6,Saturday
12,18,16,34,2017,12,2,Saturday
1,9,16,25,2018,5,24,Thursday
1,22,-2,20,2018,2,22,Thursday
1,2,9,11,2018,5,7,Monday
6,17,6,23,2017,5,3,Wednseday
1,29,-1,28,2018,2,27,Tuesday
1,24,10,34,2018,6,20,Wednseday
7,11,31,42,2018,6,4,Monday
7,18,2,20,2017,11,9,Thursday
3,4,7,11,2018,8,11,Saturday
1,9,19,28,2018,5,7,Monday
2,6,7,13,2018,8,7,Tuesday
2,19,7,26,2017,8,30,Wednseday
2,5,18,23,2017,8,19,Saturday
1,4,13,17,2017,3,21,Tuesday
1,8,21,29,2017,4,12,Wednseday
0,6,18,24,2018,1,26,Friday
8,39,-12,27,2018,3,30,Friday
2,9,26,35,2018,4,30,Monday
6,14,27,41,2018,1,23,Tuesday
3,6,19,25,2017,12,1,Friday
4,11,4,15,2018,8,6,Monday
12,13,15,28,2018,3,8,Thursday
1,2,25,27,2018,4,12,Thursday
3,25,-2,23,2018,6,11,Monday
3,18,14,32,2018,1,5,Friday
0,1,7,8,2018,5,3,Thursday
0,13,15,28,2017,6,29,Thursday
2,39,-7,32,2018,2,18,Sunday
4,17,9,26,2018,4,6,Friday
10,18,8,26,2017,5,21,Sunday
4,15,7,22,2017,7,6,Thursday
2,6,19,25,2018,4,14,Saturday
4,11,14,25,2017,11,10,Friday
12,14,7,21,2017,12,22,Friday
2,7,13,20,2018,3,20,Tuesday
1,3,8,11,2018,6,17,Sunday
12,32,-7,25,2018,4,28,Saturday
1,7,13,20,2018,7,4,Wednseday
1,27,20,47,2018,4,26,Thursday
0,5,21,26,2017,1,25,Wednseday
1,3,14,17,2018,4,23,Monday
1,8,10,18,2018,3,8,Thursday
2,9,11,20,2017,11,11,Saturday
3,12,15,27,2017,6,24,Saturday
3,9,14,23,2017,8,26,Saturday
0,9,18,27,2018,5,3,Thursday
1,2,13,15,2018,4,4,Wednseday
2,8,11,19,2017,11,19,Sunday
1,8,11,19,2017,7,16,Sunday
7,21,21,42,2018,4,6,Friday
1,6,20,26,2018,8,16,Thursday
4,7,13,20,2018,6,14,Thursday
3,24,0,24,2017,7,4,Tuesday
5,13,9,22,2017,11,23,Thursday
4,17,7,24,2017,12,4,Monday
2,10,14,24,2017,7,10,Monday
3,10,14,24,2018,2,16,Friday
2,3,10,13,2017,8,29,Tuesday
1,18,6,24,2018,3,19,Monday
0,8,26,34,2018,1,3,Wednseday
1,6,7,13,2017,11,16,Thursday
11,27,-5,22,2018,1,18,Thursday
3,4,20,24,2017,10,20,Friday
5,14,14,28,2017,7,21,Friday
0,8,11,19,2018,8,22,Wednseday
3,8,15,23,2018,1,14,Sunday
3,18,0,18,2017,11,27,Monday
5,23,-6,17,2018,3,5,Monday
4,16,19,35,2017,8,28,Monday
0,32,-8,24,2018,3,9,Friday
1,8,28,36,2017,8,14,Monday
8,18,5,23,2018,5,28,Monday
1,9,13,22,2018,7,24,Tuesday
7,12,19,31,2018,4,16,Monday
4,12,12,24,2017,7,22,Saturday
1,2,6,8,2018,7,25,Wednseday
5,12,31,43,2018,7,19,Thursday
3,6,14,20,2017,12,16,Saturday
1,13,15,28,2017,10,3,Tuesday
2,14,15,29,2018,1,16,Tuesday
0,13,30,43,2017,1,31,Tuesday
5,42,-15,27,2018,1,24,Wednseday
2,10,20,30,2018,6,26,Tuesday
1,19,8,27,2017,12,7,Thursday
2,4,10,14,2017,11,28,Tuesday
4,14,15,29,2018,1,25,Thursday
1,14,20,34,2017,12,21,Thursday
1,3,5,8,2018,7,23,Monday
4,7,11,18,2018,5,10,Thursday
10,21,7,28,2018,1,9,Tuesday
1,6,15,21,2018,5,9,Wednseday
4,17,13,30,2018,4,28,Saturday
1,22,19,41,2017,1,18,Wednseday
1,10,17,27,2018,6,26,Tuesday
4,10,12,22,2018,2,12,Monday
3,5,19,24,2017,3,3,Friday
11,24,11,35,2017,5,12,Friday
1,11,6,17,2017,3,6,Monday
0,9,22,31,2018,8,13,Monday
12,21,16,37,2018,6,9,Saturday
3,30,0,30,2018,1,27,Saturday
4,6,6,12,2018,3,10,Saturday
2,6,20,26,2018,6,23,Saturday
2,15,34,49,2018,4,30,Monday
1,13,15,28,2017,11,28,Tuesday
5,29,-7,22,2018,2,22,Thursday
0,6,29,35,2018,1,25,Thursday
3,7,17,24,2017,8,4,Friday
1,2,8,10,2018,3,19,Monday
2,16,13,29,2018,7,9,Monday
0,7,10,17,2017,3,21,Tuesday
0,17,7,24,2018,2,27,Tuesday
3,6,14,20,2017,6,23,Friday
2,15,27,42,2018,6,5,Tuesday
2,8,15,23,2018,2,14,Wednseday
1,10,10,20,2017,9,14,Thursday
3,20,6,26,2018,1,31,Wednseday
9,21,8,29,2017,11,27,Monday
1,12,11,23,2018,3,28,Wednseday
1,15,31,46,2018,6,7,Thursday
3,11,12,23,2018,4,24,Tuesday
2,6,8,14,2018,7,24,Tuesday
1,2,11,13,2018,5,2,Wednseday
7,20,1,21,2017,11,29,Wednseday
0,36,-6,30,2018,1,23,Tuesday
2,4,22,26,2018,2,3,Saturday
5,14,13,27,2018,4,5,Thursday
4,16,14,30,2018,1,20,Saturday
3,24,13,37,2018,4,7,Saturday
2,5,11,16,2017,12,6,Wednseday
0,28,5,33,2018,2,8,Thursday
3,7,17,24,2017,7,21,Friday
3,12,12,24,2017,6,23,Friday
1,18,4,22,2018,5,17,Thursday
1,7,15,22,2017,7,11,Tuesday
1,7,18,25,2017,6,15,Thursday
8,14,15,29,2017,7,11,Tuesday
4,11,9,20,2018,2,16,Friday
1,28,-8,20,2018,2,27,Tuesday
2,15,13,28,2018,1,24,Wednseday
1,11,11,22,2017,11,20,Monday
1,4,12,16,2017,12,4,Monday
2,7,17,24,2017,7,31,Monday
1,2,8,10,2018,7,23,Monday
1,4,6,10,2018,8,3,Friday
2,25,0,25,2018,3,3,Saturday
7,63,-27,36,2018,2,7,Wednseday
2,7,23,30,2018,4,18,Wednseday
1,13,9,22,2018,3,21,Wednseday
2,5,14,19,2017,12,17,Sunday
1,9,15,24,2018,2,5,Monday
7,11,2,13,2017,9,1,Friday
8,38,-8,30,2017,11,26,Sunday
6,28,-8,20,2018,3,23,Friday
2,23,9,32,2017,6,19,Monday
1,10,11,21,2017,10,10,Tuesday
2,3,13,16,2018,4,10,Tuesday
1,12,7,19,2018,2,25,Sunday
2,16,10,26,2017,9,6,Wednseday
11,14,-6,8,2018,8,9,Thursday
2,3,11,14,2017,7,17,Monday
2,17,14,31,2017,8,15,Tuesday
4,27,35,62,2018,6,7,Thursday
2,10,12,22,2017,11,26,Sunday
1,4,13,17,2017,10,23,Monday
6,19,15,34,2018,2,8,Thursday
2,17,13,30,2017,11,7,Tuesday
5,16,15,31,2017,6,25,Sunday
4,24,15,39,2017,12,9,Saturday
3,20,-1,19,2017,9,17,Sunday
4,24,2,26,2018,2,17,Saturday
11,12,11,23,2018,5,6,Sunday
2,7,10,17,2018,6,11,Monday
1,13,41,54,2017,9,20,Wednseday
6,16,6,22,2017,8,29,Tuesday
3,9,7,16,2017,9,11,Monday
5,11,26,37,2017,12,31,Sunday
1,13,6,19,2018,3,22,Thursday
1,2,34,36,2017,11,23,Thursday
4,19,12,31,2017,3,24,Friday
1,2,34,36,2018,7,2,Monday
4,6,7,13,2018,3,29,Thursday
1,39,-10,29,2018,7,24,Tuesday
2,7,29,36,2018,6,27,Wednseday
5,13,-8,5,2018,8,2,Thursday
3,6,19,25,2017,7,15,Saturday
1,4,1,5,2018,8,5,Sunday
6,9,20,29,2018,6,13,Wednseday
5,7,15,22,2018,1,10,Wednseday
2,3,1,4,2018,8,6,Monday
1,15,20,35,2018,1,4,Thursday
2,8,8,16,2018,8,19,Sunday
6,12,9,21,2017,11,16,Thursday
3,8,20,28,2017,9,11,Monday
3,11,12,23,2017,11,18,Saturday
14,18,-4,14,2017,11,9,Thursday
2,26,3,29,2018,3,18,Sunday
2,6,14,20,2017,7,8,Saturday
9,9,3,12,2018,4,4,Wednseday
19,21,-4,17,2017,11,25,Saturday
6,15,9,24,2018,1,14,Sunday
8,31,9,40,2017,4,5,Wednseday
12,17,10,27,2018,1,12,Friday
3,5,20,25,2018,6,1,Friday
1,6,21,27,2018,1,3,Wednseday
7,53,-22,31,2017,10,9,Monday
2,3,15,18,2018,1,14,Sunday
2,6,23,29,2017,4,4,Tuesday
1,7,21,28,2017,12,7,Thursday
0,12,14,26,2017,3,31,Friday
1,6,14,20,2017,6,27,Tuesday
3,11,9,20,2018,5,12,Saturday
2,6,2,8,2018,8,15,Wednseday
1,6,14,20,2018,2,22,Thursday
1,37,-11,26,2017,12,3,Sunday
3,7,10,17,2018,7,13,Friday
3,18,9,27,2017,4,15,Saturday
2,17,5,22,2018,5,20,Sunday
1,4,4,8,2018,8,2,Thursday
2,9,14,23,2017,8,16,Wednseday
1,41,-7,34,2017,3,16,Thursday
28,34,9,43,2017,11,22,Wednseday
2,14,8,22,2018,3,26,Monday
1,14,1,15,2018,5,21,Monday
3,10,21,31,2018,8,17,Friday
2,19,3,22,2017,7,19,Wednseday
1,5,26,31,2017,12,18,Monday
1,17,4,21,2018,2,14,Wednseday
22,31,-4,27,2018,4,17,Tuesday
2,14,10,24,2017,9,12,Tuesday
2,26,-8,18,2018,3,3,Saturday
3,17,9,26,2017,9,9,Saturday
2,3,11,14,2018,2,26,Monday
0,8,3,11,2017,7,3,Monday
3,5,7,12,2017,7,16,Sunday
6,10,14,24,2017,5,23,Tuesday
0,10,13,23,2017,5,8,Monday
10,13,52,65,2016,10,4,Tuesday
5,8,14,22,2018,8,9,Thursday
7,9,7,16,2018,1,2,Tuesday
5,6,12,18,2018,4,12,Thursday
3,5,14,19,2018,4,15,Sunday
6,11,15,26,2018,4,27,Friday
2,9,8,17,2018,7,22,Sunday
5,14,15,29,2018,4,18,Wednseday
2,9,19,28,2018,7,3,Tuesday
2,15,11,26,2017,6,11,Sunday
1,7,4,11,2018,8,6,Monday
2,6,16,22,2017,10,4,Wednseday
0,5,22,27,2017,2,17,Friday
0,1,11,12,2018,6,13,Wednseday
1,16,11,27,2017,5,23,Tuesday
2,9,24,33,2018,1,3,Wednseday
1,15,34,49,2018,4,19,Thursday
0,11,16,27,2018,8,3,Friday
3,14,8,22,2018,3,19,Monday
4,14,10,24,2017,10,7,Saturday
2,4,-1,3,2018,8,7,Tuesday
1,10,19,29,2018,6,12,Tuesday
7,13,10,23,2017,11,29,Wednseday
7,13,6,19,2018,3,22,Thursday
1,19,9,28,2018,2,1,Thursday
1,16,7,23,2018,5,22,Tuesday
2,7,15,22,2017,10,1,Sunday
1,14,20,34,2018,2,6,Tuesday
3,7,23,30,2018,6,26,Tuesday
2,22,2,24,2018,1,15,Monday
4,13,7,20,2017,5,12,Friday
1,10,33,43,2018,8,20,Monday
10,16,12,28,2018,4,16,Monday
1,9,19,28,2017,11,22,Wednseday
1,6,23,29,2018,2,27,Tuesday
7,22,21,43,2018,2,12,Monday
2,15,11,26,2017,2,5,Sunday
1,2,15,17,2018,1,9,Tuesday
4,15,11,26,2017,7,27,Thursday
2,25,8,33,2017,8,23,Wednseday
11,20,19,39,2017,11,25,Saturday
3,4,10,14,2018,6,29,Friday
2,6,21,27,2017,5,23,Tuesday
5,12,15,27,2018,6,28,Thursday
2,9,13,22,2017,8,1,Tuesday
4,16,20,36,2017,2,27,Monday
0,12,17,29,2018,2,7,Wednseday
4,33,-10,23,2017,11,25,Saturday
4,7,11,18,2018,1,6,Saturday
1,16,11,27,2017,8,9,Wednseday
6,11,15,26,2018,4,27,Friday
0,23,-1,22,2017,10,9,Monday
3,8,19,27,2018,6,15,Friday
2,9,16,25,2017,10,9,Monday
2,16,9,25,2018,2,5,Monday
3,7,20,27,2017,7,18,Tuesday
1,11,21,32,2018,2,4,Sunday
1,6,3,9,2018,8,7,Tuesday
1,20,13,33,2017,3,23,Thursday
2,9,14,23,2017,9,3,Sunday
5,15,9,24,2017,2,26,Sunday
4,19,0,19,2017,3,17,Friday
1,9,13,22,2018,7,17,Tuesday
0,18,2,20,2017,8,25,Friday
3,11,13,24,2017,4,2,Sunday
1,15,23,38,2018,4,9,Monday
18,18,8,26,2017,7,22,Saturday
2,15,8,23,2018,3,11,Sunday
6,16,4,20,2017,11,15,Wednseday
3,12,19,31,2018,2,2,Friday
2,9,43,52,2017,2,5,Sunday
1,17,7,24,2017,12,18,Monday
1,2,8,10,2018,6,19,Tuesday
3,10,14,24,2017,7,31,Monday
1,8,17,25,2017,6,8,Thursday
2,8,16,24,2017,10,1,Sunday
14,60,-21,39,2018,3,22,Thursday
2,16,9,25,2017,5,7,Sunday
1,16,16,32,2017,12,7,Thursday
1,8,7,15,2018,7,30,Monday
5,18,15,33,2018,1,6,Saturday
4,12,4,16,2018,2,24,Saturday
2,9,16,25,2017,8,19,Saturday
2,36,-7,29,2017,9,24,Sunday
17,36,0,36,2018,1,9,Tuesday
2,13,15,28,2018,5,9,Wednseday
5,6,5,11,2017,5,12,Friday
2,3,11,14,2017,11,20,Monday
1,12,21,33,2017,2,22,Wednseday
2,7,24,31,2017,12,4,Monday
5,6,7,13,2017,7,28,Friday
1,70,-35,35,2018,4,23,Monday
2,13,28,41,2018,6,6,Wednseday
2,10,20,30,2017,11,6,Monday
18,25,2,27,2018,7,13,Friday
12,13,13,26,2018,5,30,Wednseday
2,13,22,35,2018,2,7,Wednseday
1,10,9,19,2017,10,4,Wednseday
5,11,11,22,2017,6,22,Thursday
4,17,9,26,2018,2,23,Friday
2,15,14,29,2018,4,18,Wednseday
4,12,23,35,2018,7,26,Thursday
3,4,7,11,2018,4,30,Monday
0,20,14,34,2018,6,21,Thursday
2,7,14,21,2018,2,14,Wednseday
3,5,14,19,2017,3,17,Friday
1,21,-1,20,2017,11,8,Wednseday
1,10,18,28,2018,2,26,Monday
2,22,0,22,2017,11,29,Wednseday
4,19,6,25,2017,8,24,Thursday
1,7,17,24,2017,9,25,Monday
1,4,9,13,2018,8,16,Thursday
2,15,2,17,2018,4,1,Sunday
2,11,10,21,2018,3,5,Monday
1,5,18,23,2017,10,15,Sunday
6,19,11,30,2017,8,16,Wednseday
5,12,29,41,2018,1,12,Friday
1,15,9,24,2018,4,6,Friday
6,13,10,23,2018,1,24,Wednseday
3,10,14,24,2018,8,17,Friday
3,5,21,26,2017,12,1,Friday
9,29,1,30,2018,2,18,Sunday
2,13,14,27,2017,3,15,Wednseday
5,13,22,35,2018,5,23,Wednseday
2,11,20,31,2017,1,16,Monday
2,7,26,33,2018,6,20,Wednseday
2,5,8,13,2018,7,28,Saturday
4,39,-5,34,2017,3,16,Thursday
2,9,13,22,2017,3,27,Monday
3,8,0,8,2018,7,30,Monday
6,16,27,43,2017,1,15,Sunday
2,3,16,19,2018,6,23,Saturday
2,14,21,35,2017,8,22,Tuesday
19,31,12,43,2018,4,11,Wednseday
1,17,1,18,2018,3,26,Monday
14,22,7,29,2017,9,4,Monday
2,7,16,23,2018,6,27,Wednseday
2,14,6,20,2017,8,30,Wednseday
1,11,20,31,2017,7,30,Sunday
1,60,-21,39,2017,1,26,Thursday
1,2,5,7,2018,8,1,Wednseday
8,12,8,20,2018,4,25,Wednseday
2,38,6,44,2018,3,13,Tuesday
0,21,6,27,2017,12,13,Wednseday
7,11,7,18,2017,10,30,Monday
2,13,24,37,2018,6,6,Wednseday
4,12,13,25,2018,4,5,Thursday
2,14,17,31,2017,8,21,Monday
6,19,3,22,2017,11,22,Wednseday
5,6,0,6,2018,8,23,Thursday
1,7,14,21,2018,5,9,Wednseday
4,7,18,25,2017,6,23,Friday
5,14,17,31,2017,11,17,Friday
3,16,14,30,2018,4,21,Saturday
1,23,20,43,2017,3,28,Tuesday
3,5,14,19,2017,9,1,Friday
1,11,9,20,2018,3,8,Thursday
0,7,12,19,2018,7,19,Thursday
22,27,0,27,2018,6,14,Thursday
1,5,6,11,2018,3,11,Sunday
6,17,8,25,2018,2,24,Saturday
3,20,11,31,2017,7,18,Tuesday
7,11,12,23,2017,2,27,Monday
2,3,3,6,2018,8,21,Tuesday
2,5,9,14,2017,11,9,Thursday
6,23,25,48,2017,10,5,Thursday
0,16,24,40,2018,1,25,Thursday
1,9,7,16,2017,11,22,Wednseday
3,23,-3,20,2018,5,19,Saturday
1,5,18,23,2018,4,11,Wednseday
1,18,12,30,2018,3,25,Sunday
4,15,7,22,2017,7,27,Thursday
3,13,4,17,2017,9,19,Tuesday
1,8,10,18,2018,8,19,Sunday
1,12,-8,4,2018,7,30,Monday
3,4,10,14,2018,1,26,Friday
1,3,22,25,2017,4,17,Monday
4,8,6,14,2017,6,5,Monday
5,14,4,18,2018,3,2,Friday
4,24,-5,19,2018,3,2,Friday
3,7,14,21,2018,4,6,Friday
2,10,12,22,2017,5,23,Tuesday
3,17,6,23,2018,3,18,Sunday
12,22,2,24,2017,11,12,Sunday
1,11,14,25,2017,6,1,Thursday
2,18,6,24,2018,6,25,Monday
1,2,24,26,2017,12,27,Wednseday
4,11,10,21,2017,3,17,Friday
0,5,17,22,2018,6,28,Thursday
5,19,6,25,2017,9,14,Thursday
1,6,8,14,2018,7,18,Wednseday
5,39,-7,32,2018,1,19,Friday
2,8,8,16,2018,1,14,Sunday
1,3,8,11,2018,3,26,Monday
1,4,4,8,2018,7,26,Thursday
1,7,22,29,2017,2,6,Monday
2,15,20,35,2018,1,30,Tuesday
3,4,8,12,2018,7,7,Saturday
1,10,14,24,2017,9,17,Sunday
4,15,2,17,2017,10,23,Monday
1,19,14,33,2018,3,15,Thursday
2,7,27,34,2017,6,17,Saturday
2,5,14,19,2018,7,21,Saturday
2,11,17,28,2017,11,23,Thursday
2,9,8,17,2018,8,4,Saturday
1,4,11,15,2018,7,23,Monday
1,14,-4,10,2017,9,11,Monday
1,7,13,20,2017,7,25,Tuesday
0,6,15,21,2017,8,22,Tuesday
1,8,14,22,2018,1,16,Tuesday
5,8,32,40,2017,12,28,Thursday
0,1,4,5,2018,8,16,Thursday
3,9,15,24,2018,5,20,Sunday
1,22,21,43,2017,6,4,Sunday
3,5,21,26,2018,4,27,Friday
1,7,30,37,2018,4,18,Wednseday
1,2,12,14,2018,5,3,Thursday
8,15,18,33,2017,6,11,Sunday
2,13,19,32,2017,12,9,Saturday
6,12,14,26,2018,3,22,Thursday
1,23,8,31,2017,10,22,Sunday
1,6,22,28,2018,4,5,Thursday
3,5,11,16,2018,2,24,Saturday
1,17,5,22,2017,8,20,Sunday
5,7,13,20,2018,6,14,Thursday
1,32,5,37,2017,4,9,Sunday
1,2,29,31,2018,6,25,Monday
1,18,12,30,2018,1,7,Sunday
3,7,6,13,2018,3,30,Friday
1,28,-7,21,2018,5,2,Wednseday
2,40,-7,33,2017,11,30,Thursday
2,4,7,11,2017,11,6,Monday
4,6,17,23,2018,1,27,Saturday
8,15,9,24,2017,6,4,Sunday
1,7,14,21,2018,3,8,Thursday
1,2,16,18,2018,5,24,Thursday
2,11,13,24,2017,9,11,Monday
5,16,11,27,2017,10,18,Wednseday
6,28,1,29,2018,1,10,Wednseday
0,17,5,22,2018,5,21,Monday
3,6,17,23,2017,8,12,Saturday
4,10,9,19,2018,8,3,Friday
1,22,10,32,2017,12,25,Monday
1,6,21,27,2017,12,20,Wednseday
0,7,13,20,2018,7,27,Friday
1,8,11,19,2018,3,15,Thursday
2,6,6,12,2017,9,9,Saturday
4,5,12,17,2017,12,3,Sunday
0,13,20,33,2017,5,19,Friday
2,21,-4,17,2018,8,11,Saturday
4,18,17,35,2017,12,11,Monday
3,10,1,11,2018,8,6,Monday
4,9,13,22,2017,6,19,Monday
1,8,12,20,2018,5,8,Tuesday
2,4,5,9,2018,7,22,Sunday
1,3,13,16,2018,1,30,Tuesday
1,2,3,5,2018,8,15,Wednseday
5,24,21,45,2017,4,29,Saturday
13,17,11,28,2018,3,16,Friday
1,5,12,17,2018,7,20,Friday
4,12,13,25,2017,7,14,Friday
4,10,8,18,2018,2,26,Monday
4,14,11,25,2017,11,4,Saturday
2,13,16,29,2018,3,20,Tuesday
2,3,8,11,2018,3,26,Monday
3,19,12,31,2017,12,30,Saturday
1,4,20,24,2018,4,16,Monday
3,11,11,22,2017,9,17,Sunday
3,10,11,21,2017,11,24,Friday
3,20,0,20,2017,11,28,Tuesday
5,11,22,33,2017,11,23,Thursday
1,3,13,16,2017,10,3,Tuesday
2,7,10,17,2017,8,29,Tuesday
1,8,15,23,2017,9,5,Tuesday
3,7,2,9,2018,8,6,Monday
2,14,9,23,2018,5,21,Monday
1,4,15,19,2018,4,19,Thursday
2,8,11,19,2018,3,25,Sunday
2,3,10,13,2017,8,22,Tuesday
5,6,5,11,2018,8,23,Thursday
2,14,13,27,2018,4,5,Thursday
1,6,28,34,2018,1,2,Tuesday
1,2,9,11,2018,4,1,Sunday
12,20,14,34,2018,2,21,Wednseday
1,11,7,18,2017,12,18,Monday
7,11,23,34,2017,12,8,Friday
2,5,22,27,2018,6,6,Wednseday
5,6,7,13,2018,3,28,Wednseday
5,22,6,28,2018,2,1,Thursday
2,12,13,25,2017,8,19,Saturday
1,36,-14,22,2018,3,5,Monday
2,10,28,38,2018,5,1,Tuesday
0,32,-8,24,2018,3,9,Friday
1,5,17,22,2017,11,5,Sunday
2,3,8,11,2017,8,14,Monday
3,14,7,21,2018,4,23,Monday
3,9,19,28,2017,7,3,Monday
0,6,21,27,2017,5,23,Tuesday
2,14,10,24,2017,7,11,Tuesday
1,10,42,52,2018,5,29,Tuesday
0,14,9,23,2018,4,18,Wednseday
4,27,9,36,2017,11,30,Thursday
7,19,6,25,2017,8,21,Monday
0,2,10,12,2018,3,9,Friday
1,7,16,23,2017,6,5,Monday
2,6,11,17,2017,12,3,Sunday
4,5,12,17,2017,6,18,Sunday
2,18,8,26,2018,2,25,Sunday
2,3,20,23,2018,7,1,Sunday
8,50,-13,37,2017,12,4,Monday
1,12,10,22,2017,8,30,Wednseday
7,15,24,39,2017,2,2,Thursday
3,4,1,5,2018,8,3,Friday
6,13,7,20,2017,11,28,Tuesday
5,11,6,17,2018,2,4,Sunday
2,22,1,23,2017,11,28,Tuesday
1,7,20,27,2017,10,4,Wednseday
1,15,12,27,2018,3,6,Tuesday
3,19,6,25,2017,11,24,Friday
0,19,14,33,2017,12,1,Friday
2,13,8,21,2017,3,1,Wednseday
3,4,20,24,2017,7,28,Friday
6,11,28,39,2017,1,5,Thursday
3,5,6,11,2018,8,3,Friday
7,9,6,15,2017,11,28,Tuesday
3,4,8,12,2017,10,13,Friday
6,12,29,41,2017,2,9,Thursday
1,19,16,35,2018,5,17,Thursday
2,20,6,26,2018,2,7,Wednseday
1,16,18,34,2017,6,8,Thursday
2,36,-6,30,2018,2,6,Tuesday
2,10,17,27,2017,10,21,Saturday
1,16,10,26,2017,5,28,Sunday
2,22,1,23,2018,2,27,Tuesday
0,7,18,25,2018,4,5,Thursday
1,3,34,37,2018,6,25,Monday
1,14,13,27,2018,5,9,Wednseday
3,7,10,17,2017,9,22,Friday
5,12,9,21,2017,11,1,Wednseday
2,8,9,17,2018,5,8,Tuesday
5,32,-6,26,2018,3,9,Friday
2,6,13,19,2018,3,21,Wednseday
3,14,20,34,2018,1,5,Friday
4,12,26,38,2017,6,9,Friday
4,21,0,21,2018,3,29,Thursday
1,10,1,11,2018,3,26,Monday
0,4,10,14,2018,5,15,Tuesday
14,18,3,21,2018,5,22,Tuesday
0,14,34,48,2018,2,9,Friday
1,40,-11,29,2017,12,4,Monday
0,1,12,13,2018,3,6,Tuesday
12,27,1,28,2018,1,18,Thursday
1,7,11,18,2017,9,18,Monday
3,6,29,35,2017,1,27,Friday
1,8,21,29,2017,7,19,Wednseday
1,7,6,13,2017,8,2,Wednseday
1,6,26,32,2018,8,12,Sunday
2,4,1,5,2018,8,18,Saturday
2,9,13,22,2017,11,27,Monday
1,6,14,20,2017,5,18,Thursday
3,5,6,11,2018,8,3,Friday
4,12,6,18,2018,3,31,Saturday
1,3,13,16,2017,12,4,Monday
5,16,4,20,2018,3,2,Friday
3,7,17,24,2018,5,8,Tuesday
1,7,15,22,2018,5,2,Wednseday
2,9,19,28,2017,10,30,Monday
3,20,9,29,2018,6,19,Tuesday
2,4,22,26,2018,2,3,Saturday
4,6,19,25,2018,4,21,Saturday
11,19,2,21,2017,3,3,Friday
2,4,1,5,2018,8,18,Saturday
6,11,16,27,2017,12,28,Thursday
2,12,3,15,2017,11,29,Wednseday
2,9,21,30,2017,11,22,Wednseday
3,7,13,20,2017,8,4,Friday
4,11,9,20,2017,10,17,Tuesday
2,43,-9,34,2018,4,11,Wednseday
6,9,6,15,2018,8,15,Wednseday
1,8,13,21,2018,7,12,Thursday
8,14,7,21,2017,10,11,Wednseday
1,3,14,17,2017,10,15,Sunday
2,14,16,30,2017,11,7,Tuesday
4,12,24,36,2017,4,20,Thursday
5,12,8,20,2017,12,28,Thursday
3,16,7,23,2017,11,28,Tuesday
3,55,-21,34,2018,2,23,Friday
0,4,11,15,2018,6,14,Thursday
2,12,21,33,2018,5,26,Saturday
1,9,21,30,2018,6,12,Tuesday
7,17,14,31,2018,2,16,Friday
3,10,16,26,2018,5,4,Friday
1,19,9,28,2018,3,1,Thursday
7,24,-4,20,2017,11,24,Friday
1,12,16,28,2017,7,27,Thursday
7,44,-17,27,2017,9,27,Wednseday
1,10,21,31,2017,2,6,Monday
1,2,11,13,2017,7,26,Wednseday
6,17,20,37,2017,2,25,Saturday
3,20,15,35,2018,1,26,Friday
3,16,10,26,2017,10,22,Sunday
0,1,13,14,2018,2,26,Monday
2,10,20,30,2017,9,2,Saturday
0,27,-13,14,2018,7,31,Tuesday
2,9,16,25,2018,4,15,Sunday
8,17,19,36,2017,9,11,Monday
4,17,15,32,2018,2,2,Friday
5,16,3,19,2018,2,22,Thursday
1,7,20,27,2018,3,9,Friday
3,12,-2,10,2018,5,11,Friday
4,14,13,27,2017,11,30,Thursday
11,17,5,22,2018,8,6,Monday
10,17,3,20,2017,10,10,Tuesday
2,20,2,22,2018,1,31,Wednseday
6,15,14,29,2017,2,15,Wednseday
4,15,10,25,2018,2,1,Thursday
1,6,24,30,2018,6,19,Tuesday
1,4,14,18,2018,7,2,Monday
2,7,18,25,2018,1,20,Saturday
3,5,13,18,2017,12,31,Sunday
2,6,17,23,2017,8,26,Saturday
8,12,19,31,2017,7,30,Sunday
0,7,33,40,2017,12,22,Friday
1,33,-11,22,2017,10,30,Monday
6,7,46,53,2016,10,8,Saturday
12,14,12,26,2017,1,25,Wednseday
1,17,3,20,2018,2,21,Wednseday
1,14,22,36,2017,7,6,Thursday
1,13,21,34,2017,10,3,Tuesday
1,9,21,30,2017,9,3,Sunday
1,8,10,18,2017,11,6,Monday
0,6,29,35,2018,6,14,Thursday
5,11,14,25,2018,7,26,Thursday
1,3,32,35,2017,6,13,Tuesday
26,27,23,50,2018,6,7,Thursday
0,2,10,12,2018,8,15,Wednseday
5,24,17,41,2018,5,24,Thursday
7,18,9,27,2018,1,18,Thursday
0,14,26,40,2018,6,7,Thursday
1,12,24,36,2018,7,16,Monday
1,2,9,11,2017,10,30,Monday
3,23,-9,14,2017,7,24,Monday
2,14,14,28,2018,4,16,Monday
3,10,28,38,2018,6,5,Tuesday
3,7,28,35,2018,4,30,Monday
0,6,18,24,2018,5,11,Friday
1,7,21,28,2017,12,27,Wednseday
1,6,13,19,2018,5,2,Wednseday
0,7,5,12,2018,6,14,Thursday
6,15,6,21,2017,11,10,Friday
4,10,13,23,2017,11,12,Sunday
5,18,8,26,2018,1,11,Thursday
2,4,5,9,2018,7,17,Tuesday
1,46,-16,30,2018,3,11,Sunday
3,8,6,14,2018,8,14,Tuesday
5,5,14,19,2018,1,5,Friday
3,5,6,11,2018,3,11,Sunday
2,8,15,23,2017,3,26,Sunday
3,15,15,30,2018,1,30,Tuesday
7,26,5,31,2017,10,27,Friday
1,12,23,35,2017,10,5,Thursday
1,13,7,20,2017,7,11,Tuesday
3,9,17,26,2017,4,29,Saturday
0,8,12,20,2017,6,29,Thursday
1,6,8,14,2018,8,21,Tuesday
1,4,5,9,2018,7,30,Monday
5,14,11,25,2017,11,11,Saturday
3,9,-1,8,2018,5,15,Tuesday
2,10,14,24,2017,6,11,Sunday
2,19,19,38,2018,1,14,Sunday
6,12,16,28,2018,7,19,Thursday
1,12,9,21,2018,3,22,Thursday
4,9,15,24,2017,4,14,Friday
3,29,-1,28,2017,10,6,Friday
1,12,8,20,2017,11,29,Wednseday
7,8,0,8,2018,8,6,Monday
8,10,1,11,2018,5,14,Monday
20,39,-13,26,2018,3,18,Sunday
8,14,14,28,2018,4,2,Monday
1,5,9,14,2018,5,16,Wednseday
1,4,24,28,2018,7,16,Monday
4,14,18,32,2017,5,8,Monday
15,20,22,42,2018,7,25,Wednseday
7,21,5,26,2018,2,8,Thursday
11,12,4,16,2018,7,14,Saturday
2,15,8,23,2018,7,9,Monday
8,10,7,17,2017,9,5,Tuesday
7,31,6,37,2018,1,2,Tuesday
1,8,26,34,2018,8,15,Wednseday
5,7,15,22,2017,10,19,Thursday
9,23,7,30,2017,4,9,Sunday
1,9,8,17,2017,11,21,Tuesday
3,9,10,19,2017,5,13,Saturday
3,27,10,37,2017,2,21,Tuesday
1,4,17,21,2017,9,18,Monday
2,9,15,24,2018,1,13,Saturday
3,11,13,24,2017,8,4,Friday
4,16,9,25,2017,4,1,Saturday
4,16,10,26,2018,1,14,Sunday
1,4,6,10,2018,3,6,Tuesday
6,16,17,33,2017,5,31,Wednseday
2,18,19,37,2017,8,14,Monday
2,3,12,15,2017,7,23,Sunday
2,17,14,31,2018,1,22,Monday
3,35,3,38,2018,6,5,Tuesday
1,7,6,13,2018,8,9,Thursday
8,17,15,32,2018,3,5,Monday
3,10,14,24,2017,4,10,Monday
1,15,11,26,2017,7,6,Thursday
3,11,11,22,2017,10,23,Monday
4,10,20,30,2017,8,14,Monday
1,8,10,18,2017,11,13,Monday
3,8,15,23,2017,5,30,Tuesday
2,15,13,28,2017,12,13,Wednseday
3,15,16,31,2017,11,28,Tuesday
1,6,14,20,2018,2,15,Thursday
1,8,24,32,2018,5,10,Thursday
0,7,10,17,2017,9,22,Friday
1,6,24,30,2017,12,12,Tuesday
6,12,8,20,2017,5,10,Wednseday
3,10,10,20,2017,9,2,Saturday
2,6,23,29,2018,4,8,Sunday
3,24,10,34,2018,1,5,Friday
1,6,33,39,2018,8,23,Thursday
4,6,11,17,2017,11,24,Friday
4,14,20,34,2017,7,7,Friday
6,9,21,30,2018,6,27,Wednseday
0,10,15,25,2018,4,20,Friday
1,9,15,24,2018,1,9,Tuesday
1,2,17,19,2017,10,25,Wednseday
1,24,8,32,2018,2,5,Monday
4,18,10,28,2017,10,27,Friday
6,19,7,26,2018,2,8,Thursday
1,15,7,22,2018,3,7,Wednseday
3,9,18,27,2017,11,11,Saturday
2,5,10,15,2018,1,11,Thursday
3,8,17,25,2017,5,5,Friday
2,5,7,12,2018,8,4,Saturday
5,6,20,26,2018,5,30,Wednseday
1,8,19,27,2017,11,16,Thursday
2,4,13,17,2018,5,20,Sunday
2,3,16,19,2018,4,21,Saturday
3,12,34,46,2017,11,25,Saturday
4,5,12,17,2018,4,22,Sunday
7,13,15,28,2017,5,3,Wednseday
1,9,29,38,2017,5,28,Sunday
4,14,24,38,2017,12,29,Friday
11,18,7,25,2018,3,23,Friday
1,5,21,26,2018,1,10,Wednseday
1,9,16,25,2017,5,29,Monday
4,7,20,27,2018,4,20,Friday
3,16,13,29,2017,8,13,Sunday
2,17,12,29,2018,2,25,Sunday
1,4,13,17,2018,5,13,Sunday
3,18,-5,13,2017,6,30,Friday
1,4,18,22,2018,7,3,Tuesday
2,9,14,23,2017,9,6,Wednseday
7,29,4,33,2018,2,14,Wednseday
2,35,-11,24,2018,3,5,Monday
2,10,14,24,2018,1,16,Tuesday
0,10,14,24,2017,7,17,Monday
4,6,15,21,2017,6,1,Thursday
5,13,9,22,2018,2,22,Thursday
3,15,10,25,2017,7,24,Monday
4,7,1,8,2018,8,2,Thursday
2,19,13,32,2018,4,5,Thursday
8,22,12,34,2018,4,25,Wednseday
3,6,18,24,2017,8,6,Sunday
1,3,11,14,2017,6,6,Tuesday
3,4,13,17,2018,6,8,Friday
1,15,22,37,2017,12,26,Tuesday
2,10,13,23,2018,2,25,Sunday
0,1,12,13,2018,6,20,Wednseday
3,19,0,19,2017,10,15,Sunday
2,4,21,25,2018,6,17,Sunday
0,10,7,17,2018,7,17,Tuesday
1,7,23,30,2018,6,25,Monday
1,3,17,20,2017,11,28,Tuesday
2,18,5,23,2017,11,20,Monday
0,5,16,21,2017,12,22,Friday
3,7,25,32,2018,8,10,Friday
0,9,13,22,2017,7,31,Monday
3,7,18,25,2017,9,22,Friday
41,60,-33,27,2017,11,24,Friday
6,14,7,21,2017,9,12,Tuesday
0,3,32,35,2018,6,25,Monday
4,5,8,13,2018,7,20,Friday
2,5,12,17,2018,7,21,Saturday
5,8,13,21,2017,6,1,Thursday
4,11,9,20,2017,11,23,Thursday
1,7,22,29,2018,5,14,Monday
3,10,15,25,2017,9,29,Friday
12,14,12,26,2017,12,8,Friday
2,5,5,10,2018,7,21,Saturday
2,6,7,13,2017,8,16,Wednseday
2,20,2,22,2018,2,26,Monday
0,3,12,15,2018,7,10,Tuesday
2,17,7,24,2018,2,20,Tuesday
1,13,14,27,2018,2,13,Tuesday
2,7,14,21,2017,8,22,Tuesday
6,23,11,34,2017,5,4,Thursday
5,20,5,25,2018,2,23,Friday
4,6,21,27,2017,12,22,Friday
4,9,9,18,2018,7,21,Saturday
1,13,24,37,2018,6,6,Wednseday
5,21,12,33,2018,1,31,Wednseday
3,44,-21,23,2018,3,25,Sunday
10,11,3,14,2017,11,24,Friday
3,10,1,11,2017,11,20,Monday
2,7,6,13,2018,5,1,Tuesday
3,15,6,21,2017,11,7,Tuesday
6,16,7,23,2018,3,17,Saturday
6,17,10,27,2017,11,14,Tuesday
4,16,17,33,2017,9,2,Saturday
3,17,11,28,2017,7,11,Tuesday
17,25,-3,22,2017,2,26,Sunday
4,11,25,36,2018,8,13,Monday
28,40,-10,30,2017,4,19,Wednseday
1,6,4,10,2017,9,12,Tuesday
0,3,10,13,2018,6,15,Friday
0,4,22,26,2018,4,26,Thursday
3,10,13,23,2018,4,24,Tuesday
1,4,29,33,2017,1,29,Sunday
2,5,7,12,2018,7,21,Saturday
2,13,14,27,2017,10,3,Tuesday
2,14,17,31,2018,1,9,Tuesday
0,21,7,28,2018,1,18,Thursday
1,23,-1,22,2018,3,21,Wednseday
5,12,16,28,2018,7,19,Thursday
5,21,7,28,2017,8,30,Wednseday
3,17,8,25,2018,2,16,Friday
3,7,15,22,2018,7,3,Tuesday
1,15,2,17,2017,10,23,Monday
1,9,7,16,2018,4,11,Wednseday
10,21,15,36,2018,2,7,Wednseday
0,9,9,18,2017,10,16,Monday
1,16,8,24,2017,12,5,Tuesday
1,7,20,27,2017,2,22,Wednseday
14,24,6,30,2017,12,5,Tuesday
5,15,8,23,2018,2,18,Sunday
1,15,14,29,2017,5,4,Thursday
2,9,7,16,2017,10,16,Monday
1,11,11,22,2017,8,3,Thursday
4,9,16,25,2017,5,27,Saturday
14,27,2,29,2018,5,16,Wednseday
8,43,-6,37,2018,2,28,Wednseday
6,14,2,16,2018,4,11,Wednseday
1,13,7,20,2017,6,27,Tuesday
1,2,11,13,2017,8,22,Tuesday
1,2,17,19,2018,5,2,Wednseday
2,11,23,34,2018,6,9,Saturday
1,7,21,28,2018,3,5,Monday
2,3,8,11,2018,6,9,Saturday
0,12,22,34,2017,5,26,Friday
1,8,18,26,2018,2,14,Wednseday
3,8,17,25,2018,1,8,Monday
3,6,4,10,2017,5,12,Friday
5,31,-3,28,2018,2,2,Friday
8,9,6,15,2018,1,23,Tuesday
4,9,21,30,2018,6,16,Saturday
4,16,6,22,2018,2,19,Monday
2,9,7,16,2018,8,6,Monday
1,8,18,26,2017,11,2,Thursday
15,37,-9,28,2018,3,21,Wednseday
3,9,15,24,2017,10,23,Monday
0,9,13,22,2018,3,14,Wednseday
5,12,7,19,2017,11,16,Thursday
1,11,13,24,2017,4,24,Monday
4,7,12,19,2017,10,20,Friday
1,18,7,25,2018,2,22,Thursday
5,7,25,32,2018,8,23,Thursday
4,11,18,29,2017,7,10,Monday
0,3,11,14,2017,11,24,Friday
5,34,-10,24,2017,11,25,Saturday
2,19,15,34,2017,4,22,Saturday
1,15,21,36,2018,8,6,Monday
2,8,14,22,2017,8,20,Sunday
2,9,2,11,2018,8,6,Monday
3,8,13,21,2018,4,11,Wednseday
15,16,13,29,2018,4,24,Tuesday
0,1,7,8,2017,10,31,Tuesday
3,8,12,20,2017,6,30,Friday
2,7,36,43,2017,10,16,Monday
1,14,20,34,2017,12,14,Thursday
3,12,12,24,2017,6,16,Friday
3,19,6,25,2018,3,16,Friday
3,5,7,12,2017,10,13,Friday
2,8,19,27,2017,8,16,Wednseday
2,7,10,17,2017,7,31,Monday
6,12,6,18,2017,5,12,Friday
1,6,20,26,2018,6,7,Thursday
1,16,42,58,2017,5,23,Tuesday
4,17,10,27,2017,11,18,Saturday
2,8,28,36,2018,4,16,Monday
6,12,7,19,2018,7,12,Thursday
1,14,10,24,2018,4,23,Monday
2,12,5,17,2017,10,15,Sunday
1,7,17,24,2017,8,7,Monday
1,3,13,16,2018,1,29,Monday
2,8,14,22,2017,7,4,Tuesday
1,22,11,33,2017,12,27,Wednseday
4,10,16,26,2017,8,11,Friday
3,7,9,16,2017,10,3,Tuesday
1,3,14,17,2018,2,18,Sunday
2,9,19,28,2017,7,12,Wednseday
2,15,6,21,2018,2,28,Wednseday
2,11,8,19,2018,7,22,Sunday
1,8,24,32,2017,7,13,Thursday
0,7,13,20,2017,7,21,Friday
3,8,14,22,2017,9,19,Tuesday
3,20,25,45,2018,1,12,Friday
0,3,14,17,2018,1,19,Friday
2,22,6,28,2017,5,15,Monday
1,4,19,23,2018,6,18,Monday
3,12,4,16,2018,5,22,Tuesday
1,10,8,18,2018,4,9,Monday
4,18,7,25,2017,11,24,Friday
4,19,4,23,2017,9,25,Monday
2,5,13,18,2018,5,5,Saturday
1,8,14,22,2018,5,15,Tuesday
1,8,21,29,2018,6,19,Tuesday
2,8,5,13,2017,7,12,Wednseday
3,21,-2,19,2018,3,16,Friday
1,4,5,9,2018,7,10,Tuesday
2,13,23,36,2018,4,17,Tuesday
2,14,19,33,2018,2,7,Wednseday
8,16,22,38,2018,3,26,Monday
11,29,0,29,2018,1,18,Thursday
1,5,20,25,2017,6,11,Sunday
4,10,10,20,2017,9,8,Friday
2,4,6,10,2018,7,9,Monday
7,9,14,23,2017,5,16,Tuesday
6,22,1,23,2018,2,27,Tuesday
1,7,7,14,2017,11,7,Tuesday
4,14,10,24,2017,11,24,Friday
5,7,18,25,2017,9,15,Friday
4,31,-1,30,2018,1,16,Tuesday
8,10,7,17,2018,3,6,Tuesday
3,13,14,27,2017,11,24,Friday
6,14,11,25,2017,2,24,Friday
4,6,31,37,2017,1,22,Sunday
1,20,8,28,2017,3,29,Wednseday
2,10,10,20,2018,5,12,Saturday
2,5,41,46,2017,1,21,Saturday
1,13,14,27,2018,1,23,Tuesday
2,7,8,15,2018,1,16,Tuesday
2,8,23,31,2018,6,26,Tuesday
1,5,14,19,2017,7,23,Sunday
2,22,10,32,2018,1,15,Monday
3,4,10,14,2018,5,18,Friday
3,11,8,19,2017,12,17,Sunday
7,21,10,31,2017,3,27,Monday
5,36,4,40,2018,1,10,Wednseday
1,15,13,28,2017,4,25,Tuesday
5,8,19,27,2017,11,23,Thursday
3,27,-2,25,2018,4,21,Saturday
4,9,21,30,2017,8,12,Saturday
5,11,15,26,2018,1,19,Friday
8,11,14,25,2017,8,21,Monday
2,18,34,52,2017,2,5,Sunday
13,22,11,33,2017,10,28,Saturday
4,8,11,19,2017,12,8,Friday
0,6,29,35,2018,6,27,Wednseday
7,29,-4,25,2017,10,9,Monday
2,8,24,32,2018,1,1,Monday
8,18,8,26,2018,3,8,Thursday
2,10,19,29,2018,4,16,Monday
3,8,6,14,2017,11,8,Wednseday
0,1,12,13,2017,6,28,Wednseday
1,6,18,24,2018,4,6,Friday
2,13,7,20,2017,3,11,Saturday
1,7,11,18,2017,3,6,Monday
1,12,3,15,2018,8,16,Thursday
9,25,7,32,2017,8,19,Saturday
2,8,15,23,2017,8,22,Tuesday
1,24,4,28,2018,4,25,Wednseday
7,18,9,27,2018,1,12,Friday
4,13,4,17,2018,5,21,Monday
4,13,8,21,2018,1,16,Tuesday
2,5,13,18,2017,12,10,Sunday
1,5,9,14,2018,8,20,Monday
1,11,17,28,2017,7,17,Monday
3,23,8,31,2018,1,6,Saturday
1,9,18,27,2018,6,19,Tuesday
5,11,21,32,2018,4,19,Thursday
2,7,14,21,2018,6,26,Tuesday
5,22,14,36,2017,12,4,Monday
1,4,11,15,2018,8,6,Monday
2,6,17,23,2017,11,15,Wednseday
4,13,20,33,2018,1,13,Saturday
2,3,55,58,2017,1,28,Saturday
1,15,17,32,2018,6,28,Thursday
2,16,14,30,2018,2,24,Saturday
1,5,17,22,2018,1,18,Thursday
4,6,12,18,2018,3,15,Thursday
1,2,9,11,2018,4,1,Sunday
3,10,18,28,2017,7,31,Monday
1,7,15,22,2017,11,2,Thursday
6,7,8,15,2018,1,23,Tuesday
4,5,8,13,2017,7,1,Saturday
0,7,15,22,2017,7,31,Monday
2,9,18,27,2017,12,2,Saturday
1,6,20,26,2018,5,13,Sunday
2,7,4,11,2018,8,13,Monday
3,12,19,31,2017,5,5,Friday
0,8,15,23,2018,3,14,Wednseday
3,11,13,24,2017,5,20,Saturday
2,15,1,16,2018,3,5,Monday
4,10,22,32,2017,6,12,Monday
0,3,17,20,2018,7,11,Wednseday
1,8,6,14,2018,8,2,Thursday
5,37,-15,22,2018,3,4,Sunday
1,5,25,30,2018,7,8,Sunday
13,13,14,27,2017,1,19,Thursday
13,61,-32,29,2018,4,5,Thursday
3,9,18,27,2017,7,29,Saturday
2,37,1,38,2018,2,3,Saturday
3,9,20,29,2017,11,21,Tuesday
5,28,-7,21,2018,2,28,Wednseday
2,7,15,22,2017,8,1,Tuesday
2,5,11,16,2018,1,21,Sunday
1,8,13,21,2018,4,19,Thursday
1,9,13,22,2017,7,17,Monday
1,9,22,31,2018,6,12,Tuesday
23,32,23,55,2016,10,4,Tuesday
4,16,22,38,2017,4,1,Saturday
6,18,25,43,2018,6,7,Thursday
1,24,5,29,2017,12,4,Monday
4,11,19,30,2017,10,7,Saturday
2,8,28,36,2018,6,5,Tuesday
3,7,25,32,2018,6,15,Friday
1,2,7,9,2018,7,24,Tuesday
5,7,9,16,2018,5,16,Wednseday
1,2,11,13,2018,7,4,Wednseday
2,8,10,18,2017,3,26,Sunday
3,11,28,39,2017,12,15,Friday
7,16,14,30,2017,11,22,Wednseday
1,7,32,39,2017,3,31,Friday
1,9,15,24,2018,6,4,Monday
2,20,5,25,2018,5,20,Sunday
2,2,16,18,2018,4,22,Sunday
1,3,23,26,2017,12,13,Wednseday
1,4,9,13,2018,5,17,Thursday
2,18,4,22,2017,7,3,Monday
3,21,1,22,2017,8,7,Monday
1,8,15,23,2017,5,24,Wednseday
4,16,23,39,2017,4,24,Monday
7,8,8,16,2018,7,3,Tuesday
0,1,11,12,2018,3,8,Thursday
3,5,8,13,2018,6,22,Friday
11,13,4,17,2017,9,10,Sunday
6,7,7,14,2018,2,20,Tuesday
1,4,17,21,2017,8,21,Monday
4,10,12,22,2017,7,20,Thursday
5,12,15,27,2017,8,24,Thursday
5,10,14,24,2017,11,24,Friday
0,5,10,15,2018,7,25,Wednseday
2,6,23,29,2018,1,3,Wednseday
3,8,9,17,2017,10,17,Tuesday
2,6,10,16,2018,7,17,Tuesday
4,7,15,22,2017,11,30,Thursday
1,7,21,28,2018,1,23,Tuesday
32,51,16,67,2018,1,8,Monday
4,14,14,28,2018,2,1,Thursday
2,15,0,15,2018,7,31,Tuesday
1,15,12,27,2018,6,28,Thursday
3,11,13,24,2017,4,29,Saturday
4,24,6,30,2018,3,3,Saturday
2,9,20,29,2018,4,8,Sunday
5,38,-12,26,2018,3,15,Thursday
5,11,21,32,2017,4,27,Thursday
1,25,-2,23,2018,5,15,Tuesday
6,8,0,8,2018,8,22,Wednseday
9,14,8,22,2017,10,23,Monday
3,10,12,22,2017,7,25,Tuesday
9,23,5,28,2018,2,26,Monday
5,12,17,29,2018,3,28,Wednseday
21,29,27,56,2018,6,4,Monday
3,10,26,36,2018,8,13,Monday
3,6,14,20,2018,6,29,Friday
2,6,18,24,2017,9,30,Saturday
1,7,21,28,2017,6,15,Thursday
1,5,29,34,2017,2,1,Wednseday
0,9,13,22,2017,8,1,Tuesday
30,37,-19,18,2017,9,16,Saturday
3,13,10,23,2017,11,28,Tuesday
1,4,19,23,2018,6,18,Monday
2,8,20,28,2017,1,25,Wednseday
7,14,10,24,2017,7,24,Monday
4,8,17,25,2017,8,20,Sunday
2,10,9,19,2018,3,21,Wednseday
9,16,12,28,2018,4,25,Wednseday
4,12,17,29,2017,4,20,Thursday
1,22,7,29,2018,4,19,Thursday
1,7,16,23,2018,1,24,Wednseday
1,2,11,13,2017,5,23,Tuesday
2,30,5,35,2018,4,4,Wednseday
4,10,22,32,2017,11,25,Saturday
3,6,8,14,2017,11,10,Friday
1,7,14,21,2018,7,23,Monday
1,5,24,29,2018,5,9,Wednseday
3,11,9,20,2017,7,28,Friday
5,11,15,26,2017,3,18,Saturday
6,10,10,20,2017,7,15,Saturday
4,7,26,33,2018,3,16,Friday
4,8,14,22,2017,10,9,Monday
4,23,9,32,2018,3,10,Saturday
3,6,27,33,2018,3,17,Saturday
3,7,14,21,2018,7,16,Monday
41,42,17,59,2017,4,1,Saturday
1,9,13,22,2018,5,14,Monday
1,10,13,23,2017,6,6,Tuesday
0,7,14,21,2017,11,14,Tuesday
5,36,-13,23,2017,11,29,Wednseday
4,5,18,23,2017,5,22,Monday
2,3,5,8,2018,7,31,Tuesday
2,24,10,34,2017,12,12,Tuesday
5,8,18,26,2018,6,21,Thursday
2,8,19,27,2018,5,1,Tuesday
4,10,14,24,2017,3,18,Saturday
3,15,21,36,2017,4,3,Monday
4,11,9,20,2017,8,31,Thursday
1,4,19,23,2018,1,22,Monday
2,7,24,31,2018,7,3,Tuesday
0,7,26,33,2018,3,7,Wednseday
1,6,17,23,2018,6,12,Tuesday
3,7,18,25,2018,6,16,Saturday
1,5,12,17,2018,7,22,Sunday
1,8,16,24,2018,3,26,Monday
10,18,19,37,2017,4,30,Sunday
4,33,-2,31,2018,7,6,Friday
4,30,-2,28,2017,11,28,Tuesday
2,3,11,14,2017,11,15,Wednseday
9,35,-10,25,2018,1,11,Thursday
2,22,0,22,2018,2,28,Wednseday
3,8,18,26,2017,9,29,Friday
5,21,14,35,2018,5,25,Friday
17,19,23,42,2017,12,11,Monday
5,13,21,34,2018,7,6,Friday
1,4,10,14,2018,7,23,Monday
1,9,14,23,2017,3,26,Sunday
2,5,19,24,2018,4,15,Sunday
5,13,13,26,2018,1,10,Wednseday
7,14,18,32,2017,12,28,Thursday
2,3,9,12,2018,3,31,Saturday
1,4,20,24,2017,7,10,Monday
2,20,2,22,2018,3,21,Wednseday
6,12,9,21,2018,1,19,Friday
1,2,8,10,2018,4,2,Monday
5,10,13,23,2018,4,11,Wednseday
1,13,17,30,2018,6,12,Tuesday
2,27,12,39,2018,2,8,Thursday
0,6,26,32,2017,7,28,Friday
2,26,5,31,2017,4,23,Sunday
2,8,14,22,2017,9,17,Sunday
6,9,5,14,2018,2,21,Wednseday
0,18,14,32,2018,4,19,Thursday
4,12,13,25,2018,8,5,Sunday
2,8,3,11,2018,2,15,Thursday
1,10,18,28,2018,4,24,Tuesday
1,8,19,27,2017,2,23,Thursday
2,7,17,24,2018,1,8,Monday
19,24,22,46,2018,7,14,Saturday
4,4,19,23,2018,2,3,Saturday
1,5,16,21,2018,6,25,Monday
2,23,6,29,2018,3,25,Sunday
2,5,22,27,2018,6,6,Wednseday
6,18,3,21,2018,2,15,Thursday
7,13,19,32,2018,2,8,Thursday
1,7,18,25,2018,4,19,Thursday
8,19,6,25,2017,10,6,Friday
25,44,-19,25,2018,2,17,Saturday
6,12,1,13,2018,8,10,Friday
2,9,15,24,2017,7,2,Sunday
1,10,6,16,2018,3,7,Wednseday
5,6,10,16,2018,2,17,Saturday
9,19,8,27,2017,6,7,Wednseday
3,18,4,22,2018,3,4,Sunday
6,14,21,35,2018,5,30,Wednseday
2,19,5,24,2018,2,19,Monday
2,14,8,22,2018,3,5,Monday
2,39,-15,24,2018,3,19,Monday
1,4,17,21,2018,1,15,Monday
1,3,18,21,2017,3,13,Monday
5,7,34,41,2017,2,1,Wednseday
2,5,20,25,2017,7,30,Sunday
4,8,15,23,2017,9,11,Monday
3,18,8,26,2017,5,19,Friday
4,5,1,6,2018,8,17,Friday
5,9,27,36,2018,4,19,Thursday
12,20,11,31,2018,8,4,Saturday
0,1,10,11,2017,9,18,Monday
0,14,14,28,2018,6,18,Monday
1,2,14,16,2017,10,22,Sunday
1,3,5,8,2018,7,23,Monday
1,11,13,24,2017,3,27,Monday
5,9,13,22,2018,1,17,Wednseday
14,31,19,50,2017,3,27,Monday
5,21,11,32,2018,1,25,Thursday
1,9,20,29,2018,1,8,Monday
3,7,9,16,2018,3,13,Tuesday
4,16,7,23,2018,3,4,Sunday
3,10,17,27,2017,11,3,Friday
2,29,4,33,2018,1,24,Wednseday
1,2,6,8,2017,5,10,Wednseday
2,8,19,27,2017,2,15,Wednseday
3,18,2,20,2017,11,25,Saturday
1,15,11,26,2018,4,4,Wednseday
1,21,1,22,2017,6,28,Wednseday
1,6,16,22,2017,7,20,Thursday
2,11,7,18,2018,3,10,Saturday
8,11,3,14,2018,2,22,Thursday
4,9,11,20,2017,11,25,Saturday
2,9,13,22,2017,8,9,Wednseday
3,20,8,28,2018,4,18,Wednseday
3,18,8,26,2018,4,22,Sunday
4,13,16,29,2018,6,21,Thursday
3,23,-1,22,2017,11,20,Monday
2,12,7,19,2018,4,21,Saturday
1,7,16,23,2017,8,30,Wednseday
0,11,11,22,2018,3,15,Thursday
4,12,14,26,2017,4,28,Friday
5,14,13,27,2017,12,14,Thursday
2,10,16,26,2017,6,17,Saturday
2,8,14,22,2018,6,19,Tuesday
1,15,15,30,2018,2,7,Wednseday
2,9,38,47,2018,8,1,Wednseday
2,10,15,25,2018,7,22,Sunday
1,10,19,29,2017,7,4,Tuesday
2,7,16,23,2018,8,22,Wednseday
5,8,0,8,2018,8,5,Sunday
5,33,5,38,2018,2,2,Friday
0,2,21,23,2018,1,8,Monday
1,19,8,27,2017,12,21,Thursday
2,7,12,19,2017,4,5,Wednseday
5,8,18,26,2017,12,15,Friday
1,64,-42,22,2018,3,19,Monday
2,10,15,25,2017,11,27,Monday
1,15,15,30,2017,11,8,Wednseday
1,3,13,16,2017,9,19,Tuesday
1,3,20,23,2017,2,7,Tuesday
1,23,12,35,2018,4,16,Monday
2,3,3,6,2018,8,11,Saturday
1,29,-3,26,2017,10,5,Thursday
3,14,11,25,2018,5,18,Friday
3,9,10,19,2017,12,9,Saturday
6,21,7,28,2018,1,11,Thursday
2,4,7,11,2018,4,30,Monday
0,2,20,22,2017,7,4,Tuesday
1,10,13,23,2018,1,22,Monday
2,6,10,16,2018,7,25,Wednseday
1,7,9,16,2017,5,22,Monday
3,12,16,28,2018,4,27,Friday
3,17,0,17,2018,3,11,Sunday
3,6,13,19,2018,7,21,Saturday
1,5,14,19,2017,6,25,Sunday
3,12,12,24,2018,1,21,Sunday
3,6,6,12,2018,3,7,Wednseday
1,12,21,33,2017,3,22,Wednseday
0,2,20,22,2017,8,15,Tuesday
1,23,9,32,2017,12,21,Thursday
0,5,21,26,2018,1,19,Friday
5,10,14,24,2017,10,6,Friday
1,5,21,26,2018,5,2,Wednseday
12,22,11,33,2017,6,14,Wednseday
1,8,14,22,2017,9,21,Thursday
1,8,10,18,2017,9,3,Sunday
2,44,-10,34,2018,2,7,Wednseday
3,7,17,24,2017,7,14,Friday
0,6,13,19,2017,10,18,Wednseday
1,5,23,28,2018,1,4,Thursday
14,16,-1,15,2018,8,13,Monday
2,24,7,31,2017,12,9,Saturday
2,10,10,20,2018,8,11,Saturday
6,18,8,26,2018,2,17,Saturday
1,4,19,23,2018,6,24,Sunday
1,7,13,20,2018,3,28,Wednseday
1,6,16,22,2017,4,12,Wednseday
2,5,18,23,2017,3,18,Saturday
3,10,14,24,2017,8,8,Tuesday
2,8,21,29,2017,10,8,Sunday
2,7,30,37,2018,6,5,Tuesday
3,6,18,24,2017,7,8,Saturday
3,29,-9,20,2017,4,19,Wednseday
1,22,4,26,2018,2,7,Wednseday
0,3,13,16,2018,4,9,Monday
1,10,12,22,2017,10,9,Monday
1,7,37,44,2017,11,27,Monday
1,8,21,29,2017,10,10,Tuesday
1,23,0,23,2017,9,13,Wednseday
4,10,4,14,2018,5,4,Friday
8,14,23,37,2017,6,14,Wednseday
8,23,0,23,2018,5,13,Sunday
1,8,20,28,2018,7,4,Wednseday
1,7,13,20,2017,8,1,Tuesday
1,2,2,4,2018,7,29,Sunday
1,7,30,37,2018,6,4,Monday
4,14,20,34,2017,8,3,Thursday
1,43,-10,33,2018,3,8,Thursday
1,4,19,23,2018,8,19,Sunday
5,34,0,34,2018,3,2,Friday
3,14,7,21,2018,3,27,Tuesday
1,7,1,8,2018,8,8,Wednseday
0,41,-21,20,2017,11,29,Wednseday
2,11,7,18,2018,5,7,Monday
4,15,20,35,2017,12,4,Monday
1,4,24,28,2018,6,28,Thursday
1,9,7,16,2018,8,21,Tuesday
1,4,10,14,2018,6,14,Thursday
2,13,10,23,2017,11,21,Tuesday
3,19,10,29,2017,11,28,Tuesday
3,16,12,28,2017,12,25,Monday
3,10,10,20,2018,7,20,Friday
7,22,9,31,2018,4,16,Monday
1,4,11,15,2018,5,14,Monday
3,11,10,21,2018,8,10,Friday
1,4,11,15,2018,8,6,Monday
3,5,4,9,2018,8,4,Saturday
1,22,32,54,2018,5,31,Thursday
4,8,2,10,2018,8,13,Monday
3,9,16,25,2017,3,25,Saturday
3,11,14,25,2017,11,13,Monday
4,5,8,13,2017,6,30,Friday
1,14,14,28,2017,11,9,Thursday
2,7,21,28,2018,6,26,Tuesday
6,12,7,19,2018,3,14,Wednseday
2,14,14,28,2017,7,26,Wednseday
5,28,1,29,2018,3,28,Wednseday
3,34,-11,23,2018,3,3,Saturday
1,12,18,30,2018,4,29,Sunday
4,7,18,25,2017,8,18,Friday
3,25,15,40,2018,4,20,Friday
2,10,10,20,2017,9,16,Saturday
7,20,18,38,2017,7,14,Friday
3,5,5,10,2018,8,26,Sunday
2,15,5,20,2017,7,18,Tuesday
1,16,15,31,2017,12,3,Sunday
2,24,-1,23,2018,3,21,Wednseday
1,11,10,21,2017,10,16,Monday
3,4,48,52,2018,6,5,Tuesday
1,13,20,33,2017,10,5,Thursday
2,9,19,28,2017,7,24,Monday
5,34,-6,28,2018,3,1,Thursday
15,34,33,67,2018,1,11,Thursday
1,11,4,15,2018,7,19,Thursday
0,12,22,34,2017,6,2,Friday
2,14,9,23,2017,12,5,Tuesday
2,9,14,23,2017,11,8,Wednseday
0,11,10,21,2018,6,26,Tuesday
5,7,6,13,2017,5,26,Friday
3,10,15,25,2018,3,26,Monday
2,5,13,18,2017,5,11,Thursday
1,16,7,23,2018,3,27,Tuesday
3,9,7,16,2018,8,4,Saturday
3,9,15,24,2017,7,31,Monday
7,9,1,10,2018,3,19,Monday
0,5,8,13,2018,8,8,Wednseday
1,9,14,23,2018,1,31,Wednseday
2,9,20,29,2018,6,17,Sunday
3,5,9,14,2017,5,19,Friday
2,9,14,23,2017,9,10,Sunday
4,29,-3,26,2017,11,24,Friday
9,10,3,13,2018,8,4,Saturday
7,12,22,34,2017,3,16,Thursday
2,26,1,27,2017,6,3,Saturday
4,7,5,12,2018,3,2,Friday
24,33,-8,25,2017,7,28,Friday
2,9,16,25,2018,5,5,Saturday
5,11,14,25,2017,8,18,Friday
1,10,8,18,2018,4,8,Sunday
3,8,23,31,2018,6,17,Sunday
2,7,11,18,2018,3,18,Sunday
1,12,30,42,2017,8,28,Monday
2,7,8,15,2018,5,15,Tuesday
1,7,21,28,2017,11,7,Tuesday
1,5,8,13,2017,8,24,Thursday
6,33,-4,29,2018,3,7,Wednseday
4,18,2,20,2018,2,24,Saturday
3,13,14,27,2018,1,26,Friday
3,18,1,19,2018,4,7,Saturday
15,30,2,32,2017,6,19,Monday
3,15,17,32,2018,2,3,Saturday
3,15,20,35,2017,5,16,Tuesday
9,21,0,21,2017,11,15,Wednseday
1,23,3,26,2018,2,15,Thursday
2,14,21,35,2017,5,15,Monday
1,11,24,35,2018,4,9,Monday
6,14,16,30,2018,1,10,Wednseday
0,10,16,26,2018,1,3,Wednseday
2,8,13,21,2018,5,9,Wednseday
1,8,10,18,2017,11,27,Monday
3,9,37,46,2018,8,18,Saturday
2,15,7,22,2018,5,22,Tuesday
2,8,10,18,2018,8,13,Monday
3,7,5,12,2018,8,3,Friday
3,4,11,15,2018,6,18,Monday
1,8,23,31,2018,4,16,Monday
7,27,-3,24,2018,5,8,Tuesday
1,20,21,41,2017,2,14,Tuesday
13,20,11,31,2018,1,9,Tuesday
2,13,5,18,2018,7,22,Sunday
2,10,13,23,2017,4,3,Monday
3,5,14,19,2017,12,30,Saturday
2,3,22,25,2018,5,26,Saturday
1,15,7,22,2017,7,6,Thursday
3,7,26,33,2018,6,29,Friday
3,19,6,25,2018,5,20,Sunday
1,2,13,15,2018,4,24,Tuesday
1,5,18,23,2017,7,30,Sunday
5,11,21,32,2018,6,9,Saturday
1,18,4,22,2018,8,9,Thursday
1,8,17,25,2017,12,10,Sunday
3,8,13,21,2018,1,16,Tuesday
4,5,0,5,2018,8,23,Thursday
1,2,9,11,2018,3,4,Sunday
3,4,12,16,2017,9,16,Saturday
1,7,38,45,2017,12,12,Tuesday
9,17,6,23,2018,1,22,Monday
10,20,13,33,2018,8,4,Saturday
0,12,19,31,2017,5,19,Friday
9,23,5,28,2017,7,25,Tuesday
1,16,20,36,2017,12,21,Thursday
2,24,9,33,2018,5,19,Saturday
2,8,5,13,2018,4,25,Wednseday
0,1,17,18,2018,2,1,Thursday
4,13,-1,12,2018,5,10,Thursday
2,9,15,24,2017,9,16,Saturday
1,3,14,17,2018,6,11,Monday
3,10,24,34,2018,1,13,Saturday
1,12,16,28,2017,11,22,Wednseday
3,7,13,20,2017,8,8,Tuesday
1,14,7,21,2017,8,28,Monday
1,6,17,23,2018,1,23,Tuesday
8,9,13,22,2018,1,2,Tuesday
1,6,37,43,2018,3,18,Sunday
9,18,14,32,2018,2,10,Saturday
40,54,-7,47,2017,12,6,Wednseday
2,8,18,26,2018,2,14,Wednseday
1,2,14,16,2018,5,6,Sunday
0,7,22,29,2017,5,29,Monday
0,4,6,10,2018,8,3,Friday
3,25,10,35,2018,4,27,Friday
2,7,18,25,2018,5,14,Monday
1,2,12,14,2017,6,6,Tuesday
1,8,13,21,2017,3,20,Monday
0,6,20,26,2018,5,11,Friday
1,2,12,14,2017,6,8,Thursday
4,11,22,33,2018,6,14,Thursday
2,8,21,29,2017,8,22,Tuesday
1,14,17,31,2018,6,26,Tuesday
1,15,17,32,2018,5,7,Monday
2,10,9,19,2018,7,28,Saturday
1,2,1,3,2018,7,31,Tuesday
6,12,18,30,2018,1,17,Wednseday
3,18,10,28,2018,2,26,Monday
1,8,11,19,2018,8,8,Wednseday
4,21,22,43,2018,1,18,Thursday
4,17,16,33,2018,1,13,Saturday
17,23,13,36,2018,1,28,Sunday
1,8,6,14,2018,2,8,Thursday
1,3,16,19,2017,7,16,Sunday
6,13,7,20,2018,3,23,Friday
2,7,2,9,2017,5,15,Monday
1,2,17,19,2018,6,27,Wednseday
1,6,13,19,2018,7,4,Wednseday
3,10,14,24,2018,8,3,Friday
5,27,-1,26,2017,11,2,Thursday
0,21,12,33,2017,9,1,Friday
2,5,14,19,2017,3,25,Saturday
3,12,32,44,2017,4,8,Saturday
1,6,30,36,2018,6,20,Wednseday
1,2,12,14,2018,6,19,Tuesday
1,7,22,29,2017,2,14,Tuesday
4,8,17,25,2018,5,24,Thursday
3,18,25,43,2018,6,5,Tuesday
4,24,14,38,2017,12,29,Friday
3,13,6,19,2017,10,13,Friday
7,16,-2,14,2018,5,21,Monday
1,7,7,14,2018,8,2,Thursday
15,33,7,40,2018,2,11,Sunday
3,23,2,25,2017,12,18,Monday
2,78,-65,13,2017,5,31,Wednseday
0,7,15,22,2017,4,13,Thursday
1,4,6,10,2018,8,6,Monday
4,15,-8,7,2018,8,13,Monday
3,4,16,20,2017,9,30,Saturday
2,8,21,29,2018,6,20,Wednseday
4,14,11,25,2017,11,13,Monday
5,9,9,18,2017,3,12,Sunday
2,27,9,36,2017,10,24,Tuesday
3,8,16,24,2018,4,3,Tuesday
2,10,9,19,2018,8,4,Saturday
2,29,0,29,2018,5,7,Monday
4,7,5,12,2018,8,16,Thursday
2,9,2,11,2018,8,20,Monday
1,5,18,23,2017,7,16,Sunday
3,13,11,24,2018,4,3,Tuesday
4,7,7,14,2017,6,12,Monday
4,12,14,26,2018,4,15,Sunday
1,8,13,21,2017,3,15,Wednseday
2,8,14,22,2018,1,16,Tuesday
3,7,17,24,2017,5,19,Friday
2,5,13,18,2018,2,1,Thursday
1,12,17,29,2018,1,11,Thursday
3,7,5,12,2018,8,3,Friday
2,18,-3,15,2018,3,27,Tuesday
4,17,7,24,2017,6,30,Friday
2,8,10,18,2018,8,5,Sunday
3,19,11,30,2017,2,12,Sunday
9,10,6,16,2018,1,30,Tuesday
3,7,16,23,2017,7,23,Sunday
5,12,13,25,2018,2,11,Sunday
17,22,3,25,2017,7,3,Monday
1,9,27,36,2018,4,22,Sunday
4,8,18,26,2017,11,17,Friday
9,15,17,32,2018,6,11,Monday
3,20,10,30,2018,4,21,Saturday
4,11,26,37,2018,5,28,Monday
1,2,14,16,2018,5,6,Sunday
1,10,29,39,2017,1,29,Sunday
6,28,-4,24,2017,11,25,Saturday
3,25,1,26,2017,8,11,Friday
1,7,18,25,2018,7,2,Monday
6,19,16,35,2017,10,5,Thursday
5,9,19,28,2018,6,21,Thursday
3,8,22,30,2018,6,11,Monday
0,6,18,24,2017,8,4,Friday
5,24,12,36,2017,8,6,Sunday
2,7,4,11,2018,8,6,Monday
5,16,12,28,2018,3,1,Thursday
5,24,7,31,2017,11,25,Saturday
1,2,15,17,2018,7,2,Monday
1,8,18,26,2017,5,21,Sunday
1,2,7,9,2018,6,11,Monday
1,16,7,23,2017,10,22,Sunday
3,9,20,29,2017,12,4,Monday
2,5,13,18,2017,9,10,Sunday
6,15,5,20,2018,3,14,Wednseday
3,11,25,36,2018,7,15,Sunday
2,5,13,18,2018,5,19,Saturday
1,21,2,23,2018,3,27,Tuesday
3,6,10,16,2018,4,10,Tuesday
1,5,32,37,2018,6,13,Wednseday
4,12,6,18,2017,11,6,Monday
0,1,14,15,2017,9,25,Monday
2,13,14,27,2017,8,16,Wednseday
2,9,13,22,2017,11,26,Sunday
2,19,7,26,2018,2,3,Saturday
4,19,5,24,2018,2,17,Saturday
1,13,20,33,2018,4,22,Sunday
12,21,0,21,2018,7,26,Thursday
1,4,16,20,2017,11,9,Thursday
1,19,28,47,2018,4,18,Wednseday
2,36,-14,22,2018,3,20,Tuesday
2,20,2,22,2018,2,20,Tuesday
1,27,3,30,2018,3,21,Wednseday
1,12,16,28,2018,6,7,Thursday
8,12,19,31,2017,10,22,Sunday
4,7,16,23,2018,3,19,Monday
3,26,-5,21,2018,2,19,Monday
2,18,7,25,2018,2,17,Saturday
1,8,6,14,2017,11,13,Monday
3,9,7,16,2017,12,4,Monday
1,7,20,27,2018,1,25,Thursday
6,11,15,26,2018,5,11,Friday
3,6,12,18,2018,3,3,Saturday
1,4,14,18,2018,4,9,Monday
1,5,16,21,2018,5,14,Monday
12,22,-1,21,2017,3,29,Wednseday
1,21,0,21,2018,5,15,Tuesday
2,7,7,14,2017,10,9,Monday
5,10,15,25,2018,4,13,Friday
1,5,8,13,2018,3,28,Wednseday
1,9,13,22,2017,7,31,Monday
5,16,8,24,2018,7,20,Friday
1,18,15,33,2017,2,15,Wednseday
2,9,10,19,2017,3,11,Saturday
3,58,-31,27,2018,3,30,Friday
1,18,-1,17,2017,4,24,Monday
10,18,10,28,2017,4,18,Tuesday
0,7,13,20,2018,4,13,Friday
1,6,12,18,2018,4,6,Friday
4,10,14,24,2017,9,15,Friday
1,5,17,22,2017,6,11,Sunday
2,8,13,21,2017,11,14,Tuesday
2,7,5,12,2017,11,22,Wednseday
1,2,15,17,2018,4,23,Monday
11,15,9,24,2018,7,15,Sunday
1,5,15,20,2017,5,11,Thursday
1,2,14,16,2018,4,18,Wednseday
1,3,7,10,2018,8,27,Monday
5,22,-4,18,2018,3,2,Friday
6,28,-6,22,2018,2,15,Thursday
7,10,23,33,2018,7,18,Wednseday
1,23,14,37,2018,2,4,Sunday
2,9,15,24,2017,7,15,Saturday
3,8,5,13,2017,6,23,Friday
4,10,12,22,2018,7,1,Sunday
2,4,13,17,2018,1,20,Saturday
1,8,20,28,2017,10,25,Wednseday
8,32,-1,31,2017,8,28,Monday
4,7,21,28,2018,6,21,Thursday
3,6,8,14,2017,9,5,Tuesday
2,16,6,22,2017,5,9,Tuesday
3,21,7,28,2017,10,20,Friday
4,12,30,42,2017,12,29,Friday
4,11,1,12,2018,8,12,Sunday
6,12,13,25,2017,2,24,Friday
2,16,15,31,2017,2,14,Tuesday
9,21,6,27,2018,2,6,Tuesday
2,8,11,19,2018,5,9,Wednseday
1,5,8,13,2018,3,28,Wednseday
1,7,16,23,2018,4,9,Monday
3,10,21,31,2018,8,14,Tuesday
1,18,19,37,2017,10,30,Monday
4,8,0,8,2018,8,5,Sunday
2,3,13,16,2018,5,19,Saturday
2,37,-24,13,2017,5,23,Tuesday
4,12,14,26,2017,4,20,Thursday
0,2,1,3,2018,8,21,Tuesday
1,31,-1,30,2018,1,16,Tuesday
2,19,11,30,2018,5,19,Saturday
1,28,-18,10,2018,8,14,Tuesday
3,16,32,48,2018,6,5,Tuesday
0,6,10,16,2018,4,11,Wednseday
2,6,10,16,2018,7,10,Tuesday
2,12,15,27,2018,5,2,Wednseday
4,10,9,19,2018,3,23,Friday
3,15,6,21,2018,7,31,Tuesday
4,10,14,24,2017,5,20,Saturday
6,15,13,28,2018,1,9,Tuesday
0,7,22,29,2018,1,16,Tuesday
6,7,8,15,2018,4,11,Wednseday
6,20,7,27,2017,6,10,Saturday
2,3,8,11,2018,7,8,Sunday
5,25,-4,21,2017,11,24,Friday
3,14,15,29,2017,5,30,Tuesday
4,18,9,27,2018,4,12,Thursday
2,8,21,29,2018,3,25,Sunday
6,10,10,20,2017,11,28,Tuesday
1,12,17,29,2017,11,30,Thursday
1,6,9,15,2018,8,1,Wednseday
7,21,19,40,2017,12,1,Friday
4,11,20,31,2017,12,8,Friday
1,4,14,18,2018,5,7,Monday
4,11,15,26,2018,2,17,Saturday
5,12,15,27,2018,1,3,Wednseday
3,7,10,17,2018,3,26,Monday
1,9,20,29,2017,3,14,Tuesday
6,11,16,27,2017,1,5,Thursday
4,9,12,21,2017,8,28,Monday
1,23,12,35,2018,1,29,Monday
6,22,0,22,2017,11,29,Wednseday
6,9,1,10,2017,10,17,Tuesday
3,13,20,33,2017,9,16,Saturday
1,3,17,20,2018,7,10,Tuesday
2,15,13,28,2018,2,6,Tuesday
1,2,12,14,2017,5,24,Wednseday
1,2,8,10,2018,6,18,Monday
0,5,34,39,2017,1,20,Friday
2,3,27,30,2018,1,20,Saturday
2,15,23,38,2017,2,27,Monday
1,10,22,32,2018,6,10,Sunday
4,6,12,18,2018,4,6,Friday
6,13,9,22,2017,5,16,Tuesday
3,12,13,25,2018,4,14,Saturday
4,7,20,27,2018,6,22,Friday
1,9,21,30,2018,6,11,Monday
1,8,21,29,2017,6,13,Tuesday
2,16,8,24,2017,4,25,Tuesday
3,19,12,31,2017,2,17,Friday
0,11,16,27,2018,1,9,Tuesday
4,15,20,35,2017,8,31,Thursday
4,10,15,25,2017,2,25,Saturday
4,11,10,21,2017,10,27,Friday
2,10,20,30,2017,5,9,Tuesday
0,12,13,25,2017,6,1,Thursday
1,6,17,23,2017,5,30,Tuesday
6,12,14,26,2017,3,2,Thursday
1,3,14,17,2018,1,9,Tuesday
4,10,2,12,2018,8,19,Sunday
11,15,14,29,2018,8,13,Monday
2,12,11,23,2017,10,25,Wednseday
2,8,22,30,2018,6,20,Wednseday
3,10,27,37,2018,6,5,Tuesday
3,10,23,33,2018,2,11,Sunday
3,4,8,12,2017,5,28,Sunday
3,23,9,32,2018,2,3,Saturday
4,18,12,30,2018,4,29,Sunday
2,8,13,21,2018,5,1,Tuesday
1,1,15,16,2018,2,5,Monday
1,23,0,23,2018,3,28,Wednseday
1,2,32,34,2017,1,25,Wednseday
3,14,16,30,2017,6,19,Monday
2,39,-18,21,2018,3,19,Monday
4,14,11,25,2017,11,17,Friday
2,3,7,10,2018,7,24,Tuesday
1,4,20,24,2017,12,26,Tuesday
1,11,12,23,2018,6,10,Sunday
1,8,29,37,2017,2,1,Wednseday
3,13,-2,11,2017,5,8,Monday
3,17,14,31,2017,2,14,Tuesday
5,26,-6,20,2018,3,24,Saturday
1,2,13,15,2017,8,2,Wednseday
1,4,3,7,2018,8,16,Thursday
2,13,16,29,2017,8,16,Wednseday
1,42,-15,27,2018,2,22,Thursday
4,7,25,32,2017,4,1,Saturday
1,14,9,23,2018,3,20,Tuesday
2,9,27,36,2018,2,5,Monday
4,18,6,24,2017,11,26,Sunday
0,25,-6,19,2018,3,8,Thursday
5,16,5,21,2018,4,12,Thursday
3,12,14,26,2018,1,5,Friday
1,9,15,24,2018,4,29,Sunday
5,17,15,32,2017,6,23,Friday
0,11,15,26,2018,4,13,Friday
3,18,12,30,2018,3,3,Saturday
2,12,7,19,2018,3,8,Thursday
2,8,25,33,2018,8,22,Wednseday
5,11,12,23,2018,5,5,Saturday
1,2,6,8,2018,5,8,Tuesday
1,5,13,18,2017,11,30,Thursday
6,14,7,21,2017,9,6,Wednseday
4,18,11,29,2017,10,16,Monday
5,8,12,20,2017,12,28,Thursday
2,10,26,36,2018,4,15,Sunday
0,5,19,24,2018,6,29,Friday
6,24,6,30,2018,2,17,Saturday
6,17,7,24,2017,5,19,Friday
1,4,17,21,2018,2,19,Monday
14,34,10,44,2018,1,23,Tuesday
4,23,14,37,2017,7,3,Monday
0,6,20,26,2017,10,19,Thursday
0,1,13,14,2018,4,25,Wednseday
2,9,15,24,2018,2,5,Monday
4,14,14,28,2018,2,22,Thursday
1,5,3,8,2018,8,2,Thursday
3,19,0,19,2018,7,20,Friday
0,1,5,6,2018,8,29,Wednseday
2,12,12,24,2017,11,25,Saturday
2,9,14,23,2018,4,18,Wednseday
1,35,-13,22,2018,3,12,Monday
1,6,21,27,2018,1,24,Wednseday
2,9,28,37,2018,6,17,Sunday
4,9,9,18,2018,5,10,Thursday
1,22,3,25,2018,7,9,Monday
0,5,16,21,2017,8,28,Monday
7,10,15,25,2017,10,6,Friday
7,22,4,26,2018,1,25,Thursday
2,20,0,20,2018,5,16,Wednseday
0,11,4,15,2018,8,16,Thursday
2,10,13,23,2017,10,3,Tuesday
2,20,1,21,2018,3,7,Wednseday
1,2,12,14,2018,7,2,Monday
2,17,15,32,2018,1,29,Monday
2,12,6,18,2017,8,27,Sunday
2,4,15,19,2017,12,10,Sunday
4,5,16,21,2018,1,19,Friday
18,28,23,51,2016,10,3,Monday
1,2,22,24,2018,6,4,Monday
6,10,10,20,2017,12,29,Friday
0,8,30,38,2017,7,14,Friday
2,17,2,19,2018,8,5,Sunday
4,9,17,26,2018,6,16,Saturday
2,8,22,30,2018,5,6,Sunday
3,21,1,22,2017,7,11,Tuesday
2,9,21,30,2018,1,22,Monday
3,7,12,19,2018,8,17,Friday
4,7,14,21,2018,7,6,Friday
3,10,18,28,2018,4,30,Monday
1,3,19,22,2018,4,22,Sunday
2,9,18,27,2018,7,28,Saturday
2,5,14,19,2018,6,27,Wednseday
2,9,8,17,2018,3,5,Monday
2,3,9,12,2018,7,11,Wednseday
2,5,8,13,2018,3,21,Wednseday
11,18,20,38,2017,3,6,Monday
10,15,10,25,2018,2,12,Monday
2,5,6,11,2018,7,29,Sunday
7,17,8,25,2018,1,8,Monday
1,4,6,10,2018,7,29,Sunday
5,14,6,20,2018,3,1,Thursday
4,12,14,26,2017,6,23,Friday
12,13,-1,12,2018,3,7,Wednseday
5,21,10,31,2018,3,2,Friday
1,12,21,33,2017,5,18,Thursday
11,19,0,19,2018,3,8,Thursday
2,10,6,16,2018,7,14,Saturday
1,8,11,19,2017,9,14,Thursday
1,14,14,28,2018,3,27,Tuesday
5,15,14,29,2017,8,30,Wednseday
1,31,4,35,2018,5,7,Monday
1,6,20,26,2017,12,20,Wednseday
3,5,10,15,2018,4,29,Sunday
5,12,10,22,2018,1,14,Sunday
8,20,8,28,2018,7,4,Wednseday
2,17,13,30,2018,1,8,Monday
0,41,-7,34,2018,1,23,Tuesday
4,21,3,24,2017,11,25,Saturday
2,9,11,20,2017,5,17,Wednseday
2,15,8,23,2018,5,1,Tuesday
2,8,18,26,2017,9,27,Wednseday
2,10,6,16,2017,10,16,Monday
4,11,3,14,2017,3,27,Monday
0,6,8,14,2018,5,8,Tuesday
4,9,14,23,2017,7,23,Sunday
2,14,8,22,2017,5,9,Tuesday
1,3,13,16,2018,8,19,Sunday
6,13,11,24,2017,7,14,Friday
2,6,23,29,2017,2,14,Tuesday
3,32,-3,29,2018,2,25,Sunday
7,34,-11,23,2018,3,20,Tuesday
1,24,-1,23,2018,5,1,Tuesday
1,5,14,19,2017,3,9,Thursday
1,8,10,18,2018,5,6,Sunday
2,12,9,21,2017,4,26,Wednseday
2,7,11,18,2017,10,30,Monday
2,24,-6,18,2018,5,19,Saturday
7,22,-2,20,2018,5,17,Thursday
0,1,17,18,2018,5,24,Thursday
0,1,5,6,2018,8,28,Tuesday
4,27,5,32,2018,2,11,Sunday
1,3,11,14,2017,11,29,Wednseday
5,12,19,31,2018,6,22,Friday
7,19,20,39,2017,8,10,Thursday
5,8,6,14,2018,2,22,Thursday
8,9,5,14,2018,6,12,Tuesday
0,10,13,23,2018,4,25,Wednseday
2,9,0,9,2018,8,1,Wednseday
4,11,9,20,2018,8,17,Friday
1,13,27,40,2018,3,23,Friday
3,31,-7,24,2018,1,27,Saturday
0,13,10,23,2017,10,16,Monday
1,5,11,16,2018,4,25,Wednseday
1,15,14,29,2018,5,1,Tuesday
1,47,-8,39,2018,7,5,Thursday
3,17,9,26,2018,3,9,Friday
3,32,1,33,2017,12,30,Saturday
8,18,8,26,2017,3,16,Thursday
9,25,-3,22,2017,11,27,Monday
1,2,29,31,2018,6,11,Monday
3,20,9,29,2017,10,24,Tuesday
3,17,7,24,2018,2,2,Friday
1,5,21,26,2018,1,24,Wednseday
2,6,9,15,2017,7,26,Wednseday
6,23,2,25,2017,11,25,Saturday
3,17,14,31,2017,11,27,Monday
3,10,27,37,2018,4,29,Sunday
2,18,1,19,2018,3,18,Sunday
14,28,7,35,2017,10,6,Friday
1,2,12,14,2018,5,2,Wednseday
1,6,13,19,2018,3,21,Wednseday
20,23,-6,17,2017,11,25,Saturday
6,15,35,50,2017,1,24,Tuesday
0,4,17,21,2017,12,22,Friday
0,3,20,23,2017,11,25,Saturday
4,11,11,22,2017,7,6,Thursday
1,7,20,27,2018,2,20,Tuesday
8,13,20,33,2018,6,20,Wednseday
3,7,1,8,2018,5,21,Monday
1,9,14,23,2018,4,17,Tuesday
1,5,25,30,2017,8,6,Sunday
1,13,21,34,2017,5,25,Thursday
0,6,15,21,2017,4,4,Tuesday
1,8,13,21,2017,9,11,Monday
2,16,19,35,2017,3,20,Monday
5,14,10,24,2017,6,16,Friday
5,15,18,33,2018,2,11,Sunday
1,12,24,36,2017,5,3,Wednseday
1,7,16,23,2018,7,31,Tuesday
1,13,7,20,2018,8,16,Thursday
2,6,19,25,2017,9,23,Saturday
2,9,13,22,2017,11,12,Sunday
2,16,9,25,2017,12,3,Sunday
2,21,10,31,2017,5,8,Monday
0,3,13,16,2018,7,10,Tuesday
16,20,2,22,2018,7,24,Tuesday
3,11,13,24,2018,2,12,Monday
5,12,15,27,2017,12,22,Friday
6,8,23,31,2018,8,21,Tuesday
6,29,23,52,2018,5,29,Tuesday
3,12,12,24,2017,2,26,Sunday
2,15,20,35,2017,6,14,Wednseday
2,5,6,11,2018,5,10,Thursday
2,9,14,23,2018,7,3,Tuesday
3,8,21,29,2018,1,2,Tuesday
2,4,11,15,2018,7,9,Monday
1,6,13,19,2017,10,22,Sunday
3,11,15,26,2017,9,2,Saturday
2,11,14,25,2018,1,20,Saturday
3,6,20,26,2018,6,16,Saturday
1,4,14,18,2018,5,24,Thursday
4,7,16,23,2018,6,25,Monday
6,26,11,37,2017,12,30,Saturday
1,2,11,13,2018,4,25,Wednseday
1,2,3,5,2018,8,15,Wednseday
2,36,-3,33,2017,12,2,Saturday
1,10,13,23,2017,8,21,Monday
2,20,13,33,2018,2,4,Sunday
3,29,0,29,2018,4,3,Tuesday
4,15,-3,12,2017,7,16,Sunday
7,8,19,27,2018,4,26,Thursday
5,15,11,26,2018,2,22,Thursday
3,4,17,21,2017,12,25,Monday
1,8,18,26,2018,5,10,Thursday
4,11,15,26,2018,1,20,Saturday
8,9,15,24,2018,8,7,Tuesday
1,24,-6,18,2018,2,2,Friday
8,22,7,29,2017,4,10,Monday
13,19,13,32,2017,10,12,Thursday
1,2,9,11,2018,6,17,Sunday
1,5,20,25,2017,9,28,Thursday
1,4,13,17,2018,8,6,Monday
2,9,20,29,2018,8,1,Wednseday
1,7,15,22,2017,7,12,Wednseday
3,7,13,20,2017,10,20,Friday
2,7,15,22,2017,7,5,Wednseday
2,12,19,31,2017,2,18,Saturday
2,9,20,29,2017,5,2,Tuesday
8,16,8,24,2017,5,1,Monday
4,16,22,38,2017,4,16,Sunday
8,10,19,29,2017,8,21,Monday
0,1,17,18,2018,6,29,Friday
2,17,11,28,2017,12,13,Wednseday
2,14,16,30,2018,8,14,Tuesday
16,17,12,29,2018,3,25,Sunday
2,6,22,28,2017,8,15,Tuesday
1,9,12,21,2017,11,15,Wednseday
0,1,13,14,2017,6,8,Thursday
2,4,21,25,2018,1,6,Saturday
2,9,12,21,2017,10,16,Monday
3,40,-13,27,2017,11,25,Saturday
3,10,14,24,2018,2,17,Saturday
1,17,11,28,2018,2,6,Tuesday
1,13,19,32,2018,3,22,Thursday
1,8,14,22,2017,10,19,Thursday
3,7,11,18,2017,10,6,Friday
2,9,13,22,2017,7,4,Tuesday
3,4,14,18,2018,2,2,Friday
1,7,16,23,2018,4,11,Wednseday
3,7,8,15,2018,1,15,Monday
1,43,-24,19,2018,3,15,Thursday
1,8,14,22,2017,9,11,Monday
1,6,22,28,2018,7,4,Wednseday
1,13,10,23,2017,7,19,Wednseday
2,9,12,21,2018,4,2,Monday
4,5,0,5,2018,8,10,Friday
5,6,14,20,2017,12,16,Saturday
6,24,11,35,2018,6,27,Wednseday
4,9,25,34,2017,11,25,Saturday
1,21,1,22,2018,2,22,Thursday
1,7,2,9,2018,8,14,Tuesday
4,11,15,26,2017,3,18,Saturday
0,7,17,24,2018,2,2,Friday
0,8,25,33,2018,3,7,Wednseday
2,13,15,28,2018,2,6,Tuesday
1,7,15,22,2018,2,18,Sunday
7,20,3,23,2018,1,16,Tuesday
4,28,-6,22,2017,9,18,Monday
0,5,18,23,2017,8,2,Wednseday
1,12,6,18,2018,5,21,Monday
2,6,21,27,2018,5,2,Wednseday
3,31,0,31,2018,3,13,Tuesday
6,8,21,29,2017,8,3,Thursday
6,13,20,33,2018,5,2,Wednseday
16,28,8,36,2017,7,5,Wednseday
6,14,25,39,2018,5,24,Thursday
8,23,-1,22,2017,4,19,Wednseday
1,9,14,23,2017,10,15,Sunday
1,17,14,31,2018,1,7,Sunday
1,22,6,28,2017,12,12,Tuesday
3,10,18,28,2017,7,17,Monday
2,16,15,31,2018,1,20,Saturday
0,11,8,19,2018,3,1,Thursday
1,12,17,29,2018,4,22,Sunday
4,13,13,26,2017,10,12,Thursday
1,7,15,22,2018,5,2,Wednseday
3,10,21,31,2017,2,10,Friday
2,6,10,16,2018,8,1,Wednseday
1,8,15,23,2017,5,24,Wednseday
1,6,18,24,2018,6,24,Sunday
1,2,15,17,2018,5,1,Tuesday
2,10,16,26,2017,5,13,Saturday
3,30,5,35,2018,3,19,Monday
1,9,20,29,2018,4,18,Wednseday
3,17,14,31,2018,2,2,Friday
3,22,24,46,2018,6,15,Friday
3,20,7,27,2018,1,13,Saturday
2,8,19,27,2018,4,25,Wednseday
3,7,9,16,2017,10,3,Tuesday
4,12,14,26,2017,4,6,Thursday
0,8,19,27,2018,7,5,Thursday
6,7,1,8,2018,5,10,Thursday
0,5,17,22,2017,6,28,Wednseday
3,11,14,25,2017,7,30,Sunday
7,22,4,26,2017,8,9,Wednseday
4,6,10,16,2018,5,28,Monday
1,7,15,22,2017,10,9,Monday
1,9,32,41,2018,6,6,Wednseday
1,9,2,11,2017,5,8,Monday
2,6,4,10,2017,9,19,Tuesday
5,12,9,21,2018,4,25,Wednseday
3,11,14,25,2018,7,20,Friday
8,26,-1,25,2017,8,24,Thursday
14,30,-1,29,2017,12,6,Wednseday
1,2,2,4,2018,8,20,Monday
5,6,13,19,2017,12,30,Saturday
1,6,11,17,2017,3,21,Tuesday
1,4,-1,3,2018,8,21,Tuesday
3,3,13,16,2018,1,21,Sunday
3,6,27,33,2018,6,2,Saturday
2,11,14,25,2017,9,3,Sunday
7,14,16,30,2018,1,23,Tuesday
1,4,14,18,2018,4,19,Thursday
1,19,3,22,2018,7,19,Thursday
5,13,14,27,2017,3,29,Wednseday
0,6,33,39,2017,1,27,Friday
2,18,1,19,2018,5,17,Thursday
4,10,10,20,2018,6,15,Friday
4,8,16,24,2017,6,5,Monday
4,7,34,41,2018,6,1,Friday
1,13,9,22,2017,9,12,Tuesday
3,11,5,16,2017,11,25,Saturday
4,10,15,25,2017,11,10,Friday
2,13,15,28,2018,2,20,Tuesday
1,4,11,15,2018,8,5,Sunday
2,13,3,16,2018,3,7,Wednseday
2,17,12,29,2018,2,20,Tuesday
3,16,9,25,2018,7,21,Saturday
4,9,13,22,2017,2,26,Sunday
2,8,16,24,2017,12,12,Tuesday
2,9,10,19,2017,11,12,Sunday
1,3,13,16,2018,3,12,Monday
6,13,6,19,2017,11,17,Friday
5,5,7,12,2018,3,16,Friday
3,10,11,21,2018,2,20,Tuesday
1,4,20,24,2018,4,8,Sunday
3,5,8,13,2017,10,27,Friday
13,19,11,30,2017,10,18,Wednseday
3,4,9,13,2018,3,24,Saturday
1,3,11,14,2017,6,6,Tuesday
1,8,13,21,2017,11,20,Monday
1,4,12,16,2017,9,27,Wednseday
1,12,14,26,2018,2,4,Sunday
1,9,22,31,2018,1,30,Tuesday
2,10,12,22,2017,9,4,Monday
3,6,4,10,2018,3,6,Tuesday
2,49,-14,35,2017,7,11,Tuesday
9,16,21,37,2018,5,28,Monday
2,15,13,28,2017,7,11,Tuesday
3,7,14,21,2017,9,12,Tuesday
1,6,6,12,2018,8,15,Wednseday
11,19,2,21,2017,11,23,Thursday
4,17,0,17,2018,3,19,Monday
3,26,11,37,2018,3,18,Sunday
6,14,26,40,2018,6,15,Friday
2,8,24,32,2018,7,22,Sunday
13,14,9,23,2017,5,16,Tuesday
5,6,8,14,2018,2,9,Friday
0,4,7,11,2018,8,9,Thursday
3,5,20,25,2017,9,24,Sunday
14,17,15,32,2017,12,2,Saturday
4,5,9,14,2018,3,2,Friday
1,6,17,23,2018,1,3,Wednseday
1,10,10,20,2018,2,20,Tuesday
6,25,13,38,2017,12,15,Friday
1,10,19,29,2017,3,6,Monday
3,14,21,35,2018,1,5,Friday
2,35,-11,24,2018,2,26,Monday
1,10,27,37,2018,6,5,Tuesday
3,9,7,16,2018,7,28,Saturday
2,10,32,42,2018,6,4,Monday
2,3,16,19,2018,4,21,Saturday
5,29,14,43,2017,4,23,Sunday
1,2,19,21,2017,12,18,Monday
2,26,-4,22,2018,2,21,Wednseday
16,35,11,46,2017,5,15,Monday
1,5,17,22,2018,6,11,Monday
4,5,7,12,2018,3,17,Saturday
7,15,26,41,2017,2,22,Wednseday
4,11,16,27,2017,2,10,Friday
9,11,7,18,2017,10,7,Saturday
2,11,13,24,2018,8,18,Saturday
1,56,-15,41,2018,6,6,Wednseday
5,11,23,34,2018,6,23,Saturday
1,11,13,24,2017,6,11,Sunday
3,29,-8,21,2018,5,7,Monday
8,15,17,32,2018,6,18,Monday
21,22,-8,14,2018,7,10,Tuesday
1,6,10,16,2017,11,21,Tuesday
1,5,18,23,2018,6,10,Sunday
3,11,14,25,2017,10,6,Friday
1,8,20,28,2017,10,26,Thursday
1,21,25,46,2018,6,7,Thursday
4,14,6,20,2017,11,24,Friday
2,14,20,34,2018,1,31,Wednseday
5,10,16,26,2018,8,10,Friday
4,9,16,25,2017,6,10,Saturday
1,4,11,15,2018,1,18,Thursday
3,9,16,25,2018,4,14,Saturday
2,53,-30,23,2018,2,26,Monday
1,49,-23,26,2017,7,6,Thursday
4,10,10,20,2018,7,20,Friday
4,66,-41,25,2018,3,2,Friday
12,26,-2,24,2017,11,24,Friday
1,7,17,24,2018,7,17,Tuesday
1,12,7,19,2017,5,21,Sunday
2,28,-3,25,2018,3,12,Monday
3,7,6,13,2018,8,17,Friday
1,3,13,16,2018,6,25,Monday
8,25,5,30,2018,1,30,Tuesday
4,19,15,34,2017,12,23,Saturday
13,14,14,28,2018,3,15,Thursday
1,9,15,24,2018,6,25,Monday
2,3,11,14,2018,7,3,Tuesday
2,11,19,30,2018,3,4,Sunday
3,16,20,36,2018,2,11,Sunday
6,7,19,26,2018,7,25,Wednseday
1,7,20,27,2018,6,20,Wednseday
3,17,6,23,2018,2,26,Monday
14,34,-9,25,2017,11,25,Saturday
2,14,23,37,2018,4,9,Monday
0,3,14,17,2017,8,28,Monday
9,12,-7,5,2018,8,15,Wednseday
1,16,5,21,2017,4,26,Wednseday
14,20,35,55,2016,10,7,Friday
3,17,15,32,2018,4,16,Monday
3,7,13,20,2018,4,27,Friday
6,51,-21,30,2017,6,24,Saturday
5,7,13,20,2017,7,5,Wednseday
1,7,17,24,2017,4,25,Tuesday
2,21,0,21,2017,9,19,Tuesday
4,14,8,22,2017,9,21,Thursday
1,10,17,27,2017,5,30,Tuesday
0,3,19,22,2017,5,16,Tuesday
2,7,14,21,2018,4,9,Monday
4,15,12,27,2018,2,22,Thursday
4,27,5,32,2017,12,29,Friday
2,7,9,16,2018,8,1,Wednseday
3,4,21,25,2018,6,4,Monday
1,3,17,20,2017,3,28,Tuesday
3,11,15,26,2017,7,28,Friday
1,2,15,17,2018,5,6,Sunday
0,10,21,31,2018,4,27,Friday
4,9,17,26,2017,9,2,Saturday
1,4,18,22,2018,8,5,Sunday
2,5,9,14,2018,4,25,Wednseday
1,15,10,25,2018,4,15,Sunday
2,9,17,26,2017,6,17,Saturday
2,8,15,23,2017,10,15,Sunday
0,8,6,14,2018,5,14,Monday
4,17,22,39,2017,12,18,Monday
0,9,32,41,2017,8,30,Wednseday
0,7,18,25,2017,3,17,Friday
4,5,8,13,2017,10,27,Friday
1,12,9,21,2017,9,7,Thursday
2,38,-8,30,2018,6,17,Sunday
4,9,43,52,2017,3,18,Saturday
19,26,14,40,2017,2,5,Sunday
9,17,24,41,2017,4,1,Saturday
2,12,19,31,2018,2,4,Sunday
6,8,20,28,2017,8,16,Wednseday
5,7,12,19,2017,8,30,Wednseday
8,13,22,35,2018,5,29,Tuesday
3,10,11,21,2018,5,1,Tuesday
1,15,5,20,2018,8,2,Thursday
3,10,31,41,2018,6,5,Tuesday
4,13,18,31,2018,5,4,Friday
1,2,12,14,2017,6,7,Wednseday
2,5,20,25,2018,5,13,Sunday
5,19,7,26,2018,2,10,Saturday
2,7,27,34,2018,5,15,Tuesday
0,4,9,13,2017,10,26,Thursday
2,23,7,30,2018,6,19,Tuesday
0,3,10,13,2017,7,21,Friday
3,6,11,17,2018,5,12,Saturday
3,16,9,25,2018,3,11,Sunday
1,2,12,14,2018,2,20,Tuesday
1,10,19,29,2017,9,19,Tuesday
11,13,0,13,2018,3,24,Saturday
4,12,21,33,2017,8,10,Thursday
1,5,22,27,2017,2,8,Wednseday
2,20,23,43,2017,12,14,Thursday
3,14,22,36,2017,3,27,Monday
8,10,18,28,2017,8,14,Monday
6,20,4,24,2018,5,1,Tuesday
1,22,9,31,2018,3,12,Monday
2,23,4,27,2017,11,21,Tuesday
1,4,17,21,2018,7,12,Thursday
6,10,22,32,2017,2,3,Friday
1,7,13,20,2018,7,26,Thursday
3,31,-15,16,2018,3,6,Tuesday
1,14,21,35,2017,7,26,Wednseday
14,22,7,29,2018,2,26,Monday
4,25,7,32,2017,11,24,Friday
1,18,9,27,2018,6,27,Wednseday
3,13,19,32,2017,5,12,Friday
4,15,11,26,2017,5,21,Sunday
1,5,8,13,2017,6,1,Thursday
2,12,20,32,2017,4,22,Saturday
9,16,14,30,2017,8,1,Tuesday
1,4,14,18,2018,1,4,Thursday
2,16,23,39,2017,2,4,Saturday
4,11,7,18,2017,9,8,Friday
1,11,12,23,2018,3,6,Tuesday
2,10,8,18,2017,8,14,Monday
4,20,12,32,2017,12,8,Friday
1,4,11,15,2018,4,5,Thursday
1,4,8,12,2018,4,5,Thursday
2,5,14,19,2017,7,16,Sunday
2,29,15,44,2017,11,5,Sunday
4,12,14,26,2017,7,28,Friday
4,7,0,7,2018,8,6,Monday
1,7,21,28,2018,1,8,Monday
2,8,22,30,2018,1,30,Tuesday
4,6,2,8,2018,8,9,Thursday
3,17,25,42,2018,6,1,Friday
5,11,14,25,2017,10,12,Thursday
3,12,22,34,2018,5,25,Friday
2,7,21,28,2018,4,18,Wednseday
11,14,14,28,2018,2,19,Monday
1,3,13,16,2018,2,6,Tuesday
4,21,-1,20,2018,3,31,Saturday
2,16,5,21,2018,4,2,Monday
2,9,12,21,2018,7,11,Wednseday
3,4,7,11,2018,3,11,Sunday
6,17,16,33,2017,11,24,Friday
1,3,5,8,2018,7,18,Wednseday
1,6,7,13,2018,8,16,Thursday
1,29,3,32,2017,10,9,Monday
1,7,36,43,2018,5,7,Monday
4,7,48,55,2016,10,7,Friday
1,10,12,22,2018,1,30,Tuesday
4,9,13,22,2017,9,4,Monday
6,11,13,24,2018,6,9,Saturday
8,15,9,24,2017,12,19,Tuesday
5,11,14,25,2018,4,27,Friday
0,1,5,6,2018,8,28,Tuesday
1,18,7,25,2017,11,6,Monday
2,17,7,24,2018,2,24,Saturday
4,21,9,30,2017,12,18,Monday
11,16,9,25,2018,7,15,Sunday
5,12,8,20,2017,9,6,Wednseday
2,12,20,32,2017,8,5,Saturday
5,12,11,23,2017,7,23,Sunday
2,9,18,27,2018,1,30,Tuesday
2,6,9,15,2018,1,23,Tuesday
1,3,3,6,2018,8,21,Tuesday
0,7,12,19,2017,10,19,Thursday
2,12,15,27,2017,10,28,Saturday
2,23,-3,20,2017,11,28,Tuesday
1,18,16,34,2017,12,21,Thursday
2,22,16,38,2018,6,4,Monday
5,19,8,27,2017,11,11,Saturday
0,4,14,18,2017,11,6,Monday
1,11,11,22,2017,3,9,Thursday
1,4,8,12,2017,10,19,Thursday
2,3,28,31,2018,8,27,Monday
1,24,4,28,2018,1,9,Tuesday
0,7,14,21,2018,2,20,Tuesday
2,4,9,13,2017,6,24,Saturday
3,8,9,17,2018,8,12,Sunday
1,11,9,20,2018,7,3,Tuesday
3,7,24,31,2017,10,3,Tuesday
3,9,15,24,2018,6,24,Sunday
3,9,15,24,2017,11,4,Saturday
10,17,3,20,2017,11,4,Saturday
1,14,22,36,2017,9,18,Monday
1,4,12,16,2018,7,29,Sunday
3,24,-3,21,2017,11,24,Friday
2,15,15,30,2017,12,12,Tuesday
2,42,-11,31,2018,3,20,Tuesday
1,24,6,30,2018,7,2,Monday
5,16,14,30,2018,1,20,Saturday
4,10,10,20,2017,7,7,Friday
4,11,22,33,2018,7,29,Sunday
7,19,1,20,2018,2,15,Thursday
1,4,9,13,2018,3,22,Thursday
1,9,10,19,2018,7,4,Wednseday
2,7,24,31,2018,5,14,Monday
17,25,-2,23,2018,8,4,Saturday
7,9,0,9,2018,5,21,Monday
0,5,29,34,2017,7,12,Wednseday
3,12,20,32,2017,3,31,Friday
6,11,25,36,2018,6,7,Thursday
3,11,12,23,2018,7,21,Saturday
3,18,12,30,2018,1,21,Sunday
1,19,24,43,2018,6,7,Thursday
1,4,22,26,2017,8,13,Sunday
1,10,21,31,2018,3,26,Monday
2,7,16,23,2018,1,22,Monday
2,26,-2,24,2018,5,6,Sunday
0,7,22,29,2017,12,20,Wednseday
2,8,34,42,2017,2,7,Tuesday
5,27,-3,24,2018,2,9,Friday
6,16,31,47,2017,5,17,Wednseday
1,9,4,13,2018,8,21,Tuesday
1,19,8,27,2018,2,14,Wednseday
1,13,28,41,2018,3,27,Tuesday
12,13,14,27,2018,3,31,Saturday
10,30,13,43,2017,7,10,Monday
2,4,14,18,2018,3,25,Sunday
5,9,11,20,2017,8,2,Wednseday
1,5,4,9,2018,8,8,Wednseday
3,11,22,33,2017,2,11,Saturday
2,3,4,7,2018,8,7,Tuesday
4,12,13,25,2017,6,15,Thursday
7,21,4,25,2018,4,9,Monday
1,7,13,20,2017,8,10,Thursday
2,7,7,14,2018,2,19,Monday
3,5,14,19,2017,12,8,Friday
1,9,3,12,2018,3,7,Wednseday
1,11,9,20,2017,7,6,Thursday
7,10,17,27,2017,2,14,Tuesday
6,6,7,13,2018,3,28,Wednseday
2,9,11,20,2017,12,19,Tuesday
1,6,26,32,2018,6,3,Sunday
1,3,17,20,2017,7,18,Tuesday
1,4,14,18,2017,10,30,Monday
7,19,21,40,2017,7,21,Friday
7,25,2,27,2018,2,10,Saturday
11,17,11,28,2018,4,6,Friday
1,16,22,38,2018,6,3,Sunday
1,17,6,23,2017,11,27,Monday
1,7,15,22,2018,3,26,Monday
0,1,4,5,2018,8,23,Thursday
4,14,18,32,2017,6,30,Friday
5,11,16,27,2017,2,24,Friday
0,4,16,20,2017,11,3,Friday
3,4,6,10,2018,7,20,Friday
4,17,9,26,2018,1,5,Friday
1,4,29,33,2018,8,9,Thursday
1,16,7,23,2017,6,28,Wednseday
1,6,24,30,2018,4,15,Sunday
1,8,19,27,2018,3,6,Tuesday
1,3,19,22,2018,7,31,Tuesday
17,20,0,20,2018,3,23,Friday
1,6,8,14,2018,2,8,Thursday
3,4,8,12,2017,9,10,Sunday
1,2,7,9,2018,5,13,Sunday
3,9,14,23,2018,7,16,Monday
2,11,7,18,2017,6,3,Saturday
1,2,10,12,2017,8,13,Sunday
0,1,13,14,2018,3,21,Wednseday
3,10,14,24,2018,4,22,Sunday
2,13,16,29,2017,10,3,Tuesday
1,7,16,23,2018,4,11,Wednseday
1,8,15,23,2017,7,10,Monday
2,18,12,30,2018,1,1,Monday
1,12,14,26,2017,7,20,Thursday
6,13,28,41,2018,1,26,Friday
2,6,17,23,2018,7,4,Wednseday
1,28,3,31,2017,5,22,Monday
11,13,6,19,2018,7,13,Friday
10,11,-2,9,2018,8,5,Sunday
6,14,13,27,2017,11,29,Wednseday
2,7,27,34,2018,5,30,Wednseday
2,12,22,34,2017,1,25,Wednseday
1,4,11,15,2018,1,25,Thursday
1,8,15,23,2017,12,6,Wednseday
1,5,14,19,2017,8,30,Wednseday
1,7,12,19,2018,4,25,Wednseday
2,7,20,27,2017,2,15,Wednseday
1,18,1,19,2018,3,1,Thursday
2,20,3,23,2018,4,1,Sunday
3,6,12,18,2018,8,3,Friday
0,5,13,18,2018,8,3,Friday
4,10,29,39,2018,6,30,Saturday
2,3,10,13,2017,7,19,Wednseday
2,9,15,24,2017,6,24,Saturday
1,4,15,19,2017,10,5,Thursday
1,7,16,23,2018,2,27,Tuesday
3,13,11,24,2017,5,7,Sunday
1,4,10,14,2018,8,20,Monday
10,11,1,12,2018,8,19,Sunday
2,37,-5,32,2017,7,10,Monday
1,10,4,14,2017,11,13,Monday
3,11,13,24,2017,7,29,Saturday
3,4,17,21,2018,2,16,Friday
6,13,23,36,2017,10,17,Tuesday
1,7,15,22,2017,7,6,Thursday
2,11,9,20,2017,5,9,Tuesday
2,8,18,26,2017,5,24,Wednseday
12,20,14,34,2017,7,5,Wednseday
0,13,14,27,2017,8,24,Thursday
2,15,14,29,2017,8,29,Tuesday
3,13,12,25,2017,9,1,Friday
3,9,21,30,2018,7,29,Sunday
3,5,16,21,2017,9,1,Friday
2,4,18,22,2018,6,25,Monday
0,7,14,21,2018,4,30,Monday
3,11,15,26,2017,6,30,Friday
0,2,21,23,2017,2,7,Tuesday
1,5,14,19,2017,11,22,Wednseday
5,17,16,33,2017,8,25,Friday
7,9,14,23,2018,5,29,Tuesday
1,4,8,12,2018,7,29,Sunday
0,18,6,24,2018,5,21,Monday
1,4,18,22,2017,10,22,Sunday
2,9,18,27,2017,10,18,Wednseday
4,27,-2,25,2017,11,24,Friday
7,18,15,33,2018,6,20,Wednseday
2,11,17,28,2018,2,27,Tuesday
3,14,11,25,2017,3,13,Monday
4,13,16,29,2018,5,10,Thursday
4,23,9,32,2018,5,3,Thursday
2,6,9,15,2018,3,27,Tuesday
3,12,5,17,2017,5,14,Sunday
4,11,14,25,2017,10,5,Thursday
6,19,5,24,2017,11,17,Friday
0,6,25,31,2018,6,19,Tuesday
1,8,15,23,2017,5,24,Wednseday
1,7,30,37,2018,7,3,Tuesday
1,6,7,13,2018,8,16,Thursday
3,15,10,25,2018,2,11,Sunday
0,4,9,13,2018,5,10,Thursday
1,7,15,22,2018,5,16,Wednseday
2,10,19,29,2017,10,29,Sunday
3,4,6,10,2018,3,19,Monday
2,11,17,28,2018,2,5,Monday
1,2,17,19,2018,1,10,Wednseday
4,11,8,19,2017,10,12,Thursday
0,10,10,20,2017,8,4,Friday
1,7,7,14,2017,8,3,Thursday
4,12,19,31,2018,6,22,Friday
1,16,14,30,2017,10,9,Monday
1,25,-3,22,2018,3,21,Wednseday
0,6,23,29,2018,5,15,Tuesday
6,12,9,21,2017,12,22,Friday
2,3,5,8,2018,5,8,Tuesday
4,20,2,22,2017,10,19,Thursday
1,10,10,20,2017,9,1,Friday
2,5,12,17,2018,8,11,Saturday
1,2,10,12,2018,6,13,Wednseday
5,3,26,29,2017,8,7,Monday
2,33,2,35,2018,4,2,Monday
1,37,2,39,2017,10,9,Monday
4,6,6,12,2018,8,16,Thursday
4,25,3,28,2018,3,22,Thursday
3,9,21,30,2017,5,20,Saturday
3,17,10,27,2017,5,6,Saturday
8,22,3,25,2017,10,30,Monday
6,11,13,24,2017,12,5,Tuesday
1,9,13,22,2017,4,10,Monday
2,8,13,21,2018,7,16,Monday
3,10,11,21,2017,4,24,Monday
3,13,9,22,2018,3,11,Sunday
1,11,11,22,2018,2,14,Wednseday
5,12,19,31,2018,4,7,Saturday
3,12,22,34,2018,4,20,Friday
4,24,-2,22,2018,2,26,Monday
1,14,13,27,2017,2,7,Tuesday
7,12,21,33,2018,4,13,Friday
2,9,21,30,2017,12,9,Saturday
3,10,9,19,2017,7,2,Sunday
2,3,12,15,2018,7,30,Monday
1,12,11,23,2017,6,7,Wednseday
1,18,0,18,2018,3,8,Thursday
2,9,13,22,2018,3,27,Tuesday
2,9,14,23,2018,1,17,Wednseday
4,12,15,27,2018,2,10,Saturday
3,12,7,19,2017,9,2,Saturday
3,13,14,27,2017,10,3,Tuesday
4,22,6,28,2017,11,30,Thursday
0,8,11,19,2018,7,20,Friday
2,3,12,15,2018,3,26,Monday
1,2,6,8,2018,5,15,Tuesday
0,3,15,18,2017,12,1,Friday
7,17,10,27,2018,7,25,Wednseday
2,16,21,37,2017,8,15,Tuesday
4,7,27,34,2018,6,1,Friday
3,9,4,13,2018,8,11,Saturday
1,36,16,52,2017,9,25,Monday
3,8,20,28,2018,1,12,Friday
0,7,16,23,2017,6,14,Wednseday
4,19,12,31,2018,4,20,Friday
0,9,13,22,2017,10,10,Tuesday
1,11,17,28,2017,11,16,Thursday
1,59,-36,23,2018,2,21,Wednseday
2,3,12,15,2018,6,19,Tuesday
1,4,25,29,2017,1,22,Sunday
2,6,10,16,2018,2,28,Wednseday
0,3,11,14,2017,11,10,Friday
3,4,11,15,2018,6,18,Monday
7,14,18,32,2017,9,11,Monday
0,3,19,22,2017,9,25,Monday
3,4,12,16,2018,8,12,Sunday
2,24,5,29,2017,12,12,Tuesday
7,19,7,26,2017,5,31,Wednseday
2,6,13,19,2018,8,1,Wednseday
3,19,3,22,2017,11,19,Sunday
1,8,18,26,2017,12,20,Wednseday
3,9,16,25,2018,1,15,Monday
4,5,19,24,2018,6,29,Friday
2,4,15,19,2017,8,27,Sunday
3,11,12,23,2017,6,5,Monday
1,8,37,45,2017,1,16,Monday
4,5,3,8,2018,5,17,Thursday
1,12,24,36,2017,5,28,Sunday
3,13,7,20,2017,5,9,Tuesday
4,15,14,29,2017,7,27,Thursday
0,5,25,30,2018,6,13,Wednseday
4,31,3,34,2017,7,28,Friday
2,14,21,35,2017,5,2,Tuesday
1,3,7,10,2018,5,15,Tuesday
1,2,15,17,2018,4,22,Sunday
6,9,8,17,2018,3,27,Tuesday
4,8,11,19,2017,12,8,Friday
2,9,17,26,2017,9,30,Saturday
1,6,14,20,2017,5,17,Wednseday
5,21,34,55,2016,10,5,Wednseday
12,32,11,43,2018,3,1,Thursday
4,11,15,26,2018,4,14,Saturday
0,10,14,24,2017,7,21,Friday
7,9,9,18,2018,8,6,Monday
3,12,20,32,2017,12,8,Friday
1,11,18,29,2017,9,21,Thursday
2,9,9,18,2017,7,24,Monday
2,3,12,15,2018,7,23,Monday
3,15,9,24,2018,7,21,Saturday
5,13,12,25,2017,8,31,Thursday
0,6,15,21,2018,6,27,Wednseday
3,5,11,16,2017,11,11,Saturday
1,8,21,29,2018,6,17,Sunday
1,13,11,24,2018,4,24,Tuesday
0,12,13,25,2017,6,29,Thursday
1,29,3,32,2017,7,24,Monday
2,14,14,28,2017,9,19,Tuesday
6,10,12,22,2018,1,31,Wednseday
1,4,12,16,2018,8,26,Sunday
5,18,8,26,2018,2,10,Saturday
3,5,9,14,2017,11,24,Friday
4,9,6,15,2017,11,13,Monday
1,2,10,12,2018,6,14,Thursday
1,6,28,34,2018,5,16,Wednseday
3,8,14,22,2017,3,12,Sunday
1,28,-7,21,2018,3,7,Wednseday
4,5,11,16,2017,11,25,Saturday
4,11,11,22,2018,2,12,Monday
2,18,1,19,2018,3,17,Saturday
4,7,4,11,2017,7,24,Monday
16,17,18,35,2018,2,6,Tuesday
3,11,13,24,2017,2,26,Sunday
5,14,19,33,2017,12,6,Wednseday
2,8,8,16,2018,5,8,Tuesday
4,10,8,18,2017,8,18,Friday
12,15,1,16,2018,4,29,Sunday
6,14,11,25,2017,11,10,Friday
3,9,16,25,2017,12,17,Sunday
2,14,13,27,2017,12,26,Tuesday
2,11,16,27,2017,9,26,Tuesday
11,14,3,17,2018,3,4,Sunday
5,19,0,19,2018,2,25,Sunday
2,6,27,33,2018,4,21,Saturday
1,2,9,11,2018,3,26,Monday
0,8,17,25,2017,6,5,Monday
4,20,10,30,2018,1,27,Saturday
1,5,16,21,2017,7,12,Wednseday
4,13,14,27,2017,8,3,Thursday
1,21,-1,20,2018,3,27,Tuesday
4,26,7,33,2017,11,24,Friday
1,15,6,21,2018,5,22,Tuesday
2,9,12,21,2018,1,16,Tuesday
3,22,11,33,2017,10,1,Sunday
1,8,14,22,2017,8,1,Tuesday
2,6,10,16,2018,7,25,Wednseday
3,25,12,37,2017,6,3,Saturday
3,7,7,14,2018,2,27,Tuesday
4,11,29,40,2018,6,7,Thursday
1,10,19,29,2018,2,6,Tuesday
4,11,10,21,2018,2,15,Thursday
1,8,6,14,2017,11,10,Friday
1,5,22,27,2017,1,26,Thursday
2,11,11,22,2017,11,28,Tuesday
0,14,31,45,2017,1,31,Tuesday
1,4,20,24,2017,4,2,Sunday
1,4,0,4,2018,7,29,Sunday
2,17,6,23,2017,12,4,Monday
10,13,11,24,2017,9,2,Saturday
7,16,7,23,2017,9,20,Wednseday
5,12,10,22,2017,7,5,Wednseday
4,5,10,15,2018,7,1,Sunday
3,26,-2,24,2017,11,24,Friday
1,7,15,22,2017,7,25,Tuesday
3,17,16,33,2017,10,8,Sunday
2,24,-5,19,2018,2,25,Sunday
20,29,14,43,2017,1,18,Wednseday
1,7,25,32,2018,6,21,Thursday
2,7,13,20,2017,7,25,Tuesday
3,4,2,6,2018,8,17,Friday
5,17,14,31,2017,8,19,Saturday
4,17,3,20,2017,11,24,Friday
1,12,18,30,2017,3,8,Wednseday
1,10,8,18,2018,3,5,Monday
5,15,6,21,2017,11,3,Friday
5,7,13,20,2017,11,24,Friday
3,9,7,16,2018,3,7,Wednseday
1,9,17,26,2018,4,25,Wednseday
1,6,4,10,2018,8,21,Tuesday
2,8,14,22,2018,1,29,Monday
4,10,10,20,2017,11,24,Friday
1,7,20,27,2018,1,25,Thursday
3,5,22,27,2017,12,8,Friday
1,2,8,10,2018,4,2,Monday
1,13,9,22,2018,4,24,Tuesday
1,11,21,32,2017,11,24,Friday
1,2,2,4,2018,8,26,Sunday
1,8,15,23,2017,6,6,Tuesday
4,26,-6,20,2018,3,30,Friday
2,20,8,28,2018,1,3,Wednseday
2,7,10,17,2018,6,18,Monday
3,4,10,14,2017,11,27,Monday
0,11,16,27,2018,3,1,Thursday
1,9,6,15,2018,4,25,Wednseday
1,14,24,38,2018,5,14,Monday
1,2,15,17,2017,10,17,Tuesday
6,14,20,34,2017,11,30,Thursday
4,22,-4,18,2018,3,5,Monday
5,21,3,24,2018,5,11,Friday
1,7,13,20,2017,5,11,Thursday
1,7,16,23,2017,6,12,Monday
2,10,16,26,2018,1,27,Saturday
4,19,7,26,2017,4,30,Sunday
1,3,10,13,2017,9,5,Tuesday
2,9,16,25,2018,8,4,Saturday
1,8,11,19,2018,7,19,Thursday
0,7,14,21,2017,9,6,Wednseday
0,4,10,14,2018,6,29,Friday
5,8,31,39,2017,1,26,Thursday
9,15,9,24,2017,10,17,Tuesday
5,32,-1,31,2018,2,3,Saturday
1,3,25,28,2018,6,25,Monday
4,17,8,25,2018,3,23,Friday
2,5,7,12,2017,10,18,Wednseday
2,17,12,29,2017,5,14,Sunday
3,20,7,27,2017,12,16,Saturday
6,8,13,21,2018,1,17,Wednseday
2,16,5,21,2017,3,20,Monday
3,6,11,17,2018,4,6,Friday
1,13,29,42,2018,6,6,Wednseday
0,7,16,23,2017,11,21,Tuesday
1,8,14,22,2017,7,18,Tuesday
2,13,20,33,2018,8,15,Wednseday
5,13,14,27,2017,12,14,Thursday
10,14,10,24,2018,1,15,Monday
2,6,17,23,2017,3,11,Saturday
2,22,13,35,2017,7,18,Tuesday
4,29,-8,21,2018,2,26,Monday
3,5,5,10,2018,8,4,Saturday
6,14,7,21,2017,5,4,Thursday
2,34,-11,23,2018,3,4,Sunday
1,8,28,36,2018,6,10,Sunday
6,13,35,48,2018,6,5,Tuesday
1,2,14,16,2018,4,11,Wednseday
2,8,10,18,2017,10,22,Sunday
3,10,22,32,2018,5,27,Sunday
2,12,-3,9,2018,5,20,Sunday
2,21,11,32,2017,7,31,Monday
0,2,10,12,2017,11,22,Wednseday
4,19,5,24,2018,2,17,Saturday
5,6,9,15,2017,9,6,Wednseday
1,2,12,14,2017,9,19,Tuesday
2,6,14,20,2017,7,5,Wednseday
1,2,14,16,2018,5,6,Sunday
5,24,12,36,2018,4,2,Monday
2,8,29,37,2018,7,25,Wednseday
2,11,14,25,2017,12,10,Sunday
2,16,5,21,2017,5,3,Wednseday
1,2,25,27,2018,3,15,Thursday
2,14,17,31,2018,2,6,Tuesday
3,11,9,20,2017,11,24,Friday
2,24,-1,23,2018,3,3,Saturday
6,15,9,24,2018,2,13,Tuesday
2,9,13,22,2017,7,3,Monday
3,17,12,29,2018,5,6,Sunday
6,8,8,16,2018,1,3,Wednseday
4,8,18,26,2017,11,12,Sunday
1,6,10,16,2017,12,5,Tuesday
3,13,14,27,2018,2,2,Friday
3,4,25,29,2017,5,23,Tuesday
5,28,-3,25,2018,3,8,Thursday
2,12,23,35,2018,1,10,Wednseday
1,23,6,29,2018,2,5,Monday
1,13,15,28,2018,1,4,Thursday
0,21,-7,14,2018,7,25,Wednseday
1,7,20,27,2018,4,26,Thursday
8,16,21,37,2018,7,16,Monday
11,19,0,19,2018,8,5,Sunday
1,32,-5,27,2017,11,24,Friday
1,3,12,15,2018,1,23,Tuesday
0,4,9,13,2017,6,22,Thursday
1,9,13,22,2018,7,4,Wednseday
17,26,-4,22,2018,2,25,Sunday
2,45,-11,34,2017,9,19,Tuesday
5,6,3,9,2018,5,16,Wednseday
3,5,23,28,2018,4,13,Friday
7,19,0,19,2018,5,2,Wednseday
3,6,19,25,2017,3,31,Friday
1,6,2,8,2018,8,14,Tuesday
1,27,-1,26,2018,4,26,Thursday
1,19,6,25,2018,2,1,Thursday
1,17,33,50,2018,5,27,Sunday
3,4,6,10,2018,7,29,Sunday
7,16,13,29,2017,7,19,Wednseday
2,14,11,25,2018,1,15,Monday
1,2,8,10,2018,3,19,Monday
5,11,13,24,2018,2,9,Friday
7,8,3,11,2017,7,24,Monday
0,1,2,3,2018,8,13,Monday
1,5,10,15,2018,1,24,Wednseday
4,7,13,20,2018,7,26,Thursday
4,17,14,31,2017,2,17,Friday
3,11,8,19,2018,3,23,Friday
2,8,14,22,2018,1,16,Tuesday
12,17,0,17,2017,11,24,Friday
2,2,9,11,2017,7,24,Monday
1,12,11,23,2018,6,27,Wednseday
1,8,20,28,2018,8,16,Thursday
14,29,-5,24,2017,5,1,Monday
1,11,30,41,2017,1,19,Thursday
10,11,1,12,2018,8,19,Sunday
0,1,2,3,2018,8,6,Monday
2,4,17,21,2018,4,2,Monday
2,11,0,11,2017,10,9,Monday
2,13,7,20,2018,7,14,Saturday
0,19,22,41,2018,5,9,Wednseday
4,6,7,13,2017,6,22,Thursday
1,14,10,24,2018,2,6,Tuesday
1,2,11,13,2018,7,4,Wednseday
0,8,28,36,2017,12,14,Thursday
2,8,21,29,2018,7,2,Monday
4,11,18,29,2018,1,21,Sunday
7,14,22,36,2018,8,7,Tuesday
4,11,9,20,2018,7,20,Friday
1,3,8,11,2018,3,4,Sunday
2,5,13,18,2018,7,21,Saturday
1,6,11,17,2017,9,12,Tuesday
2,7,30,37,2018,7,23,Monday
2,5,16,21,2017,5,31,Wednseday
5,19,13,32,2017,12,22,Friday
1,27,7,34,2018,3,27,Tuesday
2,13,13,26,2017,10,1,Sunday
2,7,15,22,2017,9,11,Monday
0,6,22,28,2017,5,16,Tuesday
2,34,2,36,2018,5,30,Wednseday
2,8,24,32,2018,7,22,Sunday
6,40,-17,23,2018,3,4,Sunday
1,11,20,31,2017,6,5,Monday
4,39,-7,32,2018,1,13,Saturday
6,7,5,12,2018,4,5,Thursday
0,7,15,22,2018,4,30,Monday
1,8,11,19,2017,10,26,Thursday
3,10,19,29,2017,6,13,Tuesday
2,7,13,20,2018,5,15,Tuesday
1,9,14,23,2017,7,2,Sunday
3,15,17,32,2017,9,24,Sunday
4,15,7,22,2017,5,1,Monday
1,6,11,17,2018,8,24,Friday
4,7,12,19,2018,5,11,Friday
3,12,21,33,2018,6,23,Saturday
1,3,20,23,2018,6,11,Monday
2,15,10,25,2017,9,18,Monday
2,7,16,23,2018,4,16,Monday
1,33,-3,30,2017,12,5,Tuesday
1,2,6,8,2018,8,28,Tuesday
2,12,10,22,2017,5,17,Wednseday
1,9,15,24,2018,7,2,Monday
6,10,2,12,2018,3,9,Friday
1,13,14,27,2017,12,21,Thursday
3,7,10,17,2018,5,11,Friday
3,8,6,14,2018,2,12,Monday
1,15,14,29,2017,10,19,Thursday
3,7,17,24,2018,6,26,Tuesday
3,16,11,27,2018,8,14,Tuesday
3,13,9,22,2017,5,23,Tuesday
1,7,15,22,2018,1,16,Tuesday
4,10,17,27,2018,3,30,Friday
2,21,6,27,2017,11,25,Saturday
1,11,11,22,2017,7,6,Thursday
1,7,15,22,2018,4,16,Monday
0,1,8,9,2018,7,31,Tuesday
0,26,15,41,2018,1,10,Wednseday
2,16,15,31,2017,12,5,Tuesday
0,7,18,25,2018,5,25,Friday
3,22,8,30,2018,4,17,Tuesday
4,12,15,27,2018,2,16,Friday
1,2,6,8,2018,7,23,Monday
1,6,9,15,2018,8,9,Thursday
1,7,10,17,2018,6,11,Monday
2,5,21,26,2017,10,14,Saturday
2,17,5,22,2017,11,21,Tuesday
2,7,5,12,2018,8,22,Wednseday
2,14,6,20,2018,2,14,Wednseday
1,6,18,24,2018,1,2,Tuesday
1,8,21,29,2017,12,11,Monday
2,11,12,23,2018,3,25,Sunday
8,8,13,21,2018,4,12,Thursday
7,10,10,20,2017,11,10,Friday
0,2,25,27,2018,2,6,Tuesday
4,36,-4,32,2017,12,1,Friday
1,2,7,9,2018,5,16,Wednseday
2,7,16,23,2018,6,27,Wednseday
2,8,18,26,2017,5,21,Sunday
2,10,5,15,2018,8,5,Sunday
2,13,18,31,2017,11,25,Saturday
1,14,6,20,2018,4,26,Thursday
4,43,-16,27,2018,3,6,Tuesday
4,22,5,27,2018,2,27,Tuesday
3,40,-14,26,2018,3,3,Saturday
1,7,20,27,2018,2,13,Tuesday
1,15,13,28,2018,4,23,Monday
0,22,18,40,2017,4,26,Wednseday
1,3,4,7,2018,8,20,Monday
1,2,13,15,2018,6,27,Wednseday
2,15,25,40,2018,8,8,Wednseday
1,6,20,26,2017,11,30,Thursday
1,35,19,54,2018,5,25,Friday
12,19,24,43,2018,5,30,Wednseday
8,40,-14,26,2018,5,11,Friday
2,9,14,23,2018,1,24,Wednseday
1,5,9,14,2017,11,23,Thursday
2,7,14,21,2018,8,22,Wednseday
3,12,12,24,2018,7,21,Saturday
3,10,12,22,2017,11,13,Monday
3,7,14,21,2017,8,21,Monday
2,4,19,23,2017,4,1,Saturday
5,15,16,31,2018,5,20,Sunday
1,12,14,26,2018,4,22,Sunday
2,17,5,22,2017,6,27,Tuesday
6,12,12,24,2017,9,29,Friday
1,12,17,29,2018,4,11,Wednseday
7,43,-8,35,2017,12,11,Monday
0,4,7,11,2018,8,17,Friday
0,8,14,22,2017,8,7,Monday
3,13,10,23,2017,11,14,Tuesday
0,5,18,23,2018,7,4,Wednseday
1,8,14,22,2017,5,8,Monday
0,13,12,25,2018,2,22,Thursday
6,8,10,18,2017,9,28,Thursday
4,11,12,23,2017,10,2,Monday
2,9,15,24,2018,8,4,Saturday
15,29,-7,22,2018,4,15,Sunday
3,6,25,31,2018,5,11,Friday
2,9,20,29,2017,5,30,Tuesday
0,1,14,15,2017,8,17,Thursday
5,11,16,27,2017,12,28,Thursday
2,6,20,26,2017,12,17,Sunday
1,20,-7,13,2017,7,11,Tuesday
3,10,23,33,2018,6,16,Saturday
1,7,14,21,2018,3,1,Thursday
1,13,20,33,2018,6,28,Thursday
1,8,23,31,2017,12,12,Tuesday
1,20,21,41,2017,12,6,Wednseday
6,7,7,14,2018,4,26,Thursday
1,4,10,14,2018,2,22,Thursday
1,7,6,13,2018,8,21,Tuesday
3,10,20,30,2018,4,21,Saturday
5,7,6,13,2018,3,28,Wednseday
5,12,13,25,2018,8,2,Thursday
0,4,6,10,2018,8,13,Monday
8,12,4,16,2017,9,13,Wednseday
1,2,10,12,2017,5,28,Sunday
4,6,13,19,2018,1,4,Thursday
0,18,19,37,2018,5,28,Monday
3,8,6,14,2017,11,14,Tuesday
1,12,18,30,2018,6,13,Wednseday
3,8,13,21,2018,7,2,Monday
4,12,27,39,2017,5,25,Thursday
1,2,22,24,2018,5,8,Tuesday
2,19,-1,18,2018,3,18,Sunday
2,12,20,32,2017,4,22,Saturday
4,8,32,40,2017,5,28,Sunday
1,5,0,5,2018,8,16,Thursday
3,41,-18,23,2018,2,24,Saturday
1,6,19,25,2018,7,1,Sunday
4,9,12,21,2017,10,23,Monday
0,16,15,31,2018,2,6,Tuesday
1,8,15,23,2017,5,8,Monday
4,10,9,19,2017,3,11,Saturday
2,19,14,33,2018,1,31,Wednseday
2,22,14,36,2018,1,29,Monday
1,12,14,26,2017,11,2,Thursday
1,26,-6,20,2018,3,8,Thursday
2,10,12,22,2017,11,26,Sunday
4,11,12,23,2017,10,14,Saturday
15,22,14,36,2018,5,30,Wednseday
3,15,6,21,2017,11,27,Monday
0,12,24,36,2017,7,17,Monday
1,16,8,24,2018,1,15,Monday
1,10,25,35,2018,7,2,Monday
2,11,7,18,2017,9,11,Monday
1,7,14,21,2018,6,26,Tuesday
3,4,8,12,2017,9,15,Friday
2,5,11,16,2018,7,22,Sunday
1,4,16,20,2017,8,3,Thursday
2,11,15,26,2017,8,26,Saturday
1,8,18,26,2018,1,4,Thursday
7,13,22,35,2017,5,17,Wednseday
1,6,44,50,2017,1,31,Tuesday
1,8,13,21,2018,7,26,Thursday
7,18,-1,17,2018,8,3,Friday
3,9,12,21,2018,4,16,Monday
5,22,15,37,2018,1,10,Wednseday
1,6,13,19,2017,4,26,Wednseday
1,25,29,54,2018,1,11,Thursday
1,8,21,29,2018,1,9,Tuesday
1,4,18,22,2017,5,29,Monday
0,4,14,18,2018,5,24,Thursday
21,34,10,44,2017,12,20,Wednseday
1,4,12,16,2018,8,12,Sunday
2,13,17,30,2018,6,5,Tuesday
4,7,26,33,2018,3,8,Thursday
1,11,10,21,2017,3,6,Monday
14,21,3,24,2017,11,28,Tuesday
3,26,7,33,2017,12,1,Friday
3,25,-1,24,2018,3,2,Friday
1,8,17,25,2018,1,4,Thursday
2,11,22,33,2018,6,10,Sunday
4,10,22,32,2018,7,13,Friday
1,5,16,21,2018,5,16,Wednseday
2,5,11,16,2018,1,17,Wednseday
4,32,10,42,2018,3,9,Friday
6,19,7,26,2018,1,10,Wednseday
2,11,0,11,2017,8,28,Monday
7,11,3,14,2017,11,24,Friday
5,30,8,38,2018,1,27,Saturday
8,40,-14,26,2017,11,16,Thursday
1,2,9,11,2018,6,24,Sunday
2,3,13,16,2018,1,21,Sunday
1,13,4,17,2018,3,6,Tuesday
4,11,14,25,2017,4,7,Friday
4,22,0,22,2018,3,1,Thursday
6,17,14,31,2017,11,3,Friday
2,7,21,28,2017,9,26,Tuesday
1,7,16,23,2017,8,30,Wednseday
2,11,15,26,2017,2,5,Sunday
6,10,9,19,2018,4,28,Saturday
5,10,18,28,2018,6,15,Friday
3,5,7,12,2018,3,31,Saturday
2,3,14,17,2018,7,2,Monday
1,7,13,20,2018,3,21,Wednseday
1,6,21,27,2018,7,3,Tuesday
1,10,15,25,2018,2,26,Monday
1,27,-1,26,2017,5,11,Thursday
1,10,9,19,2018,7,15,Sunday
4,10,16,26,2017,4,28,Friday
1,7,9,16,2017,10,31,Tuesday
1,19,0,19,2018,3,7,Wednseday
6,8,11,19,2017,10,12,Thursday
4,5,14,19,2018,3,24,Saturday
3,19,5,24,2018,2,11,Sunday
5,14,13,27,2017,10,25,Wednseday
3,17,18,35,2017,10,2,Monday
1,5,34,39,2017,9,28,Thursday
1,4,14,18,2017,5,25,Thursday
4,8,14,22,2018,6,11,Monday
5,9,17,26,2017,7,19,Wednseday
1,5,15,20,2017,8,10,Thursday
2,10,13,23,2017,6,12,Monday
11,19,15,34,2018,1,6,Saturday
8,36,-12,24,2018,5,11,Friday
6,23,4,27,2018,1,30,Tuesday
1,5,16,21,2017,6,1,Thursday
1,7,9,16,2018,8,13,Monday
1,13,3,16,2018,4,2,Monday
5,6,-1,5,2018,8,9,Thursday
1,4,14,18,2017,3,19,Sunday
4,16,10,26,2017,4,2,Sunday
1,6,10,16,2018,3,6,Tuesday
3,8,31,39,2018,6,22,Friday
4,20,-6,14,2017,11,24,Friday
2,8,15,23,2018,3,11,Sunday
1,16,19,35,2017,5,29,Monday
1,6,21,27,2018,5,8,Tuesday
4,25,4,29,2018,2,15,Thursday
1,3,4,7,2018,8,13,Monday
1,4,1,5,2018,8,2,Thursday
1,2,8,10,2017,9,12,Tuesday
1,4,25,29,2018,6,18,Monday
8,16,20,36,2018,2,8,Thursday
4,13,13,26,2018,5,11,Friday
6,23,-1,22,2018,3,4,Sunday
0,18,13,31,2017,12,26,Tuesday
6,10,18,28,2017,3,7,Tuesday
1,5,10,15,2018,5,2,Wednseday
0,7,20,27,2018,1,11,Thursday
3,13,22,35,2017,10,17,Tuesday
2,11,19,30,2017,8,26,Saturday
3,6,13,19,2018,7,6,Friday
1,8,7,15,2018,6,26,Tuesday
3,12,21,33,2017,2,17,Friday
1,11,16,27,2018,8,7,Tuesday
1,5,19,24,2018,3,23,Friday
3,4,13,17,2017,7,21,Friday
3,15,19,34,2017,11,24,Friday
0,7,18,25,2017,8,18,Friday
2,3,5,8,2018,7,29,Sunday
4,25,7,32,2017,9,23,Saturday
2,31,11,42,2018,5,30,Wednseday
3,9,17,26,2018,1,20,Saturday
3,13,8,21,2018,6,8,Friday
20,26,-6,20,2018,7,13,Friday
19,20,8,28,2017,11,24,Friday
1,6,15,21,2017,3,21,Tuesday
2,11,20,31,2018,2,3,Saturday
7,29,6,35,2018,2,28,Wednseday
6,10,7,17,2018,8,17,Friday
4,14,34,48,2018,5,31,Thursday
2,42,-14,28,2018,4,18,Wednseday
2,4,18,22,2017,8,20,Sunday
1,21,0,21,2017,3,15,Wednseday
3,7,23,30,2018,6,4,Monday
4,9,14,23,2017,4,3,Monday
2,4,9,13,2018,3,24,Saturday
5,13,9,22,2017,11,30,Thursday
4,9,8,17,2017,12,11,Monday
2,3,10,13,2017,8,29,Tuesday
2,7,16,23,2017,11,6,Monday
2,9,29,38,2018,5,1,Tuesday
4,14,24,38,2017,12,23,Saturday
2,11,8,19,2018,3,10,Saturday
1,9,9,18,2017,9,4,Monday
1,4,8,12,2018,3,1,Thursday
2,9,38,47,2018,6,3,Sunday
1,36,-1,35,2017,12,7,Thursday
11,18,10,28,2018,7,27,Friday
7,19,6,25,2017,8,4,Friday
0,8,15,23,2018,4,25,Wednseday
2,8,19,27,2018,6,6,Wednseday
2,30,-8,22,2018,2,25,Sunday
4,20,5,25,2018,7,14,Saturday
5,8,14,22,2017,10,18,Wednseday
16,16,16,32,2017,4,27,Thursday
9,15,5,20,2017,7,18,Tuesday
3,41,-8,33,2018,2,4,Sunday
0,4,20,24,2017,12,26,Tuesday
6,20,2,22,2017,4,19,Wednseday
3,18,13,31,2018,1,8,Monday
7,12,8,20,2017,7,5,Wednseday
0,13,8,21,2017,6,6,Tuesday
3,14,4,18,2018,2,19,Monday
5,21,14,35,2017,12,8,Friday
2,8,17,25,2017,7,23,Sunday
5,6,8,14,2018,2,21,Wednseday
0,11,21,32,2017,3,16,Thursday
2,15,6,21,2018,3,13,Tuesday
2,8,4,12,2018,8,8,Wednseday
1,9,12,21,2018,2,15,Thursday
1,5,1,6,2018,8,1,Wednseday
6,15,13,28,2017,8,1,Tuesday
7,16,-3,13,2017,7,12,Wednseday
2,17,27,44,2018,6,4,Monday
1,30,2,32,2018,2,4,Sunday
3,7,10,17,2017,3,6,Monday
10,12,8,20,2018,3,23,Friday
0,14,6,20,2017,5,12,Friday
0,17,4,21,2017,11,24,Friday
4,11,12,23,2018,2,18,Sunday
1,5,14,19,2018,4,19,Thursday
2,12,19,31,2017,12,3,Sunday
1,6,14,20,2018,4,18,Wednseday
18,25,-4,21,2017,4,7,Friday
2,19,8,27,2017,12,20,Wednseday
6,54,-34,20,2018,2,28,Wednseday
3,10,15,25,2017,2,4,Saturday
4,33,0,33,2017,11,24,Friday
3,6,41,47,2017,1,27,Friday
1,8,12,20,2018,2,22,Thursday
3,4,8,12,2017,7,2,Sunday
3,12,12,24,2018,3,24,Saturday
0,3,28,31,2017,1,17,Tuesday
1,3,17,20,2017,12,13,Wednseday
1,7,6,13,2018,8,8,Wednseday
1,7,15,22,2017,10,3,Tuesday
0,6,24,30,2017,11,14,Tuesday
4,26,5,31,2018,2,25,Sunday
2,10,10,20,2018,5,1,Tuesday
14,16,-2,14,2017,11,28,Tuesday
0,13,8,21,2018,3,8,Thursday
2,36,-13,23,2018,3,6,Tuesday
7,18,14,32,2017,3,16,Thursday
4,10,14,24,2017,11,24,Friday
2,24,6,30,2017,12,10,Sunday
6,9,27,36,2018,1,17,Wednseday
1,16,14,30,2018,1,9,Tuesday
16,17,11,28,2018,4,10,Tuesday
1,4,6,10,2018,8,26,Sunday
3,17,9,26,2018,3,17,Saturday
3,10,10,20,2018,7,14,Saturday
1,14,12,26,2017,11,16,Thursday
1,4,8,12,2018,8,5,Sunday
1,13,16,29,2017,9,21,Thursday
3,4,16,20,2017,12,15,Friday
4,18,10,28,2017,10,6,Friday
4,16,20,36,2018,2,12,Monday
1,20,15,35,2017,6,13,Tuesday
7,13,16,29,2018,8,2,Thursday
2,22,7,29,2018,1,17,Wednseday
4,13,13,26,2017,11,3,Friday
0,4,10,14,2018,8,6,Monday
1,5,25,30,2018,7,1,Sunday
2,7,10,17,2018,7,16,Monday
49,57,-24,33,2018,1,31,Wednseday
2,7,6,13,2018,8,14,Tuesday
4,19,13,32,2017,4,14,Friday
1,9,21,30,2017,9,26,Tuesday
7,21,2,23,2017,5,29,Monday
5,18,11,29,2018,3,15,Thursday
9,14,22,36,2018,6,6,Wednseday
2,7,29,36,2018,6,6,Wednseday
7,12,13,25,2018,7,26,Thursday
1,7,9,16,2018,7,16,Monday
4,25,4,29,2018,1,28,Sunday
2,16,10,26,2018,6,16,Saturday
3,38,-17,21,2018,2,27,Tuesday
21,29,8,37,2018,2,28,Wednseday
0,4,17,21,2018,6,14,Thursday
2,3,5,8,2018,5,8,Tuesday
4,18,16,34,2017,11,24,Friday
4,14,11,25,2017,5,12,Friday
4,11,13,24,2018,3,9,Friday
1,8,16,24,2017,9,10,Sunday
0,9,12,21,2017,3,21,Tuesday
1,2,29,31,2018,8,14,Tuesday
4,18,10,28,2018,1,8,Monday
6,17,8,25,2018,4,28,Saturday
5,6,11,17,2017,9,22,Friday
10,18,20,38,2018,6,26,Tuesday
4,6,10,16,2017,11,25,Saturday
0,32,3,35,2017,8,15,Tuesday
3,5,8,13,2018,8,10,Friday
3,19,9,28,2017,9,22,Friday
2,9,14,23,2017,5,24,Wednseday
1,11,21,32,2017,10,5,Thursday
1,9,27,36,2017,5,17,Wednseday
1,6,16,22,2018,6,12,Tuesday
3,18,9,27,2017,8,25,Friday
2,24,23,47,2017,12,13,Wednseday
1,7,19,26,2017,7,12,Wednseday
1,7,23,30,2018,1,31,Wednseday
0,2,15,17,2018,6,25,Monday
3,6,4,10,2018,7,27,Friday
1,10,21,31,2017,12,11,Monday
1,15,4,19,2017,11,22,Wednseday
3,19,12,31,2018,4,20,Friday
3,11,8,19,2017,3,18,Saturday
1,9,19,28,2017,10,30,Monday
2,12,4,16,2018,1,3,Wednseday
4,10,4,14,2018,2,12,Monday
3,4,14,18,2017,12,18,Monday
5,11,25,36,2018,5,3,Thursday
6,15,3,18,2017,11,23,Thursday
2,8,8,16,2018,5,22,Tuesday
4,11,17,28,2018,2,23,Friday
2,6,18,24,2018,7,7,Saturday
1,10,17,27,2018,1,10,Wednseday
3,9,16,25,2017,9,9,Saturday
1,7,5,12,2018,3,8,Thursday
0,7,9,16,2018,1,8,Monday
9,13,11,24,2018,7,15,Sunday
4,13,14,27,2018,4,5,Thursday
2,11,23,34,2017,7,22,Saturday
4,11,27,38,2017,11,4,Saturday
4,14,10,24,2018,5,18,Friday
2,16,6,22,2018,5,20,Sunday
2,8,12,20,2018,7,31,Tuesday
3,6,8,14,2017,11,24,Friday
4,5,13,18,2018,4,12,Thursday
1,2,12,14,2018,2,20,Tuesday
0,6,27,33,2017,4,13,Thursday
0,4,11,15,2018,4,26,Thursday
3,36,-7,29,2017,12,25,Monday
5,12,8,20,2017,9,1,Friday
1,6,12,18,2018,8,16,Thursday
1,5,23,28,2017,7,27,Thursday
1,14,12,26,2017,12,13,Wednseday
4,5,6,11,2018,7,20,Friday
2,4,6,10,2018,4,2,Monday
2,9,8,17,2017,10,9,Monday
2,19,6,25,2018,1,27,Saturday
1,7,2,9,2018,8,14,Tuesday
4,7,46,53,2016,10,7,Friday
2,5,12,17,2018,5,12,Saturday
15,24,17,41,2018,3,20,Tuesday
1,10,7,17,2017,11,20,Monday
1,7,15,22,2017,5,22,Monday
0,10,20,30,2017,12,19,Tuesday
3,6,4,10,2018,8,4,Saturday
1,22,11,33,2018,3,1,Thursday
2,6,4,10,2018,8,14,Tuesday
1,7,18,25,2018,6,21,Thursday
2,6,11,17,2018,4,28,Saturday
2,9,12,21,2017,10,11,Wednseday
5,7,7,14,2017,6,9,Friday
4,10,16,26,2017,9,30,Saturday
3,17,11,28,2018,1,12,Friday
2,11,20,31,2017,10,21,Saturday
6,7,7,14,2018,6,29,Friday
1,16,19,35,2017,4,4,Tuesday
6,14,16,30,2017,5,17,Wednseday
1,13,23,36,2018,4,12,Thursday
2,4,12,16,2018,2,5,Monday
1,13,16,29,2017,9,27,Wednseday
6,28,-3,25,2018,3,9,Friday
4,7,3,10,2018,5,7,Monday
3,12,15,27,2017,12,8,Friday
1,13,13,26,2017,6,29,Thursday
1,8,3,11,2018,3,26,Monday
0,4,13,17,2018,8,17,Friday
1,9,24,33,2018,7,11,Wednseday
4,15,16,31,2017,11,26,Sunday
5,12,25,37,2018,6,6,Wednseday
1,2,9,11,2018,3,26,Monday
1,8,34,42,2018,6,7,Thursday
2,13,8,21,2017,3,14,Tuesday
11,15,7,22,2018,2,8,Thursday
1,5,16,21,2018,1,17,Wednseday
1,3,14,17,2018,4,6,Friday
2,15,7,22,2018,4,23,Monday
2,7,4,11,2017,8,7,Monday
3,11,18,29,2017,5,7,Sunday
1,5,11,16,2017,11,22,Wednseday
1,4,9,13,2018,7,26,Thursday
5,5,16,21,2017,9,22,Friday
3,26,0,26,2017,12,10,Sunday
2,3,13,16,2017,10,3,Tuesday
5,12,13,25,2018,5,3,Thursday
3,15,8,23,2018,1,8,Monday
0,1,13,14,2017,11,8,Wednseday
11,15,21,36,2018,6,10,Sunday
6,20,0,20,2018,4,5,Thursday
3,23,9,32,2018,2,18,Sunday
1,5,16,21,2018,1,10,Wednseday
2,7,16,23,2017,5,24,Wednseday
4,15,14,29,2017,8,21,Monday
1,2,11,13,2017,8,9,Wednseday
2,4,7,11,2018,8,25,Saturday
2,10,13,23,2017,6,19,Monday
1,6,-1,5,2018,8,23,Thursday
1,13,12,25,2017,7,13,Thursday
6,16,17,33,2017,12,27,Wednseday
2,11,12,23,2017,11,28,Tuesday
4,18,7,25,2017,11,17,Friday
1,6,9,15,2018,1,18,Thursday
2,31,-12,19,2018,3,3,Saturday
5,18,11,29,2018,1,18,Thursday
3,9,15,24,2017,10,10,Tuesday
2,9,9,18,2018,8,19,Sunday
4,12,21,33,2017,8,24,Thursday
5,8,12,20,2017,12,28,Thursday
3,9,17,26,2018,1,20,Saturday
4,9,14,23,2018,1,8,Monday
3,14,17,31,2017,11,3,Friday
2,7,13,20,2018,2,28,Wednseday
2,3,21,24,2017,12,10,Sunday
1,4,9,13,2018,3,27,Tuesday
0,8,19,27,2017,5,25,Thursday
4,11,15,26,2018,1,11,Thursday
3,12,19,31,2018,5,11,Friday
3,17,16,33,2017,6,9,Friday
4,5,15,20,2018,6,21,Thursday
2,17,8,25,2018,4,9,Monday
4,19,5,24,2018,3,24,Saturday
1,7,24,31,2018,7,3,Tuesday
4,12,13,25,2018,4,29,Sunday
3,29,-11,18,2018,3,5,Monday
1,8,9,17,2017,10,17,Tuesday
1,8,26,34,2018,6,20,Wednseday
1,13,4,17,2017,9,19,Tuesday
1,4,21,25,2018,7,26,Thursday
1,9,32,41,2017,2,7,Tuesday
6,17,17,34,2017,11,24,Friday
6,11,9,20,2018,3,22,Thursday
1,16,27,43,2018,2,6,Tuesday
10,38,-8,30,2018,7,3,Tuesday
2,10,21,31,2018,6,11,Monday
0,21,7,28,2018,2,27,Tuesday
2,7,14,21,2018,2,28,Wednseday
0,4,23,27,2018,6,7,Thursday
3,10,4,14,2018,8,14,Tuesday
11,25,7,32,2018,4,15,Sunday
6,10,24,34,2017,9,2,Saturday
2,13,19,32,2018,4,5,Thursday
1,14,4,18,2018,1,4,Thursday
1,23,1,24,2018,2,27,Tuesday
2,5,8,13,2018,4,4,Wednseday
7,12,17,29,2018,8,16,Thursday
5,9,5,14,2017,11,22,Wednseday
2,10,8,18,2017,3,19,Sunday
4,6,20,26,2018,4,19,Thursday
2,3,11,14,2017,11,7,Tuesday
1,9,20,29,2018,6,17,Sunday
1,14,12,26,2018,1,10,Wednseday
1,42,-22,20,2017,6,21,Wednseday
3,7,17,24,2018,2,24,Saturday
3,17,9,26,2017,8,5,Saturday
1,8,15,23,2017,9,11,Monday
2,21,14,35,2018,4,18,Wednseday
13,41,1,42,2018,2,6,Tuesday
4,27,-4,23,2017,11,27,Monday
4,9,18,27,2018,7,21,Saturday
10,25,11,36,2017,12,11,Monday
2,9,8,17,2017,11,20,Monday
2,6,7,13,2018,2,13,Tuesday
0,6,14,20,2018,3,27,Tuesday
3,7,40,47,2018,8,17,Friday
1,10,17,27,2017,6,9,Friday
4,17,4,21,2017,11,24,Friday
5,7,7,14,2017,11,24,Friday
4,11,10,21,2018,3,30,Friday
1,15,15,30,2018,3,26,Monday
6,9,20,29,2018,1,31,Wednseday
4,7,10,17,2017,9,22,Friday
5,7,13,20,2017,12,29,Friday
3,8,3,11,2018,7,30,Monday
4,14,9,23,2017,11,27,Monday
1,7,23,30,2017,12,12,Tuesday
2,14,8,22,2017,5,15,Monday
4,12,9,21,2017,11,13,Monday
4,9,16,25,2017,11,26,Sunday
1,2,10,12,2018,3,25,Sunday
3,10,21,31,2017,5,27,Saturday
1,14,10,24,2017,9,4,Monday
0,3,21,24,2018,6,22,Friday
4,8,22,30,2018,2,12,Monday
1,7,18,25,2017,5,29,Monday
8,19,8,27,2017,8,16,Wednseday
1,3,12,15,2017,9,5,Tuesday
2,3,12,15,2018,2,27,Tuesday
3,9,14,23,2017,8,7,Monday
3,7,10,17,2017,10,17,Tuesday
15,16,-1,15,2018,8,14,Tuesday
2,3,10,13,2018,2,28,Wednseday
5,10,8,18,2017,5,14,Sunday
1,20,23,43,2017,3,29,Wednseday
2,8,28,36,2017,10,24,Tuesday
2,41,-8,33,2018,2,28,Wednseday
3,21,10,31,2018,2,3,Saturday
4,9,6,15,2017,11,12,Sunday
0,17,1,18,2017,10,23,Monday
0,10,8,18,2018,4,30,Monday
4,8,13,21,2018,2,22,Thursday
8,14,17,31,2017,6,26,Monday
6,10,2,12,2018,3,17,Saturday
3,12,20,32,2017,3,24,Friday
3,8,14,22,2018,6,26,Tuesday
5,12,12,24,2017,7,7,Friday
3,9,3,12,2018,8,4,Saturday
20,24,20,44,2018,4,18,Wednseday
0,7,18,25,2017,8,10,Thursday
3,7,21,28,2018,7,6,Friday
1,2,8,10,2018,4,3,Tuesday
1,7,0,7,2018,8,2,Thursday
2,17,7,24,2017,11,5,Sunday
2,8,27,35,2018,5,8,Tuesday
1,6,23,29,2017,7,16,Sunday
1,4,27,31,2018,1,15,Monday
5,9,8,17,2017,12,3,Sunday
2,7,12,19,2018,3,14,Wednseday
0,2,14,16,2018,3,5,Monday
4,10,15,25,2018,4,13,Friday
0,3,7,10,2018,8,7,Tuesday
3,20,11,31,2017,5,5,Friday
0,1,11,12,2018,3,14,Wednseday
2,13,9,22,2017,7,12,Wednseday
5,10,27,37,2018,4,28,Saturday
1,4,10,14,2018,6,28,Thursday
2,28,14,42,2018,2,28,Wednseday
3,5,15,20,2017,12,15,Friday
1,9,17,26,2017,12,17,Sunday
4,11,17,28,2018,1,25,Thursday
0,11,25,36,2018,6,28,Thursday
3,8,6,14,2018,8,20,Monday
1,10,12,22,2017,8,30,Wednseday
4,7,26,33,2018,3,9,Friday
14,19,1,20,2017,11,23,Thursday
0,7,20,27,2018,1,25,Thursday
1,69,-46,23,2018,2,21,Wednseday
1,22,5,27,2018,1,25,Thursday
2,5,7,12,2018,3,3,Saturday
1,3,11,14,2018,2,20,Tuesday
2,14,29,43,2018,1,3,Wednseday
5,16,3,19,2017,10,29,Sunday
3,11,14,25,2017,12,3,Sunday
5,19,4,23,2018,1,28,Sunday
3,6,13,19,2018,6,9,Saturday
3,8,29,37,2018,6,5,Tuesday
7,44,-21,23,2018,2,17,Saturday
1,6,6,12,2018,3,2,Friday
1,13,1,14,2018,1,9,Tuesday
3,9,14,23,2017,6,10,Saturday
2,12,18,30,2017,10,28,Saturday
1,6,19,25,2018,7,26,Thursday
3,9,23,32,2017,6,4,Sunday
5,8,10,18,2018,2,19,Monday
11,29,-8,21,2018,5,7,Monday
1,10,19,29,2017,2,20,Monday
1,14,19,33,2017,12,21,Thursday
2,9,15,24,2017,6,19,Monday
1,3,26,29,2018,6,12,Tuesday
4,42,-3,39,2017,12,23,Saturday
4,19,8,27,2017,11,24,Friday
2,10,21,31,2018,6,18,Monday
5,13,27,40,2018,6,1,Friday
1,6,15,21,2018,4,5,Thursday
0,18,13,31,2017,11,3,Friday
2,17,18,35,2018,5,8,Tuesday
7,15,-3,12,2018,3,1,Thursday
4,9,7,16,2017,11,25,Saturday
1,8,8,16,2018,7,16,Monday
2,12,10,22,2017,7,12,Wednseday
2,13,7,20,2017,11,28,Tuesday
2,18,9,27,2017,11,14,Tuesday
2,7,22,29,2018,6,27,Wednseday
1,6,8,14,2018,8,7,Tuesday
2,30,3,33,2018,1,27,Saturday
1,6,16,22,2018,8,2,Thursday
2,14,14,28,2017,9,13,Wednseday
3,5,6,11,2018,7,8,Sunday
1,13,20,33,2017,6,28,Wednseday
1,2,27,29,2018,5,28,Monday
5,13,14,27,2017,2,4,Saturday
1,6,8,14,2017,10,31,Tuesday
2,44,-22,22,2018,2,27,Tuesday
5,12,13,25,2017,7,22,Saturday
2,16,12,28,2018,1,17,Wednseday
1,9,13,22,2018,7,16,Monday
1,13,18,31,2018,4,15,Sunday
2,10,11,21,2017,9,13,Wednseday
2,10,15,25,2018,5,12,Saturday
1,7,18,25,2018,4,26,Thursday
2,9,15,24,2017,7,15,Saturday
1,9,12,21,2017,11,13,Monday
3,18,0,18,2018,5,20,Sunday
1,7,16,23,2018,7,9,Monday
1,7,10,17,2018,5,7,Monday
5,12,1,13,2018,8,16,Thursday
1,7,20,27,2017,10,25,Wednseday
1,12,13,25,2017,11,24,Friday
4,12,13,25,2018,1,25,Thursday
5,15,14,29,2018,1,8,Monday
2,4,14,18,2017,11,6,Monday
3,5,21,26,2018,7,7,Saturday
2,7,15,22,2018,5,2,Wednseday
19,26,14,40,2018,8,1,Wednseday
1,23,0,23,2017,3,26,Sunday
5,46,-12,34,2017,3,16,Thursday
0,6,24,30,2018,1,17,Wednseday
4,12,19,31,2018,2,3,Saturday
2,39,-9,30,2018,2,12,Monday
1,7,14,21,2017,5,11,Thursday
1,26,1,27,2017,11,23,Thursday
2,8,15,23,2017,11,12,Sunday
4,11,22,33,2017,4,6,Thursday
4,10,9,19,2018,8,18,Saturday
22,23,11,34,2017,12,21,Thursday
2,5,14,19,2018,4,28,Saturday
2,14,33,47,2017,2,1,Wednseday
3,11,13,24,2017,8,4,Friday
7,13,18,31,2018,1,16,Tuesday
4,13,27,40,2017,12,1,Friday
1,4,18,22,2017,9,25,Monday
1,4,22,26,2018,5,31,Thursday
0,9,19,28,2018,4,17,Tuesday
12,41,-18,23,2018,3,28,Wednseday
2,18,13,31,2017,5,6,Saturday
3,11,31,42,2018,3,2,Friday
0,17,15,32,2017,12,22,Friday
14,15,20,35,2018,2,5,Monday
1,4,25,29,2018,8,19,Sunday
1,7,16,23,2017,3,1,Wednseday
4,12,21,33,2017,10,7,Saturday
3,50,-12,38,2018,3,10,Saturday
1,23,7,30,2017,7,31,Monday
1,13,7,20,2017,11,28,Tuesday
6,8,16,24,2018,1,12,Friday
4,18,36,54,2017,9,15,Friday
5,23,2,25,2017,12,3,Sunday
3,14,7,21,2017,10,16,Monday
1,5,20,25,2018,2,1,Thursday
2,8,14,22,2018,2,8,Thursday
3,11,12,23,2018,6,30,Saturday
3,24,14,38,2017,4,8,Saturday
3,23,1,24,2017,8,12,Saturday
5,12,16,28,2017,11,24,Friday
16,18,36,54,2016,10,9,Sunday
1,2,6,8,2018,5,15,Tuesday
4,11,14,25,2018,4,14,Saturday
3,9,18,27,2018,6,30,Saturday
4,14,14,28,2018,4,19,Thursday
3,4,10,14,2017,11,13,Monday
3,10,17,27,2017,9,22,Friday
1,15,19,34,2018,4,19,Thursday
8,21,20,41,2018,1,4,Thursday
24,31,-7,24,2018,3,3,Saturday
4,12,20,32,2017,12,22,Friday
2,5,7,12,2018,3,10,Saturday
3,12,26,38,2017,12,23,Saturday
2,10,17,27,2018,2,17,Saturday
3,10,21,31,2017,7,30,Sunday
3,6,14,20,2017,6,30,Friday
2,13,9,22,2018,4,25,Wednseday
3,10,9,19,2018,8,11,Saturday
2,3,12,15,2018,7,1,Sunday
2,17,2,19,2018,4,1,Sunday
3,26,-1,25,2017,12,1,Friday
2,9,20,29,2018,3,26,Monday
2,8,1,9,2018,8,22,Wednseday
17,24,-2,22,2017,11,28,Tuesday
2,16,11,27,2017,5,2,Tuesday
3,26,-6,20,2017,8,11,Friday
5,10,14,24,2017,11,24,Friday
2,7,18,25,2018,1,8,Monday
3,5,9,14,2018,2,12,Monday
5,10,14,24,2018,1,26,Friday
5,53,-28,25,2018,2,22,Thursday
4,26,1,27,2018,2,23,Friday
3,7,10,17,2018,8,17,Friday
3,11,10,21,2018,5,11,Friday
4,35,-7,28,2017,8,31,Thursday
3,41,-14,27,2018,1,12,Friday
3,8,17,25,2018,7,2,Monday
1,7,30,37,2018,6,5,Tuesday
0,1,7,8,2018,7,25,Wednseday
1,14,15,29,2018,1,11,Thursday
1,21,3,24,2018,5,14,Monday
4,6,21,27,2017,5,27,Saturday
1,15,14,29,2018,2,18,Sunday
1,8,15,23,2018,7,2,Monday
3,14,6,20,2018,3,13,Tuesday
1,8,9,17,2018,1,7,Sunday
10,19,16,35,2017,4,7,Friday
4,10,14,24,2018,1,12,Friday
1,2,13,15,2018,4,3,Tuesday
3,7,4,11,2017,11,6,Monday
2,11,12,23,2018,5,28,Monday
5,14,17,31,2017,4,28,Friday
3,20,7,27,2017,11,25,Saturday
4,8,18,26,2018,6,28,Thursday
7,23,-1,22,2018,2,28,Wednseday
1,7,20,27,2018,1,9,Tuesday
1,3,12,15,2018,5,15,Tuesday
0,13,9,22,2017,6,27,Tuesday
2,9,5,14,2018,8,6,Monday
5,11,7,18,2017,9,10,Sunday
5,7,7,14,2018,3,21,Wednseday
3,7,8,15,2017,6,27,Tuesday
12,18,2,20,2017,11,24,Friday
1,3,15,18,2017,3,26,Sunday
2,4,19,23,2018,1,22,Monday
0,6,8,14,2018,5,11,Friday
13,43,-13,30,2017,10,25,Wednseday
3,20,7,27,2018,2,13,Tuesday
1,8,21,29,2017,3,26,Sunday
1,4,18,22,2017,11,5,Sunday
3,7,10,17,2018,4,30,Monday
2,19,10,29,2018,4,4,Wednseday
4,19,15,34,2017,12,1,Friday
5,13,9,22,2017,4,19,Wednseday
7,8,4,12,2017,9,14,Thursday
1,18,21,39,2017,2,20,Monday
7,15,13,28,2018,7,30,Monday
3,3,17,20,2018,1,6,Saturday
1,19,10,29,2017,12,12,Tuesday
1,7,22,29,2018,4,17,Tuesday
0,7,16,23,2017,9,6,Wednseday
0,4,2,6,2018,8,9,Thursday
1,3,34,37,2018,6,5,Tuesday
2,45,-24,21,2018,3,6,Tuesday
8,15,7,22,2017,7,11,Tuesday
1,9,13,22,2018,8,15,Wednseday
1,11,15,26,2017,11,16,Thursday
2,11,15,26,2018,4,8,Sunday
2,5,20,25,2017,8,14,Monday
5,10,18,28,2018,2,9,Friday
3,11,13,24,2018,7,15,Sunday
14,31,13,44,2018,2,12,Monday
4,9,9,18,2018,3,11,Sunday
3,10,9,19,2018,6,22,Friday
4,25,8,33,2017,3,10,Friday
2,14,8,22,2017,7,12,Wednseday
1,12,19,31,2018,1,1,Monday
0,3,10,13,2018,3,23,Friday
5,17,10,27,2017,11,24,Friday
2,12,12,24,2018,4,22,Sunday
2,25,-8,17,2018,4,2,Monday
1,10,16,26,2018,2,14,Wednseday
1,7,30,37,2017,2,6,Monday
4,9,16,25,2018,1,20,Saturday
0,20,12,32,2017,12,22,Friday
7,9,-3,6,2018,8,16,Thursday
4,13,13,26,2017,7,29,Saturday
1,4,15,19,2018,4,19,Thursday
1,10,-2,8,2018,7,23,Monday
1,6,16,22,2018,1,15,Monday
23,37,-7,30,2017,12,18,Monday
4,19,5,24,2017,4,28,Friday
2,12,10,22,2017,11,15,Wednseday
1,2,13,15,2018,5,6,Sunday
1,7,13,20,2018,4,5,Thursday
2,7,20,27,2018,1,20,Saturday
1,8,12,20,2017,6,28,Wednseday
2,3,10,13,2018,3,24,Saturday
3,10,13,23,2018,4,30,Monday
8,18,12,30,2017,5,21,Sunday
3,8,10,18,2018,8,17,Friday
4,10,5,15,2018,7,30,Monday
4,13,6,19,2018,3,16,Friday
0,3,3,6,2018,7,27,Friday
7,25,3,28,2017,3,13,Monday
2,28,-8,20,2018,3,17,Saturday
3,16,4,20,2018,4,7,Saturday
3,6,11,17,2018,8,24,Friday
1,3,19,22,2018,6,26,Tuesday
1,9,9,18,2017,10,22,Sunday
3,11,24,35,2017,8,25,Friday
1,4,1,5,2018,8,9,Thursday
2,7,18,25,2017,12,4,Monday
1,16,3,19,2018,5,23,Wednseday
10,16,43,59,2017,1,21,Saturday
0,2,15,17,2018,7,3,Tuesday
3,14,4,18,2017,7,17,Monday
1,4,6,10,2018,8,6,Monday
7,14,6,20,2018,2,22,Thursday
1,9,13,22,2018,4,1,Sunday
5,8,17,25,2017,9,21,Thursday
2,8,29,37,2017,1,22,Sunday
2,26,11,37,2017,4,10,Monday
1,20,7,27,2018,4,3,Tuesday
6,14,12,26,2018,4,12,Thursday
1,8,20,28,2018,3,21,Wednseday
2,10,19,29,2018,4,23,Monday
3,18,2,20,2017,11,25,Saturday
6,13,7,20,2017,9,7,Thursday
5,11,2,13,2018,3,23,Friday
1,12,28,40,2018,2,14,Wednseday
1,5,12,17,2017,12,3,Sunday
4,23,3,26,2017,11,25,Saturday
5,14,6,20,2018,1,10,Wednseday
13,22,12,34,2017,4,26,Wednseday
4,5,7,12,2018,7,8,Sunday
3,41,-7,34,2018,2,28,Wednseday
1,8,14,22,2017,10,23,Monday
1,7,19,26,2017,4,6,Thursday
4,7,13,20,2017,4,20,Thursday
2,20,3,23,2017,11,1,Wednseday
1,3,17,20,2017,10,18,Wednseday
5,12,19,31,2017,12,8,Friday
7,16,6,22,2017,7,13,Thursday
6,19,15,34,2017,11,7,Tuesday
1,4,11,15,2018,7,23,Monday
9,10,7,17,2018,7,3,Tuesday
2,16,3,19,2017,9,2,Saturday
3,11,16,27,2017,7,8,Saturday
3,23,1,24,2017,9,11,Monday
0,5,20,25,2018,6,28,Thursday
4,9,3,12,2017,9,9,Saturday
4,12,12,24,2017,6,30,Friday
1,9,13,22,2017,7,20,Thursday
2,6,20,26,2018,7,14,Saturday
1,61,-32,29,2018,2,15,Thursday
3,9,15,24,2017,10,23,Monday
3,7,13,20,2017,11,7,Tuesday
4,9,16,25,2018,4,19,Thursday
4,17,11,28,2017,7,7,Friday
6,12,16,28,2018,1,4,Thursday
2,9,14,23,2017,10,15,Sunday
11,25,9,34,2018,5,3,Thursday
4,13,26,39,2018,3,30,Friday
1,21,2,23,2018,3,18,Sunday
4,6,8,14,2017,11,24,Friday
0,5,4,9,2018,8,6,Monday
1,25,6,31,2018,4,8,Sunday
3,16,0,16,2018,4,2,Monday
1,7,5,12,2018,8,22,Wednseday
1,8,22,30,2018,4,16,Monday
7,15,2,17,2018,3,20,Tuesday
2,3,14,17,2018,5,27,Sunday
1,7,16,23,2018,8,8,Wednseday
2,8,11,19,2017,7,16,Sunday
3,7,19,26,2018,4,20,Friday
3,12,12,24,2018,3,30,Friday
1,2,12,14,2018,5,21,Monday
15,42,-13,29,2018,5,9,Wednseday
14,17,6,23,2017,8,7,Monday
4,19,10,29,2018,4,26,Thursday
1,15,14,29,2017,9,26,Tuesday
3,12,44,56,2017,10,20,Friday
4,13,16,29,2018,6,21,Thursday
2,9,18,27,2017,12,2,Saturday
2,8,14,22,2017,10,18,Wednseday
2,7,23,30,2018,6,20,Wednseday
2,2,18,20,2018,3,21,Wednseday
1,13,20,33,2017,3,9,Thursday
4,41,-15,26,2017,11,24,Friday
2,4,14,18,2017,7,30,Sunday
1,7,18,25,2017,8,3,Thursday
4,10,17,27,2017,4,1,Saturday
4,13,10,23,2017,8,26,Saturday
8,9,6,15,2018,6,13,Wednseday
2,9,18,27,2018,2,7,Wednseday
2,11,17,28,2017,8,14,Monday
4,17,17,34,2017,6,2,Friday
3,15,22,37,2017,5,22,Monday
1,9,14,23,2017,6,19,Monday
2,12,13,25,2017,8,6,Sunday
2,12,20,32,2018,6,23,Saturday
2,21,3,24,2018,4,3,Tuesday
2,3,15,18,2018,2,3,Saturday
1,10,17,27,2018,4,11,Wednseday
10,21,-1,20,2018,3,2,Friday
2,75,-56,19,2018,2,28,Wednseday
1,2,20,22,2017,3,28,Tuesday
2,8,17,25,2017,9,25,Monday
1,7,22,29,2018,4,19,Thursday
4,5,8,13,2018,7,20,Friday
1,11,15,26,2017,3,2,Thursday
1,14,13,27,2017,9,26,Tuesday
4,21,1,22,2017,11,30,Thursday
0,22,2,24,2018,3,5,Monday
4,5,13,18,2018,6,7,Thursday
2,6,17,23,2017,4,5,Wednseday
4,46,-13,33,2018,3,17,Saturday
1,8,12,20,2017,11,22,Wednseday
1,25,5,30,2018,1,10,Wednseday
5,15,17,32,2018,2,11,Sunday
1,100,-78,22,2017,8,1,Tuesday
2,20,4,24,2017,2,28,Tuesday
2,10,14,24,2017,10,3,Tuesday
3,16,8,24,2017,8,12,Saturday
3,4,8,12,2018,5,18,Friday
1,3,19,22,2018,4,23,Monday
1,15,9,24,2017,7,16,Sunday
7,21,1,22,2017,4,19,Wednseday
2,5,14,19,2018,1,10,Wednseday
1,8,12,20,2017,7,25,Tuesday
1,2,13,15,2017,11,26,Sunday
2,7,12,19,2017,9,6,Wednseday
2,14,12,26,2017,9,23,Saturday
5,12,0,12,2018,7,29,Sunday
10,17,12,29,2018,3,11,Sunday
3,31,1,32,2017,3,5,Sunday
1,3,8,11,2017,6,19,Monday
2,10,19,29,2017,8,23,Wednseday
2,13,18,31,2017,8,8,Tuesday
2,27,-1,26,2018,3,25,Sunday
2,12,32,44,2017,1,25,Wednseday
7,14,13,27,2017,6,15,Thursday
4,10,17,27,2018,1,26,Friday
1,2,11,13,2018,7,4,Wednseday
5,12,17,29,2017,11,23,Thursday
2,18,4,22,2017,8,7,Monday
3,20,13,33,2017,10,28,Saturday
2,6,18,24,2018,6,9,Saturday
2,16,18,34,2018,1,31,Wednseday
0,2,17,19,2018,4,19,Thursday
2,13,10,23,2017,4,26,Wednseday
2,16,17,33,2018,1,24,Wednseday
3,19,9,28,2018,4,13,Friday
4,12,13,25,2017,11,10,Friday
2,8,10,18,2017,11,19,Sunday
1,8,9,17,2018,5,8,Tuesday
2,5,19,24,2018,5,12,Saturday
1,6,11,17,2018,6,12,Tuesday
7,14,15,29,2017,8,22,Tuesday
5,13,6,19,2018,3,28,Wednseday
4,11,1,12,2018,8,3,Friday
1,2,13,15,2018,2,18,Sunday
15,21,20,41,2018,4,4,Wednseday
2,15,5,20,2018,7,11,Wednseday
3,28,-4,24,2017,11,25,Saturday
6,20,0,20,2018,3,29,Thursday
1,12,8,20,2018,2,28,Wednseday
4,10,14,24,2017,8,4,Friday
6,16,40,56,2017,2,7,Tuesday
2,9,13,22,2017,9,17,Sunday
4,7,24,31,2017,3,24,Friday
6,11,14,25,2017,3,2,Thursday
1,5,16,21,2018,2,21,Wednseday
3,24,6,30,2018,4,21,Saturday
3,11,7,18,2018,4,2,Monday
2,20,9,29,2018,5,22,Tuesday
1,25,9,34,2018,4,19,Thursday
0,6,15,21,2018,6,12,Tuesday
1,7,26,33,2018,3,16,Friday
0,7,8,15,2018,7,26,Thursday
5,18,4,22,2018,7,5,Thursday
4,12,22,34,2018,4,13,Friday
8,14,6,20,2017,11,8,Wednseday
1,2,7,9,2018,4,25,Wednseday
1,9,21,30,2017,7,18,Tuesday
2,9,28,37,2018,7,31,Tuesday
6,14,8,22,2017,4,19,Wednseday
2,16,9,25,2018,8,11,Saturday
3,43,-13,30,2017,11,28,Tuesday
3,6,20,26,2018,2,3,Saturday
1,14,14,28,2018,1,8,Monday
3,6,31,37,2018,5,12,Saturday
2,16,8,24,2017,12,11,Monday
1,9,20,29,2018,2,6,Tuesday
3,14,12,26,2018,2,7,Wednseday
1,9,19,28,2018,1,24,Wednseday
1,22,4,26,2018,2,21,Wednseday
3,17,3,20,2018,3,16,Friday
3,15,17,32,2018,8,5,Sunday
2,8,14,22,2017,2,28,Tuesday
3,4,14,18,2018,4,7,Saturday
1,2,12,14,2018,2,27,Tuesday
1,9,6,15,2018,8,6,Monday
1,6,11,17,2017,3,21,Tuesday
9,16,46,62,2018,2,7,Wednseday
1,26,2,28,2018,2,7,Wednseday
2,5,12,17,2017,9,10,Sunday
3,4,17,21,2017,12,25,Monday
0,8,14,22,2017,5,10,Wednseday
0,19,-2,17,2018,5,18,Friday
3,7,14,21,2018,1,16,Tuesday
3,25,6,31,2018,2,17,Saturday
2,6,18,24,2017,5,16,Tuesday
1,13,18,31,2017,12,26,Tuesday
1,6,8,14,2018,8,14,Tuesday
5,6,7,13,2017,11,17,Friday
2,29,1,30,2018,2,4,Sunday
7,29,0,29,2018,2,19,Monday
1,4,21,25,2018,1,14,Sunday
0,33,-5,28,2018,3,22,Thursday
1,4,18,22,2018,4,29,Sunday
0,8,4,12,2017,9,8,Friday
1,4,14,18,2017,9,28,Thursday
7,8,6,14,2018,4,19,Thursday
2,5,31,36,2017,10,11,Wednseday
5,10,9,19,2017,3,3,Friday
4,15,10,25,2018,2,1,Thursday
3,17,16,33,2018,1,6,Saturday
2,7,15,22,2017,9,25,Monday
2,5,11,16,2018,7,28,Saturday
1,3,9,12,2018,4,22,Sunday
2,6,14,20,2018,7,17,Tuesday
3,11,13,24,2017,8,11,Friday
5,6,5,11,2018,7,29,Sunday
0,21,12,33,2017,12,28,Thursday
2,5,26,31,2018,4,7,Saturday
6,9,24,33,2017,7,5,Wednseday
3,9,15,24,2018,1,21,Sunday
2,8,19,27,2017,5,24,Wednseday
1,2,12,14,2017,11,28,Tuesday
3,8,15,23,2017,10,3,Tuesday
1,9,19,28,2018,1,22,Monday
6,7,6,13,2017,8,30,Wednseday
0,2,2,4,2018,8,27,Monday
1,33,-9,24,2017,11,24,Friday
2,6,14,20,2017,8,5,Saturday
11,16,3,19,2017,3,9,Thursday
3,10,10,20,2017,12,16,Saturday
1,4,15,19,2017,5,21,Sunday
2,5,9,14,2018,3,21,Wednseday
3,6,12,18,2018,7,7,Saturday
2,9,20,29,2017,11,12,Sunday
2,6,20,26,2018,2,14,Wednseday
4,10,21,31,2018,4,16,Monday
15,19,1,20,2017,10,25,Wednseday
3,8,17,25,2018,7,22,Sunday
0,11,20,31,2017,12,8,Friday
0,16,11,27,2017,6,13,Tuesday
3,5,11,16,2018,1,14,Sunday
2,4,14,18,2017,9,9,Saturday
3,10,27,37,2018,5,8,Tuesday
0,27,7,34,2017,11,29,Wednseday
2,8,14,22,2017,11,26,Sunday
3,10,9,19,2018,8,17,Friday
5,12,23,35,2018,7,26,Thursday
3,7,38,45,2017,2,17,Friday
2,3,15,18,2018,4,5,Thursday
3,5,15,20,2017,8,4,Friday
1,18,12,30,2018,5,21,Monday
1,9,15,24,2018,6,10,Sunday
4,5,23,28,2018,5,10,Thursday
3,4,2,6,2018,7,28,Saturday
6,27,4,31,2017,10,3,Tuesday
1,16,10,26,2017,9,20,Wednseday
3,15,12,27,2017,10,3,Tuesday
3,13,25,38,2018,8,3,Friday
9,12,3,15,2018,7,16,Monday
1,12,14,26,2017,12,7,Thursday
0,1,3,4,2018,8,13,Monday
3,5,0,5,2018,8,5,Sunday
3,17,7,24,2017,6,11,Sunday
1,7,17,24,2017,7,24,Monday
0,20,16,36,2017,9,21,Thursday
0,1,9,10,2017,9,18,Monday
1,3,1,4,2018,8,27,Monday
1,4,10,14,2017,11,28,Tuesday
5,31,29,60,2016,10,9,Sunday
1,10,18,28,2018,8,13,Monday
3,7,20,27,2017,2,10,Friday
2,21,8,29,2018,6,13,Wednseday
2,9,23,32,2018,1,13,Saturday
1,4,10,14,2018,7,26,Thursday
1,7,16,23,2017,11,7,Tuesday
4,26,3,29,2018,1,11,Thursday
1,8,13,21,2017,10,26,Thursday
0,4,19,23,2018,8,21,Tuesday
6,16,10,26,2018,2,21,Wednseday
13,14,6,20,2017,11,9,Thursday
1,12,9,21,2017,3,8,Wednseday
4,11,11,22,2017,5,1,Monday
1,25,1,26,2018,7,19,Thursday
2,23,-3,20,2017,11,18,Saturday
5,11,13,24,2017,7,21,Friday
3,8,18,26,2017,5,21,Sunday
2,18,12,30,2018,2,25,Sunday
2,7,22,29,2018,6,26,Tuesday
0,28,-3,25,2018,3,16,Friday
1,9,28,37,2018,6,4,Monday
3,13,13,26,2017,7,7,Friday
16,22,-1,21,2018,8,8,Wednseday
4,19,8,27,2018,3,31,Saturday
1,4,24,28,2017,8,7,Monday
2,11,6,17,2018,3,4,Sunday
2,15,14,29,2018,3,14,Wednseday
5,14,14,28,2017,10,4,Wednseday
2,8,13,21,2018,1,11,Thursday
4,5,8,13,2018,3,22,Thursday
2,16,8,24,2017,7,1,Saturday
5,6,6,12,2018,7,20,Friday
4,9,10,19,2018,8,11,Saturday
2,14,5,19,2017,9,13,Wednseday
3,8,10,18,2018,7,13,Friday
2,7,8,15,2018,7,16,Monday
5,17,2,19,2018,3,30,Friday
6,21,18,39,2017,4,28,Friday
20,29,19,48,2018,5,16,Wednseday
2,8,24,32,2017,1,30,Monday
1,17,16,33,2018,5,27,Sunday
3,4,15,19,2018,1,12,Friday
1,12,12,24,2018,2,27,Tuesday
2,9,14,23,2017,5,2,Tuesday
2,5,21,26,2018,5,30,Wednseday
4,8,21,29,2017,10,9,Monday
2,7,29,36,2018,8,20,Monday
6,8,15,23,2018,1,3,Wednseday
4,8,14,22,2017,10,26,Thursday
3,32,-6,26,2017,12,3,Sunday
3,4,11,15,2018,5,20,Sunday
2,26,-6,20,2018,3,14,Wednseday
2,9,16,25,2018,1,22,Monday
1,10,19,29,2018,7,3,Tuesday
1,14,9,23,2017,4,19,Wednseday
7,21,3,24,2017,11,28,Tuesday
4,10,20,30,2017,12,30,Saturday
2,13,19,32,2018,5,5,Saturday
2,6,33,39,2018,6,9,Saturday
6,10,-5,5,2018,8,24,Friday
8,22,17,39,2018,4,26,Thursday
4,6,11,17,2017,11,12,Sunday
0,13,12,25,2017,11,24,Friday
1,5,15,20,2017,3,30,Thursday
1,13,16,29,2018,3,4,Sunday
1,14,14,28,2017,5,8,Monday
0,1,9,10,2017,9,18,Monday
3,17,21,38,2018,5,22,Tuesday
2,64,-46,18,2017,7,17,Monday
3,26,12,38,2017,12,16,Saturday
8,12,11,23,2017,5,3,Wednseday
4,29,2,31,2017,12,5,Tuesday
7,17,7,24,2017,9,15,Friday
5,13,8,21,2017,5,31,Wednseday
2,3,12,15,2017,7,11,Tuesday
13,26,14,40,2017,6,28,Wednseday
2,7,24,31,2017,6,27,Tuesday
4,13,14,27,2017,12,1,Friday
2,6,15,21,2018,1,2,Tuesday
3,8,7,15,2017,11,14,Tuesday
1,2,15,17,2018,4,17,Tuesday
3,15,12,27,2018,5,9,Wednseday
0,8,18,26,2017,8,31,Thursday
1,9,6,15,2018,5,14,Monday
1,9,15,24,2017,6,4,Sunday
7,13,26,39,2017,5,5,Friday
2,3,9,12,2018,4,7,Saturday
2,5,13,18,2018,7,21,Saturday
5,12,23,35,2018,8,8,Wednseday
2,14,15,29,2018,1,31,Wednseday
2,5,20,25,2018,6,23,Saturday
1,6,14,20,2018,6,14,Thursday
2,7,14,21,2018,6,26,Tuesday
5,8,21,29,2017,2,16,Thursday
4,17,3,20,2017,9,2,Saturday
5,10,3,13,2018,8,4,Saturday
0,14,29,43,2017,2,2,Thursday
1,31,5,36,2018,2,1,Thursday
6,7,8,15,2018,4,26,Thursday
2,3,12,15,2017,9,26,Tuesday
2,17,10,27,2018,2,8,Thursday
1,10,13,23,2017,7,31,Monday
1,18,13,31,2018,1,30,Tuesday
0,7,25,32,2018,1,19,Friday
1,2,4,6,2018,8,14,Tuesday
0,2,16,18,2018,2,1,Thursday
1,23,15,38,2018,1,30,Tuesday
0,47,-14,33,2017,3,1,Wednseday
1,6,26,32,2017,5,18,Thursday
6,9,9,18,2018,6,16,Saturday
1,4,18,22,2017,4,2,Sunday
1,5,3,8,2018,5,17,Thursday
1,25,4,29,2017,6,18,Sunday
3,6,24,30,2017,3,25,Saturday
1,5,7,12,2018,3,15,Thursday
1,7,20,27,2017,8,22,Tuesday
2,10,18,28,2017,5,16,Tuesday
1,15,-4,11,2018,5,17,Thursday
2,7,16,23,2017,4,4,Tuesday
3,8,16,24,2017,12,5,Tuesday
2,6,15,21,2018,4,17,Tuesday
1,21,12,33,2017,10,19,Thursday
3,4,9,13,2017,5,19,Friday
2,10,19,29,2017,12,19,Tuesday
6,22,6,28,2018,2,22,Thursday
2,3,10,13,2018,4,4,Wednseday
4,5,13,18,2018,6,15,Friday
6,7,9,16,2018,1,3,Wednseday
2,6,7,13,2018,2,28,Wednseday
2,5,25,30,2018,4,21,Saturday
1,8,26,34,2017,4,11,Tuesday
21,26,3,29,2017,4,24,Monday
0,3,14,17,2018,1,19,Friday
4,5,13,18,2017,12,1,Friday
9,28,18,46,2018,2,24,Saturday
1,10,13,23,2017,8,6,Sunday
3,20,8,28,2017,8,15,Tuesday
13,26,-3,23,2017,8,30,Wednseday
8,13,27,40,2017,7,6,Thursday
4,6,21,27,2017,2,3,Friday
16,31,11,42,2018,1,9,Tuesday
1,7,17,24,2017,6,6,Tuesday
3,17,7,24,2018,1,21,Sunday
6,20,14,34,2017,6,16,Friday
3,15,17,32,2017,5,19,Friday
7,8,12,20,2017,6,21,Wednseday
2,15,8,23,2017,11,22,Wednseday
1,2,18,20,2018,6,13,Wednseday
1,3,11,14,2017,11,13,Monday
5,11,22,33,2018,4,19,Thursday
7,12,8,20,2017,10,11,Wednseday
7,29,2,31,2018,2,13,Tuesday
2,6,17,23,2017,8,22,Tuesday
1,9,20,29,2018,2,14,Wednseday
2,17,10,27,2018,5,17,Thursday
2,20,8,28,2017,8,30,Wednseday
7,8,18,26,2017,12,20,Wednseday
9,79,-55,24,2018,2,24,Saturday
1,14,13,27,2018,2,6,Tuesday
0,20,7,27,2017,12,8,Friday
1,7,9,16,2018,3,7,Wednseday
5,16,11,27,2017,10,11,Wednseday
2,20,16,36,2018,8,1,Wednseday
2,13,8,21,2018,1,16,Tuesday
2,4,18,22,2017,11,20,Monday
0,16,15,31,2017,3,27,Monday
4,6,6,12,2018,3,2,Friday
1,4,28,32,2018,8,12,Sunday
0,4,24,28,2018,6,25,Monday
1,16,6,22,2017,5,1,Monday
5,8,7,15,2017,6,4,Sunday
2,32,-9,23,2017,10,16,Monday
2,6,31,37,2017,1,22,Sunday
3,6,25,31,2017,8,19,Saturday
8,14,7,21,2017,11,8,Wednseday
1,7,28,35,2017,8,2,Wednseday
5,11,19,30,2017,10,29,Sunday
2,10,11,21,2018,5,8,Tuesday
5,20,8,28,2018,1,10,Wednseday
11,15,7,22,2017,11,5,Sunday
4,14,9,23,2017,10,16,Monday
1,13,2,15,2018,5,22,Tuesday
5,15,9,24,2017,2,26,Sunday
4,11,16,27,2018,8,16,Thursday
1,8,28,36,2017,12,21,Thursday
2,4,11,15,2017,11,12,Sunday
4,7,11,18,2018,1,4,Thursday
3,21,5,26,2017,4,7,Friday
1,9,19,28,2017,8,21,Monday
1,5,24,29,2017,3,5,Sunday
2,16,8,24,2018,7,31,Tuesday
7,12,14,26,2017,10,27,Friday
3,8,6,14,2018,4,24,Tuesday
5,21,28,49,2018,1,5,Friday
1,5,17,22,2018,5,13,Sunday
3,9,11,20,2017,11,21,Tuesday
1,2,8,10,2018,6,25,Monday
1,10,18,28,2017,10,16,Monday
3,8,18,26,2017,2,12,Sunday
1,6,16,22,2018,7,25,Wednseday
5,9,18,27,2017,11,29,Wednseday
4,16,6,22,2017,5,15,Monday
1,5,6,11,2018,8,12,Sunday
6,16,16,32,2018,1,20,Saturday
0,5,14,19,2018,8,24,Friday
2,4,12,16,2018,4,9,Monday
2,9,25,34,2018,7,3,Tuesday
3,5,10,15,2017,6,11,Sunday
4,15,14,29,2017,10,12,Thursday
1,7,11,18,2017,9,18,Monday
5,19,9,28,2017,8,31,Thursday
4,10,29,39,2018,5,5,Saturday
1,13,10,23,2018,4,25,Wednseday
4,12,10,22,2017,8,3,Thursday
1,4,8,12,2018,6,14,Thursday
4,11,13,24,2018,8,18,Saturday
3,4,10,14,2017,11,24,Friday
2,13,16,29,2018,2,5,Monday
4,19,12,31,2018,5,18,Friday
4,21,0,21,2017,10,20,Friday
1,11,11,22,2018,3,25,Sunday
3,13,11,24,2017,6,16,Friday
2,3,8,11,2018,3,11,Sunday
0,19,10,29,2017,4,26,Wednseday
2,11,12,23,2018,3,3,Saturday
2,15,13,28,2017,11,14,Tuesday
5,6,7,13,2017,5,24,Wednseday
1,3,4,7,2018,8,22,Wednseday
1,8,29,37,2018,5,27,Sunday
29,35,26,61,2016,10,6,Thursday
1,2,20,22,2017,12,19,Tuesday
7,15,8,23,2018,1,8,Monday
4,19,9,28,2017,11,23,Thursday
6,12,15,27,2018,4,11,Wednseday
1,29,4,33,2017,7,9,Sunday
3,32,-8,24,2018,2,19,Monday
2,5,8,13,2017,11,1,Wednseday
1,5,22,27,2018,5,9,Wednseday
3,10,11,21,2017,11,24,Friday
2,11,8,19,2017,9,14,Thursday
1,8,15,23,2018,6,20,Wednseday
0,6,33,39,2017,2,2,Thursday
2,72,-48,24,2018,1,21,Sunday
1,9,27,36,2017,1,30,Monday
1,7,18,25,2018,5,3,Thursday
1,16,6,22,2017,8,15,Tuesday
1,8,22,30,2018,1,17,Wednseday
2,6,12,18,2018,3,18,Sunday
2,15,23,38,2018,5,27,Sunday
0,13,12,25,2017,11,9,Thursday
2,12,8,20,2018,4,25,Wednseday
1,4,14,18,2017,10,22,Sunday
16,31,6,37,2018,3,19,Monday
2,16,10,26,2018,7,11,Wednseday
2,11,14,25,2018,7,14,Saturday
6,9,48,57,2016,10,5,Wednseday
2,24,0,24,2018,4,10,Tuesday
1,14,5,19,2018,3,1,Thursday
3,10,18,28,2018,1,19,Friday
2,8,8,16,2018,3,5,Monday
5,14,17,31,2018,2,23,Friday
6,7,12,19,2018,4,26,Thursday
6,26,0,26,2017,11,16,Thursday
2,6,26,32,2017,10,7,Saturday
1,29,7,36,2018,2,20,Tuesday
3,9,14,23,2017,8,26,Saturday
2,10,6,16,2018,7,11,Wednseday
3,12,12,24,2018,8,17,Friday
2,8,19,27,2017,12,13,Wednseday
2,6,27,33,2017,2,1,Wednseday
1,4,14,18,2017,9,11,Monday
1,9,18,27,2018,4,25,Wednseday
2,8,21,29,2018,4,22,Sunday
4,8,13,21,2018,4,12,Thursday
1,26,-5,21,2017,11,23,Thursday
1,16,15,31,2018,2,5,Monday
1,5,15,20,2017,8,16,Wednseday
3,142,-110,32,2017,11,25,Saturday
4,15,7,22,2018,4,10,Tuesday
1,5,14,19,2018,1,10,Wednseday
4,13,25,38,2017,12,22,Friday
5,14,18,32,2018,3,9,Friday
2,6,17,23,2018,4,28,Saturday
0,4,56,60,2017,8,3,Thursday
2,13,21,34,2018,6,16,Saturday
1,2,5,7,2018,8,1,Wednseday
1,3,12,15,2018,2,26,Monday
4,11,12,23,2018,7,21,Saturday
4,11,29,40,2018,6,22,Friday
0,4,19,23,2017,4,4,Tuesday
3,11,13,24,2017,9,2,Saturday
1,9,10,19,2018,5,16,Wednseday
5,32,0,32,2018,2,2,Friday
2,3,10,13,2017,5,20,Saturday
5,13,7,20,2017,5,24,Wednseday
0,1,12,13,2017,8,10,Thursday
8,11,3,14,2018,8,9,Thursday
1,7,20,27,2017,6,27,Tuesday
6,10,22,32,2017,12,29,Friday
5,11,23,34,2017,2,10,Friday
10,33,1,34,2017,9,23,Saturday
1,8,15,23,2018,2,25,Sunday
2,19,7,26,2017,7,12,Wednseday
2,8,8,16,2018,8,20,Monday
1,22,-5,17,2018,7,30,Monday
0,1,13,14,2018,6,28,Thursday
0,7,14,21,2017,10,10,Tuesday
2,14,15,29,2018,4,16,Monday
5,17,21,38,2017,6,11,Sunday
3,33,3,36,2018,2,18,Sunday
2,16,15,31,2017,4,3,Monday
1,6,12,18,2018,2,8,Thursday
1,14,25,39,2018,1,22,Monday
5,6,12,18,2018,4,27,Friday
1,7,9,16,2017,9,19,Tuesday
3,5,7,12,2018,8,3,Friday
1,5,8,13,2018,3,28,Wednseday
1,16,13,29,2017,12,4,Monday
5,12,10,22,2018,4,22,Sunday
5,6,7,13,2017,8,31,Thursday
0,15,11,26,2018,3,1,Thursday
1,7,20,27,2018,6,7,Thursday
1,2,13,15,2018,8,27,Monday
1,12,18,30,2018,1,7,Sunday
1,11,11,22,2018,2,13,Tuesday
1,17,19,36,2018,5,28,Monday
3,19,8,27,2017,11,11,Saturday
1,10,12,22,2017,4,23,Sunday
4,15,10,25,2018,2,11,Sunday
4,17,16,33,2018,3,18,Sunday
13,21,7,28,2018,7,25,Wednseday
2,9,14,23,2018,3,6,Tuesday
3,20,2,22,2017,8,8,Tuesday
1,6,14,20,2017,8,8,Tuesday
1,15,12,27,2017,6,21,Wednseday
3,18,20,38,2018,2,2,Friday
3,16,2,18,2018,8,4,Saturday
4,11,22,33,2018,5,3,Thursday
5,29,26,55,2017,12,7,Thursday
4,11,9,20,2017,11,16,Thursday
2,14,15,29,2017,2,6,Monday
2,14,14,28,2018,5,7,Monday
0,14,19,33,2018,2,2,Friday
1,19,8,27,2018,3,22,Thursday
3,18,12,30,2017,5,22,Monday
2,6,20,26,2017,11,4,Saturday
2,19,6,25,2018,1,27,Saturday
2,17,17,34,2017,8,26,Saturday
4,25,7,32,2018,3,23,Friday
1,7,14,21,2017,3,20,Monday
2,8,16,24,2018,6,17,Sunday
1,4,12,16,2018,5,7,Monday
3,27,-2,25,2018,2,12,Monday
3,15,11,26,2017,11,17,Friday
2,11,22,33,2017,5,20,Saturday
2,3,15,18,2017,5,22,Monday
4,11,13,24,2018,7,16,Monday
2,11,17,28,2018,2,26,Monday
1,6,23,29,2017,9,26,Tuesday
19,24,-5,19,2018,7,14,Saturday
3,7,6,13,2018,3,20,Tuesday
0,1,12,13,2018,7,4,Wednseday
19,75,-41,34,2018,4,6,Friday
2,7,14,21,2017,11,1,Wednseday
5,23,-1,22,2017,11,29,Wednseday
1,7,11,18,2018,7,16,Monday
1,7,16,23,2018,2,18,Sunday
1,8,17,25,2017,6,1,Thursday
1,12,17,29,2017,8,27,Sunday
5,11,22,33,2018,7,12,Thursday
3,9,17,26,2018,4,18,Wednseday
5,19,6,25,2018,7,7,Saturday
3,28,10,38,2018,3,10,Saturday
3,5,24,29,2018,4,4,Wednseday
0,6,15,21,2018,7,18,Wednseday
4,11,-1,10,2017,5,14,Sunday
0,12,16,28,2018,2,7,Wednseday
3,10,31,41,2017,1,10,Tuesday
3,12,7,19,2018,3,24,Saturday
1,49,-6,43,2018,3,27,Tuesday
1,2,10,12,2018,5,10,Thursday
12,19,4,23,2018,8,1,Wednseday
4,4,11,15,2018,4,2,Monday
2,14,12,26,2018,4,11,Wednseday
4,16,16,32,2018,5,24,Thursday
8,21,7,28,2017,6,19,Monday
2,9,16,25,2017,5,1,Monday
1,12,16,28,2018,1,24,Wednseday
0,15,18,33,2018,6,13,Wednseday
0,15,9,24,2018,7,17,Tuesday
2,3,19,22,2017,12,24,Sunday
2,7,11,18,2018,7,16,Monday
1,51,-23,28,2017,5,10,Wednseday
2,7,15,22,2018,7,3,Tuesday
3,8,10,18,2018,4,16,Monday
3,14,14,28,2018,2,2,Friday
12,17,17,34,2018,4,25,Wednseday
3,5,7,12,2018,8,25,Saturday
2,10,16,26,2018,3,24,Saturday
4,11,15,26,2017,7,28,Friday
5,15,17,32,2017,12,3,Sunday
4,26,3,29,2018,5,6,Sunday
1,8,4,12,2017,9,14,Thursday
3,4,5,9,2018,8,25,Saturday
5,22,2,24,2017,5,20,Saturday
5,12,16,28,2017,3,9,Thursday
7,13,7,20,2018,3,27,Tuesday
1,2,11,13,2018,3,20,Tuesday
2,10,12,22,2017,7,11,Tuesday
3,18,12,30,2017,10,1,Sunday
1,22,10,32,2018,6,11,Monday
1,2,9,11,2017,5,22,Monday
61,86,-35,51,2017,9,6,Wednseday
3,6,19,25,2017,3,24,Friday
2,9,20,29,2017,12,5,Tuesday
5,20,5,25,2017,11,4,Saturday
1,5,16,21,2017,11,2,Thursday
2,26,-2,24,2018,3,24,Saturday
3,22,5,27,2018,1,30,Tuesday
0,5,17,22,2018,7,19,Thursday
4,12,11,23,2017,4,30,Sunday
2,3,10,13,2018,7,10,Tuesday
2,3,13,16,2018,5,14,Monday
1,4,9,13,2018,8,23,Thursday
9,16,15,31,2017,12,24,Sunday
2,19,8,27,2017,3,1,Wednseday
1,21,12,33,2018,5,17,Thursday
0,3,31,34,2017,2,17,Friday
6,12,23,35,2017,4,27,Thursday
3,14,21,35,2017,10,3,Tuesday
4,10,9,19,2017,5,12,Friday
1,7,9,16,2017,11,22,Wednseday
4,19,3,22,2017,11,26,Sunday
1,11,14,25,2017,6,18,Sunday
4,15,11,26,2017,9,28,Thursday
6,10,14,24,2018,5,1,Tuesday
1,8,27,35,2017,8,8,Tuesday
5,27,14,41,2018,3,9,Friday
0,6,32,38,2018,6,5,Tuesday
3,11,24,35,2017,4,24,Monday
8,36,7,43,2017,11,6,Monday
2,7,20,27,2017,8,17,Thursday
2,8,17,25,2018,3,25,Sunday
9,11,12,23,2018,7,15,Sunday
1,2,9,11,2018,3,18,Sunday
1,8,22,30,2018,1,23,Tuesday
2,16,-2,14,2018,8,7,Tuesday
18,29,6,35,2018,2,12,Monday
2,13,13,26,2018,2,21,Wednseday
40,48,-17,31,2018,4,27,Friday
9,16,15,31,2017,11,5,Sunday
2,5,14,19,2018,6,16,Saturday
1,7,14,21,2017,8,30,Wednseday
1,2,13,15,2017,8,7,Monday
6,43,-17,26,2017,11,22,Wednseday
1,8,19,27,2018,1,2,Tuesday
4,7,13,20,2017,11,24,Friday
9,33,-1,32,2018,2,5,Monday
3,7,17,24,2017,12,11,Monday
2,5,11,16,2018,1,8,Monday
4,7,35,42,2018,8,23,Thursday
3,9,6,15,2018,2,25,Sunday
3,10,26,36,2018,4,23,Monday
1,2,14,16,2018,4,24,Tuesday
3,10,12,22,2018,2,18,Sunday
2,22,3,25,2018,4,2,Monday
1,12,10,22,2017,8,30,Wednseday
0,7,7,14,2018,2,22,Thursday
19,26,-7,19,2018,5,16,Wednseday
6,28,56,84,2017,9,12,Tuesday
2,6,14,20,2017,3,7,Tuesday
2,5,12,17,2018,5,5,Saturday
4,11,29,40,2017,10,7,Saturday
4,5,13,18,2017,9,15,Friday
3,11,-1,10,2017,5,12,Friday
1,15,15,30,2017,12,18,Monday
5,9,3,12,2018,4,14,Saturday
19,29,29,58,2018,5,30,Wednseday
2,3,11,14,2017,6,19,Monday
1,7,7,14,2018,3,21,Wednseday
2,28,-5,23,2017,5,9,Tuesday
1,7,14,21,2017,3,8,Wednseday
0,4,12,16,2017,12,5,Tuesday
2,45,-21,24,2018,4,3,Tuesday
1,4,9,13,2017,8,24,Thursday
3,5,9,14,2018,2,21,Wednseday
3,10,15,25,2017,11,13,Monday
10,10,4,14,2017,11,13,Monday
5,11,7,18,2018,1,5,Friday
13,17,-4,13,2017,10,10,Tuesday
1,6,31,37,2017,12,5,Tuesday
3,15,20,35,2017,6,26,Monday
2,29,7,36,2017,4,11,Tuesday
3,30,13,43,2018,4,9,Monday
2,9,21,30,2018,4,25,Wednseday
1,5,10,15,2018,4,11,Wednseday
3,9,18,27,2017,5,6,Saturday
4,8,17,25,2017,5,25,Thursday
1,4,7,11,2018,8,5,Sunday
0,4,27,31,2018,1,15,Monday
4,5,6,11,2017,5,13,Saturday
1,7,30,37,2018,6,6,Wednseday
2,7,8,15,2018,8,13,Monday
5,8,17,25,2018,4,19,Thursday
2,17,12,29,2017,6,14,Wednseday
4,8,17,25,2017,6,8,Thursday
2,4,25,29,2018,4,15,Sunday
2,8,9,17,2018,5,7,Monday
1,9,32,41,2017,1,17,Tuesday
2,4,25,29,2017,2,7,Tuesday
7,12,16,28,2017,3,9,Thursday
3,15,8,23,2018,1,14,Sunday
6,10,7,17,2017,10,17,Tuesday
3,16,14,30,2018,3,3,Saturday
7,14,-2,12,2017,11,22,Wednseday
1,6,17,23,2018,6,11,Monday
2,12,21,33,2017,11,25,Saturday
2,8,10,18,2018,8,6,Monday
5,20,27,47,2018,2,10,Saturday
2,19,2,21,2018,5,16,Wednseday
2,14,11,25,2017,10,9,Monday
2,6,7,13,2018,8,11,Saturday
6,25,-1,24,2018,2,16,Friday
0,8,27,35,2018,4,12,Thursday
5,17,8,25,2017,6,9,Friday
5,6,11,17,2018,2,17,Saturday
3,7,10,17,2018,6,26,Tuesday
4,12,20,32,2017,8,11,Friday
2,7,28,35,2017,2,1,Wednseday
1,14,18,32,2018,1,22,Monday
1,3,8,11,2017,7,3,Monday
4,14,15,29,2017,3,2,Thursday
1,7,42,49,2017,10,19,Thursday
3,15,20,35,2018,1,30,Tuesday
7,35,-7,28,2017,9,29,Friday
2,5,19,24,2018,7,8,Sunday
0,6,13,19,2018,3,15,Thursday
1,22,14,36,2017,4,6,Thursday
3,15,8,23,2017,12,4,Monday
4,5,14,19,2018,3,18,Sunday
0,28,1,29,2018,4,19,Thursday
3,7,18,25,2018,6,1,Friday
3,59,-28,31,2017,9,18,Monday
0,8,6,14,2018,5,16,Wednseday
1,6,14,20,2018,5,3,Thursday
3,14,20,34,2018,5,25,Friday
3,9,16,25,2017,12,1,Friday
3,8,25,33,2017,6,11,Sunday
2,5,3,8,2018,8,8,Wednseday
1,12,24,36,2017,6,1,Thursday
1,5,11,16,2018,7,25,Wednseday
0,3,17,20,2017,8,29,Tuesday
1,15,5,20,2017,10,12,Thursday
3,8,0,8,2018,8,5,Sunday
1,3,12,15,2018,1,17,Wednseday
1,15,7,22,2017,11,22,Wednseday
1,8,16,24,2018,6,25,Monday
3,18,7,25,2018,1,12,Friday
4,9,23,32,2017,4,1,Saturday
7,14,9,23,2018,2,14,Wednseday
0,9,13,22,2018,1,2,Tuesday
2,7,11,18,2017,7,17,Monday
2,9,19,28,2017,5,2,Tuesday
0,9,20,29,2018,1,3,Wednseday
1,4,18,22,2017,5,23,Tuesday
1,8,13,21,2017,9,13,Wednseday
2,16,21,37,2017,9,30,Saturday
3,8,5,13,2018,4,24,Tuesday
3,6,18,24,2018,4,15,Sunday
3,24,12,36,2017,12,31,Sunday
15,20,13,33,2018,2,4,Sunday
4,29,-8,21,2018,3,15,Thursday
3,6,35,41,2018,1,26,Friday
1,8,15,23,2018,2,14,Wednseday
1,2,6,8,2018,7,19,Thursday
3,16,8,24,2018,5,4,Friday
2,25,-1,24,2018,3,5,Monday
0,3,6,9,2018,8,15,Wednseday
2,9,18,27,2018,8,4,Saturday
0,14,26,40,2018,6,22,Friday
11,36,-15,21,2017,11,24,Friday
1,2,5,7,2018,8,14,Tuesday
6,14,5,19,2017,11,30,Thursday
7,14,14,28,2018,6,26,Tuesday
3,11,15,26,2017,12,9,Saturday
2,5,12,17,2018,7,8,Sunday
4,14,4,18,2017,11,27,Monday
1,13,16,29,2017,2,9,Thursday
1,6,10,16,2018,5,2,Wednseday
3,8,12,20,2017,11,14,Tuesday
3,7,19,26,2017,12,8,Friday
1,2,19,21,2018,7,24,Tuesday
1,2,21,23,2018,5,20,Sunday
3,8,11,19,2018,5,4,Friday
4,7,32,39,2017,2,2,Thursday
15,52,-23,29,2017,11,20,Monday
1,8,18,26,2018,5,9,Wednseday
4,30,6,36,2017,7,17,Monday
2,8,15,23,2017,3,20,Monday
5,21,4,25,2017,11,23,Thursday
1,5,25,30,2017,10,29,Sunday
1,34,-7,27,2018,3,20,Tuesday
1,10,8,18,2018,3,5,Monday
6,7,6,13,2017,5,17,Wednseday
5,24,3,27,2017,11,24,Friday
1,13,16,29,2018,2,22,Thursday
8,35,-5,30,2018,1,23,Tuesday
5,24,6,30,2017,11,18,Saturday
1,7,21,28,2018,7,25,Wednseday
2,7,21,28,2017,9,18,Monday
3,14,17,31,2017,12,9,Saturday
1,8,29,37,2018,6,11,Monday
1,5,16,21,2018,5,2,Wednseday
1,4,9,13,2017,8,1,Tuesday
4,5,9,14,2017,10,26,Thursday
0,3,4,7,2018,8,10,Friday
6,15,6,21,2017,3,15,Wednseday
3,5,9,14,2017,11,24,Friday
1,7,17,24,2017,12,11,Monday
4,12,11,23,2017,10,15,Sunday
2,5,8,13,2018,6,13,Wednseday
1,5,15,20,2018,7,4,Wednseday
1,10,14,24,2018,8,20,Monday
1,3,24,27,2018,2,20,Tuesday
1,10,8,18,2017,12,10,Sunday
2,12,9,21,2017,9,20,Wednseday
4,9,21,30,2018,4,15,Sunday
4,9,26,35,2017,11,24,Friday
0,18,28,46,2017,7,14,Friday
1,5,19,24,2017,9,3,Sunday
3,14,13,27,2018,4,24,Tuesday
5,21,17,38,2018,7,6,Friday
3,14,18,32,2018,6,29,Friday
2,7,18,25,2018,6,18,Monday
1,3,2,5,2018,8,26,Sunday
1,28,0,28,2017,9,12,Tuesday
1,4,18,22,2017,4,2,Sunday
1,3,19,22,2018,6,12,Tuesday
3,4,8,12,2018,3,16,Friday
0,3,8,11,2018,4,30,Monday
1,7,21,28,2018,5,9,Wednseday
9,11,11,22,2018,8,6,Monday
2,10,7,17,2018,3,4,Sunday
1,7,13,20,2017,8,9,Wednseday
3,10,25,35,2018,5,29,Tuesday
4,13,8,21,2017,6,15,Thursday
2,10,13,23,2017,10,15,Sunday
11,17,0,17,2018,8,3,Friday
2,17,7,24,2017,4,16,Sunday
3,14,16,30,2018,2,14,Wednseday
6,11,19,30,2017,4,29,Saturday
11,20,8,28,2018,1,18,Thursday
3,10,13,23,2017,11,25,Saturday
1,5,13,18,2017,9,10,Sunday
0,2,19,21,2017,8,23,Wednseday
1,9,14,23,2017,9,5,Tuesday
43,65,-29,36,2017,10,17,Tuesday
4,17,3,20,2017,11,24,Friday
1,7,22,29,2018,4,4,Wednseday
2,10,10,20,2018,2,17,Saturday
1,7,8,15,2018,7,23,Monday
2,43,-4,39,2018,4,23,Monday
1,15,13,28,2018,4,25,Wednseday
5,13,12,25,2017,6,8,Thursday
3,14,16,30,2018,1,16,Tuesday
5,8,27,35,2018,4,18,Wednseday
1,3,26,29,2017,8,21,Monday
2,4,14,18,2017,12,10,Sunday
3,16,17,33,2017,10,8,Sunday
4,17,16,33,2017,12,9,Saturday
5,6,9,15,2017,8,10,Thursday
1,12,14,26,2017,3,23,Thursday
1,3,14,17,2018,2,20,Tuesday
32,41,-7,34,2018,1,20,Saturday
1,13,7,20,2017,11,15,Wednseday
1,9,21,30,2017,7,17,Monday
6,15,14,29,2017,4,18,Tuesday
1,13,21,34,2018,6,21,Thursday
1,4,11,15,2017,5,18,Thursday
3,9,9,18,2018,3,3,Saturday
2,6,8,14,2017,11,15,Wednseday
2,9,13,22,2018,5,1,Tuesday
36,44,-33,11,2018,8,6,Monday
3,7,16,23,2018,4,9,Monday
1,5,17,22,2018,8,8,Wednseday
2,21,16,37,2017,4,11,Tuesday
2,3,8,11,2017,5,29,Monday
3,13,6,19,2018,8,17,Friday
3,7,6,13,2018,6,15,Friday
1,4,1,5,2018,8,16,Thursday
2,7,30,37,2017,10,2,Monday
1,9,22,31,2018,1,15,Monday
1,7,24,31,2018,7,17,Tuesday
2,5,0,5,2018,8,8,Wednseday
23,50,13,63,2018,4,16,Monday
16,25,-3,22,2018,7,15,Sunday
3,9,21,30,2017,10,1,Sunday
4,25,2,27,2018,2,23,Friday
8,16,27,43,2018,6,6,Wednseday
3,4,6,10,2018,7,20,Friday
17,25,1,26,2017,4,8,Saturday
10,12,8,20,2017,11,24,Friday
5,20,0,20,2018,2,28,Wednseday
1,11,11,22,2017,10,16,Monday
3,10,8,18,2017,10,13,Friday
0,30,3,33,2017,9,6,Wednseday
4,11,15,26,2017,12,10,Sunday
1,14,16,30,2018,5,15,Tuesday
1,9,20,29,2017,12,12,Tuesday
1,18,7,25,2018,2,18,Sunday
1,2,5,7,2018,8,15,Wednseday
1,2,14,16,2018,6,10,Sunday
3,13,5,18,2018,8,4,Saturday
8,17,26,43,2018,6,3,Sunday
1,4,19,23,2018,8,19,Sunday
2,16,13,29,2017,6,20,Tuesday
3,10,15,25,2017,12,17,Sunday
2,8,17,25,2017,12,3,Sunday
3,20,11,31,2018,2,23,Friday
4,10,22,32,2017,5,21,Sunday
0,3,17,20,2017,11,7,Tuesday
5,14,20,34,2017,12,28,Thursday
1,4,21,25,2017,11,27,Monday
6,10,6,16,2018,1,2,Tuesday
9,22,-3,19,2017,11,12,Sunday
1,8,27,35,2017,5,1,Monday
1,16,9,25,2017,7,9,Sunday
3,13,14,27,2017,7,18,Tuesday
9,16,19,35,2017,9,25,Monday
1,20,10,30,2018,1,31,Wednseday
4,15,33,48,2018,6,7,Thursday
1,6,15,21,2017,8,31,Thursday
1,14,22,36,2018,4,18,Wednseday
3,17,4,21,2018,2,26,Monday
7,14,14,28,2018,4,26,Thursday
8,9,18,27,2018,6,6,Wednseday
7,10,15,25,2017,6,9,Friday
1,15,14,29,2017,11,5,Sunday
2,4,20,24,2017,4,1,Saturday
2,31,-5,26,2017,11,25,Saturday
7,11,17,28,2018,6,14,Thursday
3,4,10,14,2018,4,13,Friday
3,12,23,35,2017,2,10,Friday
2,9,9,18,2017,9,9,Saturday
1,15,25,40,2018,4,22,Sunday
12,13,5,18,2018,8,17,Friday
1,8,18,26,2018,4,26,Thursday
1,8,16,24,2018,4,15,Sunday
0,8,23,31,2018,5,28,Monday
3,10,10,20,2018,3,31,Saturday
5,30,4,34,2017,4,13,Thursday
1,7,36,43,2018,7,17,Tuesday
2,15,13,28,2018,3,26,Monday
2,7,21,28,2018,4,16,Monday
2,8,5,13,2018,7,4,Wednseday
2,8,12,20,2017,11,22,Wednseday
3,9,4,13,2017,7,29,Saturday
1,3,10,13,2017,9,5,Tuesday
2,4,12,16,2018,4,3,Tuesday
2,5,15,20,2018,8,25,Saturday
2,3,15,18,2018,4,23,Monday
1,48,-14,34,2017,7,5,Wednseday
1,31,-10,21,2018,3,1,Thursday
2,7,13,20,2017,10,24,Tuesday
7,20,3,23,2018,8,7,Tuesday
5,8,53,61,2016,10,7,Friday
1,2,9,11,2017,11,20,Monday
2,10,15,25,2018,2,4,Sunday
2,6,6,12,2017,7,16,Sunday
1,8,18,26,2017,12,14,Thursday
1,21,9,30,2018,2,27,Tuesday
3,10,30,40,2018,7,1,Sunday
1,4,27,31,2018,7,16,Monday
1,7,13,20,2017,3,30,Thursday
10,13,16,29,2018,3,18,Sunday
1,11,14,25,2017,3,30,Thursday
16,18,1,19,2018,1,13,Saturday
15,38,-3,35,2018,1,15,Monday
3,5,19,24,2018,6,30,Saturday
2,11,4,15,2017,5,8,Monday
2,23,15,38,2018,1,22,Monday
3,18,5,23,2017,10,14,Saturday
8,100,-68,32,2017,6,11,Sunday
3,65,-43,22,2018,3,11,Sunday
1,10,13,23,2018,1,16,Tuesday
3,16,24,40,2018,6,2,Saturday
5,15,11,26,2017,6,11,Sunday
3,6,19,25,2017,3,31,Friday
1,18,19,37,2017,9,18,Monday
3,8,19,27,2017,2,14,Tuesday
7,14,31,45,2018,6,4,Monday
1,2,5,7,2018,8,8,Wednseday
2,6,19,25,2017,9,30,Saturday
3,7,23,30,2018,8,6,Monday
8,20,23,43,2018,5,29,Tuesday
4,11,15,26,2018,4,12,Thursday
2,13,24,37,2018,1,16,Tuesday
5,6,2,8,2018,8,16,Thursday
2,6,16,22,2018,2,15,Thursday
7,14,7,21,2018,1,18,Thursday
8,9,8,17,2017,7,18,Tuesday
2,6,10,16,2018,4,24,Tuesday
3,31,0,31,2017,2,7,Tuesday
1,10,11,21,2017,8,29,Tuesday
1,9,12,21,2017,9,11,Monday
2,3,2,5,2018,8,4,Saturday
2,15,21,36,2017,12,5,Tuesday
4,5,19,24,2018,4,15,Sunday
2,3,10,13,2017,7,15,Saturday
8,29,14,43,2018,1,24,Wednseday
3,13,8,21,2017,6,6,Tuesday
2,10,13,23,2017,11,12,Sunday
6,11,22,33,2018,5,5,Saturday
4,8,16,24,2018,5,11,Friday
1,2,12,14,2018,2,19,Monday
2,30,-7,23,2018,5,7,Monday
1,11,14,25,2017,12,10,Sunday
1,14,4,18,2017,11,20,Monday
13,16,23,39,2018,8,2,Thursday
1,6,22,28,2017,10,4,Wednseday
10,22,7,29,2017,6,20,Tuesday
2,9,8,17,2017,3,21,Tuesday
2,9,37,46,2017,1,29,Sunday
1,13,3,16,2018,3,7,Wednseday
2,6,17,23,2017,9,27,Wednseday
7,18,0,18,2017,10,9,Monday
0,6,16,22,2018,7,5,Thursday
2,17,15,32,2018,1,6,Saturday
1,8,14,22,2017,8,20,Sunday
1,10,14,24,2017,12,11,Monday
4,13,17,30,2017,12,3,Sunday
1,4,19,23,2017,3,13,Monday
1,4,2,6,2018,8,16,Thursday
1,12,15,27,2017,11,15,Wednseday
3,27,-7,20,2017,3,31,Friday
3,8,13,21,2018,2,27,Tuesday
3,6,25,31,2017,12,8,Friday
1,15,11,26,2017,4,2,Sunday
3,9,11,20,2018,7,21,Saturday
19,22,3,25,2018,3,4,Sunday
2,13,19,32,2018,2,17,Saturday
2,8,15,23,2018,4,17,Tuesday
2,4,17,21,2017,2,27,Monday
0,8,18,26,2017,8,2,Wednseday
4,5,9,14,2017,6,8,Thursday
3,8,13,21,2018,4,2,Monday
2,5,9,14,2017,10,11,Wednseday
10,19,28,47,2018,6,1,Friday
2,8,28,36,2018,8,21,Tuesday
3,4,10,14,2017,8,25,Friday
6,12,7,19,2017,10,18,Wednseday
4,5,11,16,2017,9,24,Sunday
6,14,14,28,2017,10,24,Tuesday
1,20,15,35,2018,5,17,Thursday
2,9,9,18,2018,3,19,Monday
8,34,-10,24,2017,11,14,Tuesday
6,24,4,28,2018,3,13,Tuesday
3,15,6,21,2018,2,23,Friday
2,12,17,29,2018,6,20,Wednseday
2,15,9,24,2018,3,20,Tuesday
3,4,8,12,2017,10,20,Friday
4,6,14,20,2017,12,14,Thursday
3,7,8,15,2018,1,16,Tuesday
4,16,10,26,2018,1,25,Thursday
3,11,20,31,2018,4,27,Friday
2,17,15,32,2018,2,4,Sunday
0,4,7,11,2018,8,16,Thursday
0,3,17,20,2018,6,22,Friday
5,7,10,17,2018,3,30,Friday
1,9,13,22,2017,11,21,Tuesday
5,23,12,35,2017,3,8,Wednseday
1,12,25,37,2017,7,23,Sunday
3,14,27,41,2018,6,1,Friday
6,16,9,25,2018,1,12,Friday
2,4,11,15,2017,6,4,Sunday
9,16,16,32,2017,1,14,Saturday
2,7,10,17,2017,3,13,Monday
1,2,18,20,2018,6,21,Thursday
4,9,18,27,2017,12,1,Friday
4,34,-14,20,2017,9,1,Friday
4,12,14,26,2017,12,14,Thursday
3,10,12,22,2017,8,8,Tuesday
5,14,11,25,2017,6,9,Friday
1,8,14,22,2018,5,8,Tuesday
2,22,35,57,2018,6,6,Wednseday
2,20,8,28,2018,1,10,Wednseday
7,12,-4,8,2017,5,10,Wednseday
1,5,11,16,2018,7,9,Monday
2,13,20,33,2017,7,29,Saturday
2,16,9,25,2017,12,2,Saturday
6,13,21,34,2017,7,7,Friday
3,28,17,45,2018,6,1,Friday
3,7,17,24,2018,4,13,Friday
4,7,46,53,2016,10,7,Friday
1,19,15,34,2017,7,27,Thursday
1,19,22,41,2018,6,5,Tuesday
1,14,9,23,2017,10,25,Wednseday
1,3,22,25,2017,5,22,Monday
3,5,12,17,2017,4,1,Saturday
1,6,14,20,2017,8,30,Wednseday
2,8,13,21,2017,10,24,Tuesday
2,8,12,20,2018,5,8,Tuesday
1,6,8,14,2018,5,8,Tuesday
3,4,19,23,2018,2,17,Saturday
1,7,30,37,2017,2,1,Wednseday
6,25,-9,16,2017,11,22,Wednseday
3,7,7,14,2018,2,27,Tuesday
2,17,21,38,2018,5,22,Tuesday
7,13,12,25,2018,4,27,Friday
1,13,21,34,2017,11,29,Wednseday
2,3,8,11,2018,5,21,Monday
3,9,13,22,2018,3,6,Tuesday
4,14,19,33,2017,2,16,Thursday
5,11,11,22,2018,5,10,Thursday
1,15,12,27,2017,7,4,Tuesday
2,17,21,38,2018,4,7,Saturday
5,16,13,29,2018,3,11,Sunday
2,13,10,23,2018,2,27,Tuesday
5,22,5,27,2018,4,20,Friday
2,11,18,29,2017,7,18,Tuesday
4,8,32,40,2017,8,3,Thursday
1,11,15,26,2017,4,2,Sunday
2,4,7,11,2018,4,30,Monday
1,15,21,36,2017,12,5,Tuesday
3,12,0,12,2018,8,3,Friday
4,12,14,26,2018,6,8,Friday
1,21,10,31,2017,5,1,Monday
1,5,18,23,2017,10,4,Wednseday
2,13,14,27,2018,4,28,Saturday
3,14,7,21,2017,11,14,Tuesday
2,13,22,35,2018,5,9,Wednseday
1,7,8,15,2018,8,9,Thursday
6,14,0,14,2018,7,24,Tuesday
0,7,5,12,2018,8,9,Thursday
5,7,24,31,2018,4,20,Friday
1,6,7,13,2018,8,16,Thursday
0,6,21,27,2017,10,11,Wednseday
2,8,10,18,2018,5,14,Monday
3,6,18,24,2017,4,14,Friday
3,14,2,16,2017,9,18,Monday
6,9,19,28,2018,1,24,Wednseday
0,11,16,27,2018,2,22,Thursday
3,6,15,21,2018,1,12,Friday
3,5,9,14,2017,11,24,Friday
2,6,21,27,2018,6,27,Wednseday
14,15,7,22,2018,2,27,Tuesday
2,7,27,34,2018,1,30,Tuesday
1,4,6,10,2018,6,25,Monday
4,11,9,20,2018,5,3,Thursday
1,11,16,27,2017,11,23,Thursday
1,11,21,32,2018,6,14,Thursday
2,15,31,46,2017,8,20,Sunday
3,11,8,19,2017,9,8,Friday
1,13,8,21,2017,3,7,Tuesday
5,11,13,24,2017,7,1,Saturday
2,24,-1,23,2018,4,2,Monday
10,20,3,23,2017,9,5,Tuesday
5,14,8,22,2017,4,19,Wednseday
2,29,14,43,2018,5,22,Tuesday
1,12,15,27,2018,4,26,Thursday
0,7,15,22,2017,7,6,Thursday
4,16,16,32,2018,1,25,Thursday
1,16,3,19,2018,5,20,Sunday
5,18,11,29,2017,6,29,Thursday
2,10,15,25,2018,8,18,Saturday
2,5,4,9,2018,5,9,Wednseday
4,11,7,18,2017,7,31,Monday
3,14,14,28,2018,2,28,Wednseday
3,12,8,20,2018,7,27,Friday
4,9,8,17,2017,12,3,Sunday
20,33,6,39,2017,8,17,Thursday
2,10,20,30,2017,9,9,Saturday
3,10,12,22,2018,5,6,Sunday
5,8,21,29,2017,2,15,Wednseday
1,2,12,14,2018,2,21,Wednseday
8,17,3,20,2017,11,8,Wednseday
7,29,9,38,2018,1,9,Tuesday
2,12,0,12,2018,3,7,Wednseday
1,50,-25,25,2017,11,27,Monday
2,28,-8,20,2018,3,13,Tuesday
4,11,8,19,2018,5,3,Thursday
1,13,10,23,2018,5,13,Sunday
4,5,10,15,2018,2,15,Thursday
1,2,13,15,2017,10,16,Monday
1,11,6,17,2018,3,11,Sunday
1,5,5,10,2018,4,2,Monday
2,13,8,21,2017,11,8,Wednseday
5,7,4,11,2018,5,11,Friday
1,4,18,22,2017,11,9,Thursday
3,42,-4,38,2017,4,17,Monday
2,11,25,36,2017,2,27,Monday
3,9,11,20,2017,8,15,Tuesday
10,27,3,30,2017,10,17,Tuesday
2,3,19,22,2017,7,24,Monday
4,14,13,27,2017,11,30,Thursday
1,4,17,21,2018,6,25,Monday
4,39,-6,33,2017,4,15,Saturday
2,14,20,34,2017,9,27,Wednseday
0,4,22,26,2018,4,12,Thursday
4,9,24,33,2018,3,16,Friday
2,26,1,27,2018,3,1,Thursday
5,16,18,34,2017,7,22,Saturday
5,7,6,13,2018,5,17,Thursday
4,15,9,24,2018,1,30,Tuesday
3,11,5,16,2018,7,24,Tuesday
0,1,11,12,2018,4,4,Wednseday
1,9,12,21,2018,1,16,Tuesday
2,8,14,22,2017,7,24,Monday
3,9,21,30,2018,6,11,Monday
1,2,17,19,2017,7,16,Sunday
7,23,4,27,2017,12,6,Wednseday
3,10,8,18,2018,3,2,Friday
1,7,18,25,2017,8,24,Thursday
1,6,19,25,2017,7,30,Sunday
3,9,14,23,2017,5,29,Monday
3,7,24,31,2017,2,10,Friday
3,22,12,34,2018,1,26,Friday
1,19,13,32,2018,1,18,Thursday
3,8,7,15,2018,6,11,Monday
8,19,17,36,2018,7,5,Thursday
1,11,17,28,2017,11,30,Thursday
6,9,13,22,2017,11,29,Wednseday
2,9,18,27,2018,8,18,Saturday
5,23,17,40,2018,1,6,Saturday
3,4,9,13,2018,8,17,Friday
3,38,-15,23,2017,11,28,Tuesday
4,28,-10,18,2018,5,17,Thursday
1,8,13,21,2018,3,19,Monday
3,6,0,6,2018,8,10,Friday
5,32,-12,20,2017,11,24,Friday
2,14,15,29,2018,2,5,Monday
1,12,10,22,2017,10,22,Sunday
0,8,28,36,2018,6,21,Thursday
4,19,15,34,2017,1,27,Friday
4,6,12,18,2018,1,4,Thursday
1,2,4,6,2018,7,31,Tuesday
5,8,15,23,2018,5,2,Wednseday
7,17,10,27,2017,11,14,Tuesday
3,13,28,41,2017,2,17,Friday
3,16,6,22,2018,2,12,Monday
2,11,11,22,2018,3,15,Thursday
2,14,23,37,2017,1,31,Tuesday
2,8,10,18,2017,9,17,Sunday
7,17,11,28,2018,4,10,Tuesday
5,24,10,34,2018,3,2,Friday
4,9,10,19,2017,11,16,Thursday
1,9,14,23,2017,5,8,Monday
3,8,3,11,2018,8,20,Monday
5,6,7,13,2017,11,16,Thursday
8,22,8,30,2017,10,1,Sunday
1,5,11,16,2018,5,23,Wednseday
0,1,13,14,2017,6,13,Tuesday
14,37,14,51,2018,2,6,Tuesday
13,22,11,33,2018,2,1,Thursday
3,10,21,31,2017,2,11,Saturday
2,8,9,17,2017,10,9,Monday
1,2,13,15,2018,6,26,Tuesday
2,11,7,18,2017,6,19,Monday
1,13,22,35,2017,5,18,Thursday
5,6,15,21,2017,3,30,Thursday
1,9,19,28,2018,4,24,Tuesday
2,3,7,10,2018,3,12,Monday
3,14,8,22,2017,7,31,Monday
2,4,39,43,2017,3,5,Sunday
0,5,9,14,2018,7,19,Thursday
19,45,-12,33,2018,5,4,Friday
2,3,10,13,2017,8,1,Tuesday
10,17,29,46,2018,6,9,Saturday
7,18,10,28,2018,6,21,Thursday
4,25,9,34,2017,12,29,Friday
2,13,20,33,2018,3,21,Wednseday
1,8,7,15,2018,8,6,Monday
6,17,14,31,2017,9,16,Saturday
3,10,8,18,2017,8,14,Monday
1,12,24,36,2017,11,22,Wednseday
13,20,36,56,2018,6,15,Friday
2,10,12,22,2017,6,20,Tuesday
1,11,18,29,2018,5,3,Thursday
3,14,13,27,2018,4,13,Friday
7,18,9,27,2018,4,27,Friday
0,7,9,16,2018,1,29,Monday
1,2,13,15,2017,10,23,Monday
4,11,28,39,2018,5,25,Friday
2,21,0,21,2017,11,27,Monday
1,12,9,21,2017,8,28,Monday
1,3,15,18,2017,11,30,Thursday
1,7,15,22,2018,3,28,Wednseday
1,10,17,27,2017,8,22,Tuesday
2,7,14,21,2017,2,28,Tuesday
1,3,19,22,2017,8,20,Sunday
1,6,19,25,2018,5,3,Thursday
8,14,2,16,2018,3,5,Monday
2,11,10,21,2018,4,23,Monday
1,16,6,22,2018,1,29,Monday
3,12,14,26,2017,6,23,Friday
1,9,13,22,2018,8,5,Sunday
4,12,15,27,2017,8,31,Thursday
0,9,17,26,2018,4,18,Wednseday
2,4,13,17,2017,9,17,Sunday
4,12,14,26,2018,4,1,Sunday
2,24,15,39,2018,4,16,Monday
2,11,12,23,2018,6,18,Monday
5,29,-1,28,2017,3,22,Wednseday
1,2,11,13,2017,7,5,Wednseday
2,7,15,22,2017,7,19,Wednseday
1,1,28,29,2018,6,26,Tuesday
4,26,16,42,2017,12,22,Friday
3,13,20,33,2018,6,29,Friday
2,6,12,18,2018,3,1,Thursday
4,8,17,25,2017,8,25,Friday
2,5,18,23,2018,5,13,Sunday
2,16,15,31,2018,1,29,Monday
3,4,6,10,2017,5,14,Sunday
9,11,5,16,2017,6,3,Saturday
3,12,16,28,2018,1,19,Friday
1,11,18,29,2017,8,21,Monday
4,9,5,14,2017,11,27,Monday
5,29,-2,27,2018,3,28,Wednseday
3,50,-20,30,2017,9,24,Sunday
4,22,1,23,2017,7,30,Sunday
1,5,18,23,2018,2,21,Wednseday
0,6,25,31,2017,3,17,Friday
2,7,8,15,2018,4,3,Tuesday
7,14,30,44,2018,4,30,Monday
1,12,19,31,2017,11,7,Tuesday
2,12,17,29,2017,11,12,Sunday
2,8,18,26,2018,4,22,Sunday
1,6,11,17,2018,3,20,Tuesday
8,15,23,38,2017,10,15,Sunday
0,3,21,24,2018,8,21,Tuesday
1,4,19,23,2017,7,3,Monday
1,7,30,37,2018,6,13,Wednseday
6,12,9,21,2018,3,21,Wednseday
1,12,18,30,2017,2,12,Sunday
0,8,18,26,2018,4,26,Thursday
9,15,7,22,2017,11,7,Tuesday
5,28,15,43,2018,5,30,Wednseday
1,6,11,17,2018,3,27,Tuesday
2,9,17,26,2017,7,5,Wednseday
4,5,8,13,2017,5,19,Friday
0,12,6,18,2017,11,23,Thursday
1,2,12,14,2018,6,28,Thursday
2,3,14,17,2018,5,6,Sunday
4,10,10,20,2018,3,2,Friday
1,6,15,21,2018,1,17,Wednseday
6,24,8,32,2017,11,25,Saturday
0,11,26,37,2018,4,9,Monday
2,24,-1,23,2018,2,12,Monday
0,6,13,19,2018,3,23,Friday
2,8,12,20,2017,7,11,Tuesday
0,8,34,42,2018,6,7,Thursday
4,15,15,30,2018,1,16,Tuesday
2,6,14,20,2017,8,15,Tuesday
4,12,14,26,2017,11,4,Saturday
1,2,12,14,2018,1,10,Wednseday
7,9,6,15,2018,1,18,Thursday
5,17,9,26,2017,11,1,Wednseday
3,5,13,18,2017,9,8,Friday
3,23,1,24,2018,3,12,Monday
2,9,7,16,2018,8,14,Tuesday
0,12,14,26,2017,11,16,Thursday
3,16,11,27,2017,5,27,Saturday
2,37,-11,26,2018,3,31,Saturday
7,12,15,27,2017,10,4,Wednseday
1,6,23,29,2018,7,1,Sunday
3,5,7,12,2018,3,16,Friday
3,8,17,25,2018,7,2,Monday
7,10,19,29,2017,6,12,Monday
3,7,9,16,2017,9,12,Tuesday
1,15,6,21,2018,4,9,Monday
2,4,15,19,2018,4,19,Thursday
2,7,29,36,2017,3,14,Tuesday
11,28,7,35,2017,2,2,Thursday
2,5,8,13,2017,8,16,Wednseday
7,22,11,33,2017,5,25,Thursday
2,4,7,11,2017,9,4,Monday
2,5,9,14,2017,11,8,Wednseday
2,10,23,33,2018,6,9,Saturday
5,23,13,36,2017,12,13,Wednseday
2,5,13,18,2017,9,30,Saturday
1,5,39,44,2018,6,3,Sunday
2,3,28,31,2018,6,26,Tuesday
1,5,13,18,2018,6,10,Sunday
1,5,19,24,2017,9,26,Tuesday
2,8,-1,7,2018,8,13,Monday
7,25,2,27,2018,1,12,Friday
2,6,19,25,2018,4,19,Thursday
0,7,7,14,2018,7,18,Wednseday
3,4,11,15,2017,8,20,Sunday
4,14,12,26,2018,7,19,Thursday
11,14,12,26,2017,10,5,Thursday
7,13,13,26,2017,4,21,Friday
2,9,22,31,2017,4,9,Sunday
1,7,11,18,2017,8,28,Monday
1,2,16,18,2018,6,28,Thursday
4,42,-7,35,2018,3,5,Monday
3,4,10,14,2017,8,25,Friday
5,11,15,26,2018,2,11,Sunday
3,14,16,30,2017,11,14,Tuesday
3,12,5,17,2018,8,17,Friday
16,25,42,67,2017,12,4,Monday
1,5,16,21,2017,8,3,Thursday
0,10,18,28,2018,8,17,Friday
0,4,15,19,2018,3,16,Friday
1,10,32,42,2018,3,28,Wednseday
3,18,7,25,2018,5,19,Saturday
1,15,5,20,2018,7,24,Tuesday
3,12,21,33,2018,4,15,Sunday
1,5,16,21,2018,8,8,Wednseday
2,51,-26,25,2018,1,21,Sunday
5,13,16,29,2017,4,13,Thursday
6,19,0,19,2017,12,7,Thursday
2,10,9,19,2017,9,16,Saturday
0,9,18,27,2017,6,13,Tuesday
2,13,13,26,2018,1,20,Saturday
8,22,9,31,2018,1,16,Tuesday
1,5,13,18,2017,3,5,Sunday
1,6,5,11,2018,6,7,Thursday
1,2,10,12,2017,10,29,Sunday
2,3,14,17,2018,1,20,Saturday
0,4,17,21,2018,8,3,Friday
4,7,7,14,2017,11,13,Monday
1,10,20,30,2017,7,3,Monday
2,8,2,10,2018,3,6,Tuesday
0,47,-26,21,2018,3,14,Wednseday
1,5,27,32,2018,5,28,Monday
3,49,-23,26,2017,8,26,Saturday
2,20,4,24,2017,12,26,Tuesday
3,11,21,32,2017,5,27,Saturday
2,8,14,22,2017,10,22,Sunday
4,12,14,26,2017,9,24,Sunday
1,7,13,20,2018,5,2,Wednseday
8,15,20,35,2017,8,15,Tuesday
2,9,20,29,2017,2,8,Wednseday
2,4,14,18,2018,4,23,Monday
2,10,13,23,2017,9,3,Sunday
3,10,18,28,2018,4,23,Monday
2,18,40,58,2018,5,5,Saturday
2,6,12,18,2017,10,14,Saturday
1,9,14,23,2018,1,10,Wednseday
1,22,14,36,2018,6,10,Sunday
4,12,8,20,2018,2,15,Thursday
1,2,3,5,2018,8,12,Sunday
1,6,9,15,2018,5,17,Thursday
1,11,4,15,2017,9,25,Monday
1,47,-33,14,2018,1,10,Wednseday
1,7,10,17,2018,3,27,Tuesday
0,6,21,27,2018,3,15,Thursday
1,2,17,19,2017,12,17,Sunday
1,9,13,22,2017,6,28,Wednseday
1,9,14,23,2017,11,28,Tuesday
1,14,13,27,2017,10,5,Thursday
1,21,8,29,2017,12,7,Thursday
0,11,6,17,2018,7,13,Friday
3,12,11,23,2017,12,4,Monday
2,15,11,26,2018,3,7,Wednseday
5,5,47,52,2016,10,9,Sunday
4,26,-4,22,2018,3,12,Monday
9,72,-32,40,2018,2,24,Saturday
3,10,15,25,2018,3,24,Saturday
3,8,21,29,2018,8,13,Monday
1,26,-5,21,2017,9,14,Thursday
5,6,7,13,2018,3,28,Wednseday
8,14,5,19,2018,2,28,Wednseday
4,14,35,49,2017,1,27,Friday
1,15,6,21,2017,3,20,Monday
5,13,14,27,2017,12,13,Wednseday
1,13,12,25,2017,7,13,Thursday
1,11,32,43,2018,6,4,Monday
4,13,14,27,2018,5,3,Thursday
2,16,-2,14,2018,2,19,Monday
1,7,18,25,2018,4,9,Monday
7,25,14,39,2018,1,13,Saturday
1,34,-17,17,2018,4,3,Tuesday
3,4,10,14,2017,11,13,Monday
3,24,-4,20,2018,2,27,Tuesday
2,5,19,24,2018,5,13,Sunday
3,10,17,27,2017,1,20,Friday
10,23,-14,9,2018,8,5,Sunday
1,8,20,28,2017,3,23,Thursday
7,22,23,45,2018,6,8,Friday
5,37,-4,33,2017,12,28,Thursday
2,3,11,14,2017,11,27,Monday
5,15,21,36,2018,7,8,Sunday
3,24,10,34,2017,9,22,Friday
2,7,21,28,2018,4,23,Monday
1,8,21,29,2018,1,17,Wednseday
6,12,13,25,2018,6,28,Thursday
20,23,-4,19,2018,5,19,Saturday
0,7,9,16,2018,8,8,Wednseday
1,5,15,20,2017,3,1,Wednseday
0,8,14,22,2018,1,17,Wednseday
1,4,10,14,2018,7,23,Monday
4,10,32,42,2017,6,9,Friday
1,12,17,29,2018,6,6,Wednseday
1,2,24,26,2017,10,15,Sunday
5,6,7,13,2017,5,6,Saturday
3,16,20,36,2018,6,17,Sunday
1,6,23,29,2018,7,1,Sunday
2,6,10,16,2018,8,14,Tuesday
2,8,19,27,2018,4,25,Wednseday
1,5,21,26,2018,3,25,Sunday
1,3,19,22,2018,4,1,Sunday
1,3,8,11,2018,5,7,Monday
1,6,42,48,2018,6,5,Tuesday
5,8,20,28,2018,2,1,Thursday
4,9,21,30,2018,4,7,Saturday
5,8,20,28,2017,3,8,Wednseday
3,10,14,24,2018,5,4,Friday
3,13,22,35,2018,6,8,Friday
1,4,4,8,2018,8,6,Monday
1,9,18,27,2018,1,10,Wednseday
4,9,9,18,2018,3,10,Saturday
0,1,13,14,2018,6,14,Thursday
2,9,18,27,2017,7,19,Wednseday
10,27,8,35,2017,10,31,Tuesday
0,9,42,51,2018,6,6,Wednseday
1,10,10,20,2017,6,20,Tuesday
8,22,13,35,2017,12,26,Tuesday
27,28,-12,16,2018,7,25,Wednseday
1,26,1,27,2017,11,30,Thursday
3,7,10,17,2017,9,11,Monday
2,9,25,34,2018,7,4,Wednseday
2,3,10,13,2017,8,1,Tuesday
6,25,-1,24,2017,11,4,Saturday
1,2,9,11,2017,10,23,Monday
2,14,14,28,2017,10,2,Monday
8,9,11,20,2017,12,27,Wednseday
5,29,-1,28,2017,11,24,Friday
5,13,19,32,2017,6,30,Friday
2,11,13,24,2017,9,17,Sunday
2,14,14,28,2018,3,26,Monday
3,10,22,32,2018,4,30,Monday
0,6,13,19,2018,5,16,Wednseday
2,4,8,12,2018,4,1,Sunday
3,18,5,23,2018,3,31,Saturday
10,14,6,20,2017,3,28,Tuesday
7,24,5,29,2018,2,7,Wednseday
1,2,12,14,2017,11,29,Wednseday
1,10,32,42,2018,7,30,Monday
7,23,5,28,2018,4,9,Monday
1,3,11,14,2017,11,24,Friday
2,15,10,25,2018,2,5,Monday
2,3,17,20,2017,11,29,Wednseday
1,2,15,17,2018,1,23,Tuesday
2,5,24,29,2018,4,22,Sunday
2,13,15,28,2017,7,5,Wednseday
9,23,10,33,2018,1,14,Sunday
3,26,1,27,2017,12,2,Saturday
2,10,18,28,2018,7,2,Monday
4,18,8,26,2018,3,8,Thursday
1,5,17,22,2017,3,9,Thursday
3,15,9,24,2017,6,11,Sunday
2,8,15,23,2018,4,4,Wednseday
1,15,29,44,2018,6,10,Sunday
0,5,19,24,2018,6,29,Friday
1,11,14,25,2017,12,10,Sunday
3,29,6,35,2018,2,13,Tuesday
2,6,30,36,2017,1,25,Wednseday
4,15,6,21,2018,7,19,Thursday
0,1,14,15,2018,4,10,Tuesday
0,8,15,23,2018,4,4,Wednseday
2,16,6,22,2017,6,19,Monday
4,10,13,23,2017,10,21,Saturday
3,19,6,25,2018,3,3,Saturday
0,11,21,32,2017,10,27,Friday
1,6,21,27,2018,7,3,Tuesday
2,7,9,16,2018,2,18,Sunday
2,3,5,8,2018,8,26,Sunday
2,3,10,13,2018,5,8,Tuesday
1,8,15,23,2018,2,25,Sunday
2,3,17,20,2018,6,26,Tuesday
7,11,20,31,2018,8,14,Tuesday
1,3,12,15,2018,6,18,Monday
1,9,18,27,2017,6,7,Wednseday
4,5,8,13,2018,6,21,Thursday
0,13,10,23,2018,1,16,Tuesday
2,11,11,22,2018,8,6,Monday
5,12,13,25,2017,8,19,Saturday
1,4,14,18,2018,2,1,Thursday
2,4,16,20,2017,8,12,Saturday
1,10,13,23,2017,10,24,Tuesday
4,6,9,15,2018,4,12,Thursday
0,5,26,31,2017,9,29,Friday
0,10,23,33,2017,12,29,Friday
1,7,13,20,2017,8,10,Thursday
0,5,21,26,2018,5,4,Friday
2,6,10,16,2018,4,24,Tuesday
1,15,33,48,2017,11,30,Thursday
5,7,6,13,2018,3,28,Wednseday
2,3,3,6,2018,8,18,Saturday
3,9,7,16,2018,4,2,Monday
3,7,17,24,2017,6,30,Friday
1,8,22,30,2017,5,3,Wednseday
2,7,9,16,2017,9,18,Monday
1,19,3,22,2018,2,1,Thursday
2,7,16,23,2017,8,16,Wednseday
1,9,15,24,2018,7,2,Monday
1,7,13,20,2017,9,12,Tuesday
7,17,10,27,2018,4,17,Tuesday
2,6,23,29,2017,10,24,Tuesday
4,19,6,25,2018,3,2,Friday
2,8,18,26,2018,7,15,Sunday
1,8,8,16,2018,8,15,Wednseday
13,14,-7,7,2018,8,7,Tuesday
1,8,10,18,2018,8,13,Monday
5,13,21,34,2017,10,11,Wednseday
1,12,10,22,2018,2,28,Wednseday
6,20,11,31,2017,12,8,Friday
1,3,9,12,2017,6,18,Sunday
4,10,14,24,2018,1,21,Sunday
1,5,17,22,2018,4,11,Wednseday
4,14,1,15,2018,1,15,Monday
9,13,15,28,2018,8,1,Wednseday
3,4,6,10,2018,7,27,Friday
2,3,26,29,2018,1,22,Monday
4,5,8,13,2018,7,6,Friday
2,14,52,66,2017,1,24,Tuesday
0,14,24,38,2018,1,26,Friday
1,11,15,26,2018,3,23,Friday
2,4,42,46,2017,1,14,Saturday
4,33,8,41,2017,2,2,Thursday
3,16,6,22,2018,8,6,Monday
1,4,9,13,2017,5,18,Thursday
4,13,20,33,2018,8,17,Friday
3,5,20,25,2018,1,20,Saturday
5,11,16,27,2017,5,26,Friday
14,29,-1,28,2017,10,24,Tuesday
3,7,17,24,2017,10,1,Sunday
2,11,20,31,2018,6,16,Saturday
2,7,36,43,2017,1,16,Monday
3,8,19,27,2017,2,7,Tuesday
1,2,18,20,2018,5,1,Tuesday
2,16,12,28,2017,2,28,Tuesday
2,18,15,33,2018,4,7,Saturday
2,10,14,24,2017,5,7,Sunday
1,10,14,24,2018,7,10,Tuesday
2,7,13,20,2017,8,9,Wednseday
5,6,15,21,2018,1,10,Wednseday
1,2,8,10,2017,9,18,Monday
15,19,4,23,2018,4,29,Sunday
2,15,14,29,2017,12,26,Tuesday
6,14,33,47,2018,1,19,Friday
2,9,19,28,2017,7,31,Monday
0,8,14,22,2017,8,14,Monday
3,13,17,30,2018,6,30,Saturday
7,14,8,22,2017,11,28,Tuesday
3,22,7,29,2018,1,7,Sunday
2,11,12,23,2018,8,13,Monday
6,14,12,26,2018,3,28,Wednseday
1,28,0,28,2017,8,29,Tuesday
1,3,11,14,2018,7,2,Monday
1,36,-14,22,2018,5,15,Tuesday
2,17,6,23,2018,5,16,Wednseday
1,15,13,28,2018,6,27,Wednseday
8,11,-5,6,2018,8,2,Thursday
12,19,21,40,2017,1,25,Wednseday
6,7,3,10,2018,7,17,Tuesday
1,7,18,25,2018,7,2,Monday
1,7,17,24,2017,7,24,Monday
5,23,10,33,2017,12,6,Wednseday
3,12,8,20,2017,4,21,Friday
1,3,13,16,2017,11,21,Tuesday
0,6,16,22,2017,8,3,Thursday
2,2,11,13,2017,6,17,Saturday
4,7,10,17,2018,4,16,Monday
1,17,2,19,2018,5,18,Friday
1,10,12,22,2018,2,18,Sunday
4,8,9,17,2017,12,4,Monday
1,4,9,13,2017,8,24,Thursday
4,32,-6,26,2018,4,26,Thursday
6,13,14,27,2018,6,27,Wednseday
2,8,8,16,2017,9,18,Monday
1,12,17,29,2017,12,10,Sunday
1,14,6,20,2017,9,14,Thursday
1,7,23,30,2018,1,15,Monday
5,14,6,20,2018,8,3,Friday
2,17,13,30,2018,1,2,Tuesday
1,13,11,24,2017,10,31,Tuesday
0,4,8,12,2018,5,4,Friday
3,4,13,17,2018,1,7,Sunday
2,8,18,26,2017,12,7,Thursday
2,11,49,60,2018,8,6,Monday
0,20,0,20,2018,5,18,Friday
2,15,20,35,2017,10,4,Wednseday
4,11,16,27,2018,4,13,Friday
2,12,16,28,2018,2,7,Wednseday
3,10,15,25,2018,1,27,Saturday
1,7,17,24,2017,3,20,Monday
3,5,7,12,2018,8,10,Friday
1,14,9,23,2017,3,15,Wednseday
2,21,9,30,2018,1,17,Wednseday
4,8,17,25,2018,1,25,Thursday
1,37,-9,28,2017,11,20,Monday
5,13,7,20,2017,10,18,Wednseday
3,15,13,28,2017,10,24,Tuesday
1,7,23,30,2017,12,4,Monday
1,2,8,10,2018,6,18,Monday
1,8,20,28,2018,4,9,Monday
1,10,13,23,2017,2,7,Tuesday
5,22,12,34,2018,1,12,Friday
1,3,20,23,2017,7,30,Sunday
10,23,12,35,2018,4,10,Tuesday
4,19,11,30,2017,12,9,Saturday
2,3,13,16,2017,8,14,Monday
2,11,32,43,2018,4,26,Thursday
0,3,13,16,2018,4,11,Wednseday
4,5,7,12,2018,5,3,Thursday
5,8,-1,7,2018,8,9,Thursday
4,10,13,23,2018,1,22,Monday
3,6,8,14,2018,1,26,Friday
1,8,16,24,2018,4,29,Sunday
1,3,12,15,2018,1,22,Monday
6,13,3,16,2018,8,7,Tuesday
5,6,22,28,2017,12,21,Thursday
7,20,3,23,2018,2,24,Saturday
1,35,-10,25,2018,3,11,Sunday
1,6,15,21,2018,2,13,Tuesday
3,16,15,31,2018,3,3,Saturday
4,18,7,25,2017,11,24,Friday
0,10,12,22,2017,9,12,Tuesday
2,14,-4,10,2018,8,14,Tuesday
1,15,13,28,2018,5,10,Thursday
2,23,18,41,2018,4,25,Wednseday
2,4,29,33,2018,6,2,Saturday
1,2,11,13,2018,5,22,Tuesday
4,10,16,26,2017,8,11,Friday
2,25,1,26,2017,9,9,Saturday
4,22,-1,21,2018,3,12,Monday
2,8,11,19,2017,11,12,Sunday
3,14,2,16,2018,7,31,Tuesday
2,23,3,26,2018,1,28,Sunday
3,12,5,17,2018,8,3,Friday
4,13,6,19,2017,11,16,Thursday
3,4,8,12,2017,5,28,Sunday
1,2,18,20,2017,12,27,Wednseday
2,35,-5,30,2017,11,29,Wednseday
1,18,15,33,2018,6,17,Sunday
3,6,14,20,2017,8,11,Friday
4,10,10,20,2017,11,3,Friday
16,23,1,24,2018,2,24,Saturday
1,10,11,21,2017,11,7,Tuesday
3,14,10,24,2017,6,30,Friday
5,6,9,15,2018,7,22,Sunday
2,12,9,21,2018,1,18,Thursday
3,9,36,45,2018,7,15,Sunday
1,7,13,20,2017,7,25,Tuesday
1,15,12,27,2018,5,17,Thursday
2,11,12,23,2018,2,24,Saturday
2,18,3,21,2018,1,15,Monday
1,9,17,26,2018,1,3,Wednseday
3,15,20,35,2018,8,13,Monday
1,30,6,36,2018,1,31,Wednseday
1,14,21,35,2018,1,10,Wednseday
3,12,19,31,2017,9,16,Saturday
4,18,7,25,2018,1,29,Monday
2,3,17,20,2017,12,26,Tuesday
2,5,20,25,2018,8,11,Saturday
0,6,22,28,2018,4,17,Tuesday
2,30,15,45,2018,3,11,Sunday
7,12,13,25,2017,11,9,Thursday
5,11,7,18,2018,5,25,Friday
1,12,7,19,2018,8,16,Thursday
4,8,9,17,2017,10,15,Sunday
7,18,9,27,2018,2,9,Friday
15,55,-27,28,2017,11,14,Tuesday
2,9,18,27,2018,2,20,Tuesday
2,8,20,28,2018,6,18,Monday
2,5,13,18,2018,8,18,Saturday
3,6,19,25,2018,6,16,Saturday
1,3,7,10,2017,9,11,Monday
1,11,25,36,2017,9,4,Monday
1,17,14,31,2017,6,18,Sunday
0,2,14,16,2017,5,15,Monday
1,12,23,35,2018,1,3,Wednseday
1,23,8,31,2017,7,25,Tuesday
6,30,-7,23,2018,5,16,Wednseday
1,14,21,35,2018,2,6,Tuesday
2,3,18,21,2017,12,25,Monday
1,11,8,19,2018,5,10,Thursday
8,13,3,16,2018,2,13,Tuesday
2,22,-6,16,2018,1,8,Monday
2,8,14,22,2018,7,23,Monday
1,11,25,36,2018,3,15,Thursday
5,20,15,35,2018,6,13,Wednseday
1,6,9,15,2018,8,22,Wednseday
3,11,20,31,2018,4,20,Friday
11,22,1,23,2017,8,22,Tuesday
5,11,14,25,2018,5,24,Thursday
4,12,7,19,2017,11,17,Friday
1,8,14,22,2017,8,7,Monday
1,2,13,15,2018,1,16,Tuesday
1,6,16,22,2018,6,19,Tuesday
0,3,7,10,2018,7,27,Friday
1,6,11,17,2018,5,8,Tuesday
0,12,1,13,2018,3,2,Friday
2,5,15,20,2017,7,1,Saturday
3,8,4,12,2018,3,16,Friday
2,8,17,25,2018,3,12,Monday
2,10,21,31,2017,8,29,Tuesday
3,14,12,26,2018,1,31,Wednseday
2,6,20,26,2017,7,1,Saturday
3,8,11,19,2018,7,1,Sunday
7,16,3,19,2018,5,9,Wednseday
8,15,6,21,2017,10,9,Monday
2,11,26,37,2018,3,19,Monday
9,21,52,73,2017,9,12,Tuesday
5,18,15,33,2018,7,6,Friday
10,13,21,34,2018,8,11,Saturday
1,4,13,17,2018,4,23,Monday
1,4,22,26,2018,1,28,Sunday
0,16,14,30,2017,7,17,Monday
5,6,7,13,2018,3,22,Thursday
1,5,16,21,2018,2,22,Thursday
2,7,11,18,2017,10,16,Monday
1,9,20,29,2018,4,12,Thursday
1,9,7,16,2018,7,29,Sunday
14,22,-9,13,2018,3,20,Tuesday
5,12,16,28,2018,3,8,Thursday
0,3,20,23,2017,5,9,Tuesday
1,10,14,24,2017,7,25,Tuesday
4,9,10,19,2018,3,29,Thursday
0,4,28,32,2017,2,3,Friday
3,11,20,31,2018,1,6,Saturday
5,12,13,25,2017,2,24,Friday
2,7,12,19,2018,6,16,Saturday
8,13,8,21,2017,11,28,Tuesday
1,6,9,15,2018,8,14,Tuesday
2,32,18,50,2017,11,20,Monday
1,10,16,26,2017,12,27,Wednseday
4,18,12,30,2018,2,24,Saturday
3,20,4,24,2017,9,24,Sunday
7,12,14,26,2018,4,12,Thursday
2,6,20,26,2018,2,3,Saturday
0,4,25,29,2018,6,28,Thursday
2,11,18,29,2017,8,14,Monday
2,3,9,12,2018,4,15,Sunday
2,15,14,29,2017,12,4,Monday
3,6,14,20,2017,10,21,Saturday
11,23,16,39,2017,11,12,Sunday
3,5,9,14,2017,11,24,Friday
1,15,7,22,2017,9,18,Monday
4,5,5,10,2018,7,16,Monday
3,10,13,23,2017,10,22,Sunday
0,46,-14,32,2018,4,5,Thursday
0,13,12,25,2017,5,5,Friday
2,21,8,29,2018,3,28,Wednseday
6,10,13,23,2017,11,14,Tuesday
5,7,12,19,2017,8,9,Wednseday
1,9,18,27,2017,8,16,Wednseday
6,15,12,27,2017,9,12,Tuesday
1,13,15,28,2018,1,12,Friday
2,10,15,25,2018,1,22,Monday
0,9,14,23,2018,7,24,Tuesday
4,23,19,42,2017,5,15,Monday
4,7,8,15,2018,2,11,Sunday
3,4,20,24,2018,3,24,Saturday
1,6,20,26,2018,1,10,Wednseday
1,16,13,29,2018,5,6,Sunday
0,7,15,22,2017,5,16,Tuesday
2,4,19,23,2017,4,16,Sunday
3,9,9,18,2017,11,13,Monday
2,29,-13,16,2018,3,5,Monday
3,15,12,27,2018,2,23,Friday
5,12,11,23,2018,4,18,Wednseday
2,12,15,27,2018,1,20,Saturday
4,18,24,42,2017,11,30,Thursday
1,3,17,20,2017,12,26,Tuesday
1,8,14,22,2018,7,25,Wednseday
0,14,29,43,2018,5,29,Tuesday
5,8,15,23,2017,4,5,Wednseday
5,14,12,26,2018,4,27,Friday
1,11,12,23,2017,11,20,Monday
4,5,8,13,2018,3,23,Friday
0,10,19,29,2018,1,9,Tuesday
7,20,3,23,2017,4,19,Wednseday
3,8,13,21,2017,3,7,Tuesday
3,9,22,31,2018,6,23,Saturday
1,23,4,27,2018,3,21,Wednseday
7,9,13,22,2017,10,2,Monday
2,9,12,21,2017,6,7,Wednseday
1,16,13,29,2017,9,17,Sunday
5,19,13,32,2017,12,1,Friday
4,11,7,18,2017,10,13,Friday
3,14,16,30,2017,6,19,Monday
4,34,-10,24,2017,11,24,Friday
4,27,15,42,2017,11,24,Friday
1,10,20,30,2018,5,6,Sunday
25,32,22,54,2016,10,9,Sunday
1,15,12,27,2018,3,27,Tuesday
4,5,19,24,2017,11,24,Friday
1,23,3,26,2017,11,22,Wednseday
3,11,16,27,2017,6,16,Friday
1,13,-5,8,2018,5,15,Tuesday
8,13,14,27,2017,12,27,Wednseday
0,16,11,27,2017,5,31,Wednseday
4,17,10,27,2017,6,16,Friday
2,9,26,35,2017,8,16,Wednseday
1,18,9,27,2018,3,1,Thursday
5,11,14,25,2017,6,1,Thursday
4,19,9,28,2017,11,30,Thursday
1,8,14,22,2018,7,31,Tuesday
3,13,5,18,2017,11,27,Monday
2,10,14,24,2017,3,26,Sunday
1,5,18,23,2018,6,24,Sunday
26,31,-15,16,2018,1,14,Sunday
3,8,14,22,2018,7,2,Monday
8,18,4,22,2017,5,1,Monday
2,9,9,18,2018,7,28,Saturday
3,14,10,24,2017,7,14,Friday
2,18,6,24,2018,2,27,Tuesday
2,3,8,11,2018,4,8,Sunday
1,14,37,51,2018,1,2,Tuesday
2,13,12,25,2017,6,3,Saturday
8,15,8,23,2018,4,9,Monday
2,13,9,22,2018,5,23,Wednseday
2,23,0,23,2018,1,29,Monday
3,17,12,29,2018,4,24,Tuesday
7,32,-1,31,2017,11,20,Monday
1,19,16,35,2017,8,24,Thursday
0,13,15,28,2018,4,13,Friday
1,5,11,16,2018,1,31,Wednseday
4,17,9,26,2017,11,24,Friday
1,14,15,29,2017,10,3,Tuesday
1,7,23,30,2017,11,7,Tuesday
3,7,19,26,2018,7,21,Saturday
8,15,15,30,2018,7,25,Wednseday
2,7,21,28,2018,4,10,Tuesday
2,5,24,29,2017,2,5,Sunday
1,9,28,37,2018,4,10,Tuesday
1,18,4,22,2017,3,5,Sunday
1,8,22,30,2017,9,3,Sunday
2,8,21,29,2017,3,5,Sunday
1,6,21,27,2018,1,18,Thursday
1,3,1,4,2018,8,5,Sunday
0,12,15,27,2017,11,24,Friday
3,7,10,17,2018,4,16,Monday
1,8,14,22,2017,5,7,Sunday
1,13,16,29,2018,1,10,Wednseday
1,9,19,28,2017,10,26,Thursday
9,18,2,20,2018,3,1,Thursday
4,18,22,40,2018,6,7,Thursday
5,10,10,20,2017,11,3,Friday
0,12,6,18,2017,9,15,Friday
1,7,9,16,2018,2,7,Wednseday
1,10,12,22,2018,4,4,Wednseday
7,26,-2,24,2017,12,4,Monday
3,5,7,12,2018,7,20,Friday
2,5,12,17,2018,6,9,Saturday
0,5,18,23,2018,4,25,Wednseday
5,7,8,15,2018,1,24,Wednseday
1,3,19,22,2018,8,26,Sunday
1,4,15,19,2018,4,19,Thursday
4,13,21,34,2018,1,19,Friday
8,18,37,55,2016,10,7,Friday
3,16,5,21,2017,3,21,Tuesday
0,4,21,25,2018,1,25,Thursday
3,11,16,27,2018,2,3,Saturday
1,2,3,5,2018,8,15,Wednseday
1,13,14,27,2018,4,25,Wednseday
0,23,4,27,2018,4,10,Tuesday
1,4,10,14,2018,6,28,Thursday
1,5,7,12,2018,8,15,Wednseday
1,8,6,14,2018,7,31,Tuesday
3,6,48,54,2018,1,13,Saturday
15,20,43,63,2016,10,6,Thursday
3,10,6,16,2018,5,12,Saturday
5,6,7,13,2018,7,5,Thursday
1,3,26,29,2017,3,28,Tuesday
0,16,14,30,2017,7,18,Tuesday
4,5,10,15,2017,11,12,Sunday
3,9,12,21,2018,1,10,Wednseday
2,11,22,33,2018,6,23,Saturday
2,14,15,29,2018,2,5,Monday
2,9,15,24,2018,1,27,Saturday
3,18,23,41,2018,6,1,Friday
3,6,13,19,2018,7,6,Friday
1,6,4,10,2018,8,7,Tuesday
1,13,4,17,2017,10,10,Tuesday
2,3,7,10,2018,5,22,Tuesday
3,16,13,29,2017,11,13,Monday
3,8,12,20,2018,8,21,Tuesday
5,9,7,16,2017,11,18,Saturday
0,4,13,17,2018,8,13,Monday
2,6,27,33,2018,6,9,Saturday
3,10,16,26,2018,3,17,Saturday
2,9,20,29,2018,4,23,Monday
5,12,13,25,2017,11,16,Thursday
1,18,14,32,2018,2,8,Thursday
5,16,20,36,2018,5,23,Wednseday
3,4,6,10,2018,4,2,Monday
5,12,11,23,2018,8,1,Wednseday
5,15,29,44,2018,5,30,Wednseday
2,6,30,36,2018,5,16,Wednseday
1,11,14,25,2018,3,1,Thursday
2,4,12,16,2018,7,21,Saturday
1,3,15,18,2017,3,26,Sunday
0,1,4,5,2018,8,29,Wednseday
4,20,19,39,2018,4,12,Thursday
1,18,15,33,2018,2,1,Thursday
2,6,15,21,2018,6,27,Wednseday
6,14,14,28,2017,4,27,Thursday
4,22,13,35,2018,1,18,Thursday
1,3,15,18,2018,4,15,Sunday
5,23,10,33,2018,1,31,Wednseday
4,7,1,8,2018,8,9,Thursday
0,2,4,6,2018,8,15,Wednseday
1,10,14,24,2017,7,18,Tuesday
2,5,10,15,2018,1,24,Wednseday
1,15,27,42,2018,6,4,Monday
0,1,14,15,2018,6,27,Wednseday
5,14,14,28,2017,5,4,Thursday
2,7,1,8,2018,8,20,Monday
4,14,5,19,2018,3,2,Friday
2,11,19,30,2017,9,3,Sunday
1,2,7,9,2018,7,22,Sunday
1,9,10,19,2017,11,26,Sunday
5,13,14,27,2017,11,30,Thursday
1,4,18,22,2017,10,2,Monday
4,10,22,32,2018,5,25,Friday
5,40,-21,19,2017,10,12,Thursday
6,11,6,17,2017,11,21,Tuesday
4,6,17,23,2018,5,12,Saturday
0,37,-8,29,2017,12,20,Wednseday
1,16,18,34,2017,10,4,Wednseday
3,11,38,49,2017,1,27,Friday
4,17,21,38,2018,1,8,Monday
1,8,18,26,2018,3,8,Thursday
